season,match_week,team_id,team_name,position,played,won,drawn,lost,goals_for,goals_against,goal_difference,points,home_played,home_won,home_drawn,home_lost,home_goals_for,home_goals_against,home_goal_difference,home_points,away_played,away_won,away_drawn,away_lost,away_goals_for,away_goals_against,away_goal_difference,away_points,annotation_types,annotation_destinations,stadium_name,stadium_city
1992/93,1,14,Norwich City,1,2,2,0,0,6,3,3,6,1,1,0,0,2,1,1,3,1,1,0,0,4,2,2,3,Q,EU_CL,Carrow Road,Norwich
1992/93,1,5,Coventry City,2,2,2,0,0,4,1,3,6,1,1,0,0,2,1,1,3,1,1,0,0,2,0,2,3,Q,EU_UC,Highfield Road,Coventry
1992/93,1,7,Everton,3,2,1,1,0,4,1,3,4,1,0,1,0,1,1,0,1,1,1,0,0,3,0,3,3,Q,EU_UC,Goodison Park,Liverpool
1992/93,1,17,Queens Park Rangers,4,2,1,1,0,4,2,2,4,1,1,0,0,3,1,2,3,1,0,1,0,1,1,0,1,,,MATRADE Loftus Road Stadium,London
1992/93,1,19,Sheffield Wednesday,5,2,1,1,0,3,1,2,4,1,1,0,0,2,0,2,3,1,0,1,0,1,1,0,1,,,Hillsborough,Sheffield
1992/93,1,3,Blackburn Rovers,6,2,1,1,0,4,3,1,4,1,1,0,0,1,0,1,3,1,0,1,0,3,3,0,1,,,Ewood Park,Blackburn
1992/93,1,9,Leeds United,7,2,1,1,0,3,2,1,4,1,1,0,0,2,1,1,3,1,0,1,0,1,1,0,1,,,Elland Road,Leeds
1992/93,1,8,Ipswich Town,8,2,1,1,0,2,1,1,4,1,0,1,0,1,1,0,1,1,1,0,0,1,0,1,3,,,Portman Road,Ipswich
1992/93,1,13,Middlesbrough,9,2,1,0,1,3,2,1,3,1,1,0,0,2,0,2,3,1,0,0,1,1,2,-1,0,,,Ayresome Park,Middlesbrough
1992/93,1,18,Sheffield United,10,2,1,0,1,3,3,0,3,1,1,0,0,2,1,1,3,1,0,0,1,1,2,-1,0,,,Bramall Lane,Sheffield
1992/93,1,10,Liverpool,11,2,1,0,1,2,2,0,3,1,1,0,0,2,1,1,3,1,0,0,1,0,1,-1,0,,,Anfield,Liverpool
1992/93,1,15,Nottingham Forest,12,2,1,0,1,1,2,-1,3,1,1,0,0,1,0,1,3,1,0,0,1,0,2,-2,0,,,The City Ground,Nottingham
1992/93,1,6,Crystal Palace,13,2,0,2,0,4,4,0,2,1,0,1,0,3,3,0,1,1,0,1,0,1,1,0,1,,,Selhurst Park,London
1992/93,1,2,Aston Villa,14,2,0,2,0,2,2,0,2,1,0,1,0,1,1,0,1,1,0,1,0,1,1,0,1,,,Villa Park,Birmingham
1992/93,1,16,Oldham Athletic,15,2,0,2,0,2,2,0,2,1,0,1,0,1,1,0,1,1,0,1,0,1,1,0,1,,,Boundary Park,Oldham
1992/93,1,4,Chelsea,16,2,0,1,1,2,3,-1,1,1,0,1,0,1,1,0,1,1,0,0,1,1,2,-1,0,,,Stamford Bridge,London
1992/93,1,11,Manchester City,17,2,0,1,1,1,3,-2,1,1,0,1,0,1,1,0,1,1,0,0,1,0,2,-2,0,,,Maine Road,Manchester
1992/93,1,20,Southampton,18,2,0,1,1,1,3,-2,1,1,0,1,0,0,0,0,1,1,0,0,1,1,3,-2,0,,,The Dell,Southampton
1992/93,1,21,Tottenham Hotspur,19,2,0,1,1,0,2,-2,1,1,0,0,1,0,2,-2,0,1,0,1,0,0,0,0,1,,,White Hart Lane,London
1992/93,1,22,Wimbledon,20,2,0,0,2,1,3,-2,0,1,0,0,1,0,1,-1,0,1,0,0,1,1,2,-1,0,R,EN_D1,Selhurst Park,London
1992/93,1,1,Arsenal,21,2,0,0,2,2,5,-3,0,1,0,0,1,2,4,-2,0,1,0,0,1,0,1,-1,0,"R,Q","EN_D1,EU_CWC",Highbury,London
1992/93,1,12,Manchester United,22,2,0,0,2,1,5,-4,0,1,0,0,1,0,3,-3,0,1,0,0,1,1,2,-1,0,R,EN_D1,Old Trafford,Manchester
1992/93,2,17,Queens Park Rangers,1,4,3,1,0,8,4,4,10,2,2,0,0,6,3,3,6,2,1,1,0,2,1,1,4,Q,EU_CL,MATRADE Loftus Road Stadium,London
1992/93,2,5,Coventry City,2,4,3,0,1,6,3,3,9,2,1,0,1,2,2,0,3,2,2,0,0,4,1,3,6,Q,EU_UC,Highfield Road,Coventry
1992/93,2,7,Everton,3,4,2,2,0,6,2,4,8,2,1,1,0,2,1,1,4,2,1,1,0,4,1,3,4,Q,EU_UC,Goodison Park,Liverpool
1992/93,2,3,Blackburn Rovers,4,4,2,2,0,5,3,2,8,2,2,0,0,2,0,2,6,2,0,2,0,3,3,0,2,,,Ewood Park,Blackburn
1992/93,2,9,Leeds United,5,4,2,1,1,9,6,3,7,2,2,0,0,7,1,6,6,2,0,1,1,2,5,-3,1,,,Elland Road,Leeds
1992/93,2,14,Norwich City,6,4,2,1,1,8,7,1,7,2,1,1,0,3,2,1,4,2,1,0,1,5,5,0,3,,,Carrow Road,Norwich
1992/93,2,13,Middlesbrough,7,3,2,0,1,7,3,4,6,2,2,0,0,6,1,5,6,1,0,0,1,1,2,-1,0,,,Ayresome Park,Middlesbrough
1992/93,2,19,Sheffield Wednesday,8,4,1,3,0,7,5,2,6,2,1,1,0,5,3,2,4,2,0,2,0,2,2,0,2,,,Hillsborough,Sheffield
1992/93,2,1,Arsenal,9,4,2,0,2,6,5,1,6,2,1,0,1,4,4,0,3,2,1,0,1,2,1,1,3,Q,EU_CWC,Highbury,London
1992/93,2,8,Ipswich Town,10,4,1,3,0,5,4,1,6,2,0,2,0,3,3,0,2,2,1,1,0,2,1,1,4,,,Portman Road,Ipswich
1992/93,2,16,Oldham Athletic,11,4,1,2,1,7,7,0,5,2,1,1,0,6,4,2,4,2,0,1,1,1,3,-2,1,,,Boundary Park,Oldham
1992/93,2,6,Crystal Palace,12,4,0,4,0,7,7,0,4,2,0,2,0,4,4,0,2,2,0,2,0,3,3,0,2,,,Selhurst Park,London
1992/93,2,18,Sheffield United,13,4,1,1,2,7,8,-1,4,2,1,1,0,4,3,1,4,2,0,0,2,3,5,-2,0,,,Bramall Lane,Sheffield
1992/93,2,11,Manchester City,14,4,1,1,2,4,5,-1,4,2,1,1,0,4,2,2,4,2,0,0,2,0,3,-3,0,,,Maine Road,Manchester
1992/93,2,10,Liverpool,15,4,1,1,2,4,6,-2,4,2,1,0,1,2,3,-1,3,2,0,1,1,2,3,-1,1,,,Anfield,Liverpool
1992/93,2,12,Manchester United,16,4,1,1,2,3,6,-3,4,2,0,1,1,1,4,-3,1,2,1,0,1,2,2,0,3,,,Old Trafford,Manchester
1992/93,2,4,Chelsea,17,4,0,3,1,5,6,-1,3,2,0,2,0,1,1,0,2,2,0,1,1,4,5,-1,1,,,Stamford Bridge,London
1992/93,2,2,Aston Villa,18,4,0,3,1,3,4,-1,3,2,0,2,0,2,2,0,2,2,0,1,1,1,2,-1,1,,,Villa Park,Birmingham
1992/93,2,15,Nottingham Forest,19,3,1,0,2,4,7,-3,3,1,1,0,0,1,0,1,3,2,0,0,2,3,7,-4,0,,,The City Ground,Nottingham
1992/93,2,20,Southampton,20,4,0,2,2,2,5,-3,2,2,0,1,1,0,1,-1,1,2,0,1,1,2,4,-2,1,R,EN_D1,The Dell,Southampton
1992/93,2,21,Tottenham Hotspur,21,4,0,2,2,2,9,-7,2,2,0,1,1,2,4,-2,1,2,0,1,1,0,5,-5,1,R,EN_D1,White Hart Lane,London
1992/93,2,22,Wimbledon,22,4,0,1,3,4,7,-3,1,2,0,0,2,1,3,-2,0,2,0,1,1,3,4,-1,1,R,EN_D1,Selhurst Park,London
1992/93,3,14,Norwich City,1,6,4,1,1,13,9,4,13,3,2,1,0,6,3,3,7,3,2,0,1,7,6,1,6,Q,EU_CL,Carrow Road,Norwich
1992/93,3,5,Coventry City,2,6,4,0,2,8,6,2,12,3,1,0,2,2,4,-2,3,3,3,0,0,6,2,4,9,Q,EU_UC,Highfield Road,Coventry
1992/93,3,3,Blackburn Rovers,3,5,3,2,0,7,3,4,11,2,2,0,0,2,0,2,6,3,1,2,0,5,3,2,5,Q,EU_UC,Ewood Park,Blackburn
1992/93,3,17,Queens Park Rangers,4,6,3,2,1,8,5,3,11,3,2,1,0,6,3,3,7,3,1,1,1,2,2,0,4,,,MATRADE Loftus Road Stadium,London
1992/93,3,1,Arsenal,5,6,3,1,2,8,6,2,10,3,2,0,1,6,5,1,6,3,1,1,1,2,1,1,4,Q,EU_CWC,Highbury,London
1992/93,3,12,Manchester United,6,6,3,1,2,6,6,0,10,3,1,1,1,2,4,-2,4,3,2,0,1,4,2,2,6,,,Old Trafford,Manchester
1992/93,3,7,Everton,7,5,2,3,0,6,2,4,9,3,1,2,0,2,1,1,5,2,1,1,0,4,1,3,4,,,Goodison Park,Liverpool
1992/93,3,9,Leeds United,8,6,2,3,1,13,10,3,9,3,2,1,0,9,3,6,7,3,0,2,1,4,7,-3,2,,,Elland Road,Leeds
1992/93,3,4,Chelsea,9,6,2,3,1,9,7,2,9,3,1,2,0,2,1,1,5,3,1,1,1,7,6,1,4,,,Stamford Bridge,London
1992/93,3,8,Ipswich Town,10,6,1,5,0,8,7,1,8,3,0,3,0,4,4,0,3,3,1,2,0,4,3,1,5,,,Portman Road,Ipswich
1992/93,3,11,Manchester City,11,6,2,2,2,8,8,0,8,3,1,2,0,7,5,2,5,3,1,0,2,1,3,-2,3,,,Maine Road,Manchester
1992/93,3,13,Middlesbrough,12,5,2,1,2,10,7,3,7,3,2,1,0,8,3,5,7,2,0,0,2,2,4,-2,0,,,Ayresome Park,Middlesbrough
1992/93,3,16,Oldham Athletic,13,6,1,4,1,12,12,0,7,3,1,2,0,8,6,2,5,3,0,2,1,4,6,-2,2,,,Boundary Park,Oldham
1992/93,3,19,Sheffield Wednesday,14,6,1,3,2,9,9,0,6,3,1,1,1,6,5,1,4,3,0,2,1,3,4,-1,2,,,Hillsborough,Sheffield
1992/93,3,2,Aston Villa,15,6,1,3,2,6,7,-1,6,3,0,2,1,3,5,-2,2,3,1,1,1,3,2,1,4,,,Villa Park,Birmingham
1992/93,3,10,Liverpool,16,6,1,3,2,7,9,-2,6,3,1,1,1,3,4,-1,4,3,0,2,1,4,5,-1,2,,,Anfield,Liverpool
1992/93,3,20,Southampton,17,6,1,3,2,5,7,-2,6,3,1,1,1,2,2,0,4,3,0,2,1,3,5,-2,2,,,The Dell,Southampton
1992/93,3,21,Tottenham Hotspur,18,6,1,3,2,5,10,-5,6,3,1,1,1,4,4,0,4,3,0,2,1,1,6,-5,2,,,White Hart Lane,London
1992/93,3,6,Crystal Palace,19,6,0,4,2,8,10,-2,4,3,0,2,1,5,6,-1,2,3,0,2,1,3,4,-1,2,,,Selhurst Park,London
1992/93,3,18,Sheffield United,20,6,1,1,4,7,12,-5,4,3,1,1,1,4,5,-1,4,3,0,0,3,3,7,-4,0,R,EN_D1,Bramall Lane,Sheffield
1992/93,3,15,Nottingham Forest,21,5,1,0,4,5,12,-7,3,2,1,0,1,1,2,-1,3,3,0,0,3,4,10,-6,0,R,EN_D1,The City Ground,Nottingham
1992/93,3,22,Wimbledon,22,6,0,2,4,4,8,-4,2,3,0,0,3,1,4,-3,0,3,0,2,1,3,4,-1,2,R,EN_D1,Selhurst Park,London
1992/93,4,14,Norwich City,1,7,5,1,1,14,9,5,16,4,3,1,0,7,3,4,10,3,2,0,1,7,6,1,6,Q,EU_CL,Carrow Road,Norwich
1992/93,4,5,Coventry City,2,7,5,0,2,9,6,3,15,3,1,0,2,2,4,-2,3,4,4,0,0,7,2,5,12,Q,EU_UC,Highfield Road,Coventry
1992/93,4,3,Blackburn Rovers,3,6,4,2,0,11,4,7,14,3,3,0,0,6,1,5,9,3,1,2,0,5,3,2,5,Q,EU_UC,Ewood Park,Blackburn
1992/93,4,12,Manchester United,4,7,4,1,2,8,6,2,13,4,2,1,1,4,4,0,7,3,2,0,1,4,2,2,6,,,Old Trafford,Manchester
1992/93,4,17,Queens Park Rangers,5,7,3,3,1,8,5,3,12,4,2,2,0,6,3,3,8,3,1,1,1,2,2,0,4,,,MATRADE Loftus Road Stadium,London
1992/93,4,11,Manchester City,6,7,3,2,2,11,8,3,11,3,1,2,0,7,5,2,5,4,2,0,2,4,3,1,6,,,Maine Road,Manchester
1992/93,4,13,Middlesbrough,7,6,3,1,2,12,7,5,10,4,3,1,0,10,3,7,10,2,0,0,2,2,4,-2,0,,,Ayresome Park,Middlesbrough
1992/93,4,1,Arsenal,8,7,3,1,3,10,9,1,10,3,2,0,1,6,5,1,6,4,1,1,2,4,4,0,4,Q,EU_CWC,Highbury,London
1992/93,4,7,Everton,9,6,2,3,1,7,4,3,9,3,1,2,0,2,1,1,5,3,1,1,1,5,3,2,4,,,Goodison Park,Liverpool
1992/93,4,2,Aston Villa,10,7,2,3,2,9,7,2,9,4,1,2,1,6,5,1,5,3,1,1,1,3,2,1,4,,,Villa Park,Birmingham
1992/93,4,9,Leeds United,11,7,2,3,2,13,12,1,9,3,2,1,0,9,3,6,7,4,0,2,2,4,9,-5,2,,,Elland Road,Leeds
1992/93,4,4,Chelsea,12,7,2,3,2,10,9,1,9,3,1,2,0,2,1,1,5,4,1,1,2,8,8,0,4,,,Stamford Bridge,London
1992/93,4,8,Ipswich Town,13,7,1,6,0,8,7,1,9,3,0,3,0,4,4,0,3,4,1,3,0,4,3,1,6,,,Portman Road,Ipswich
1992/93,4,10,Liverpool,14,7,2,3,2,9,10,-1,9,4,2,1,1,5,5,0,7,3,0,2,1,4,5,-1,2,,,Anfield,Liverpool
1992/93,4,21,Tottenham Hotspur,15,7,2,3,2,7,11,-4,9,4,2,1,1,6,5,1,7,3,0,2,1,1,6,-5,2,,,White Hart Lane,London
1992/93,4,16,Oldham Athletic,16,7,1,4,2,12,13,-1,7,4,1,2,1,8,7,1,5,3,0,2,1,4,6,-2,2,,,Boundary Park,Oldham
1992/93,4,19,Sheffield Wednesday,17,7,1,3,3,9,12,-3,6,4,1,1,2,6,8,-2,4,3,0,2,1,3,4,-1,2,,,Hillsborough,Sheffield
1992/93,4,20,Southampton,18,7,1,3,3,5,8,-3,6,3,1,1,1,2,2,0,4,4,0,2,2,3,6,-3,2,,,The Dell,Southampton
1992/93,4,22,Wimbledon,19,7,1,2,4,7,10,-3,5,4,1,0,3,4,6,-2,3,3,0,2,1,3,4,-1,2,,,Selhurst Park,London
1992/93,4,6,Crystal Palace,20,7,0,4,3,8,13,-5,4,3,0,2,1,5,6,-1,2,4,0,2,2,3,7,-4,2,R,EN_D1,Selhurst Park,London
1992/93,4,18,Sheffield United,21,7,1,1,5,7,14,-7,4,3,1,1,1,4,5,-1,4,4,0,0,4,3,9,-6,0,R,EN_D1,Bramall Lane,Sheffield
1992/93,4,15,Nottingham Forest,22,6,1,0,5,6,16,-10,3,2,1,0,1,1,2,-1,3,4,0,0,4,5,14,-9,0,R,EN_D1,The City Ground,Nottingham
1992/93,5,14,Norwich City,1,8,6,1,1,17,11,6,19,4,3,1,0,7,3,4,10,4,3,0,1,10,8,2,9,Q,EU_CL,Carrow Road,Norwich
1992/93,5,5,Coventry City,2,8,6,0,2,10,6,4,18,4,2,0,2,3,4,-1,6,4,4,0,0,7,2,5,12,Q,EU_UC,Highfield Road,Coventry
1992/93,5,3,Blackburn Rovers,3,8,5,2,1,14,7,7,17,4,3,0,1,8,4,4,9,4,2,2,0,6,3,3,8,Q,EU_UC,Ewood Park,Blackburn
1992/93,5,12,Manchester United,4,8,5,1,2,10,6,4,16,4,2,1,1,4,4,0,7,4,3,0,1,6,2,4,9,,,Old Trafford,Manchester
1992/93,5,17,Queens Park Rangers,5,8,4,3,1,10,6,4,15,4,2,2,0,6,3,3,8,4,2,1,1,4,3,1,7,,,MATRADE Loftus Road Stadium,London
1992/93,5,13,Middlesbrough,6,7,4,1,2,13,7,6,13,4,3,1,0,10,3,7,10,3,1,0,2,3,4,-1,3,,,Ayresome Park,Middlesbrough
1992/93,5,7,Everton,7,8,3,3,2,10,8,2,12,4,1,2,1,2,3,-1,5,4,2,1,1,8,5,3,7,,,Goodison Park,Liverpool
1992/93,5,8,Ipswich Town,8,8,2,6,0,10,8,2,12,4,1,3,0,6,5,1,6,4,1,3,0,4,3,1,6,,,Portman Road,Ipswich
1992/93,5,11,Manchester City,9,8,3,2,3,11,9,2,11,4,1,2,1,7,6,1,5,4,2,0,2,4,3,1,6,,,Maine Road,Manchester
1992/93,5,2,Aston Villa,10,8,2,4,2,10,8,2,10,4,1,2,1,6,5,1,5,4,1,2,1,4,3,1,5,,,Villa Park,Birmingham
1992/93,5,9,Leeds United,11,8,2,4,2,14,13,1,10,4,2,2,0,10,4,6,8,4,0,2,2,4,9,-5,2,,,Elland Road,Leeds
1992/93,5,1,Arsenal,12,8,3,1,4,10,10,0,10,4,2,0,2,6,6,0,6,4,1,1,2,4,4,0,4,Q,EU_CWC,Highbury,London
1992/93,5,4,Chelsea,13,8,2,3,3,12,12,0,9,4,1,2,1,4,4,0,5,4,1,1,2,8,8,0,4,,,Stamford Bridge,London
1992/93,5,19,Sheffield Wednesday,14,8,2,3,3,11,13,-2,9,4,1,1,2,6,8,-2,4,4,1,2,1,5,5,0,5,,,Hillsborough,Sheffield
1992/93,5,10,Liverpool,15,8,2,3,3,9,11,-2,9,4,2,1,1,5,5,0,7,4,0,2,2,4,6,-2,2,,,Anfield,Liverpool
1992/93,5,21,Tottenham Hotspur,16,8,2,3,3,7,12,-5,9,4,2,1,1,6,5,1,7,4,0,2,2,1,7,-6,2,,,White Hart Lane,London
1992/93,5,16,Oldham Athletic,17,8,1,5,2,14,15,-1,8,4,1,2,1,8,7,1,5,4,0,3,1,6,8,-2,3,,,Boundary Park,Oldham
1992/93,5,18,Sheffield United,18,8,2,1,5,8,14,-6,7,4,2,1,1,5,5,0,7,4,0,0,4,3,9,-6,0,,,Bramall Lane,Sheffield
1992/93,5,20,Southampton,19,8,1,3,4,6,10,-4,6,4,1,1,2,3,4,-1,4,4,0,2,2,3,6,-3,2,,,The Dell,Southampton
1992/93,5,22,Wimbledon,20,8,1,2,5,8,12,-4,5,4,1,0,3,4,6,-2,3,4,0,2,2,4,6,-2,2,R,EN_D1,Selhurst Park,London
1992/93,5,6,Crystal Palace,21,8,0,5,3,10,15,-5,5,4,0,3,1,7,8,-1,3,4,0,2,2,3,7,-4,2,R,EN_D1,Selhurst Park,London
1992/93,5,15,Nottingham Forest,22,7,1,0,6,7,18,-11,3,3,1,0,2,2,4,-2,3,4,0,0,4,5,14,-9,0,R,EN_D1,The City Ground,Nottingham
1992/93,6,14,Norwich City,1,9,7,1,1,18,11,7,22,5,4,1,0,8,3,5,13,4,3,0,1,10,8,2,9,Q,EU_CL,Carrow Road,Norwich
1992/93,6,5,Coventry City,2,9,6,1,2,11,7,4,19,4,2,0,2,3,4,-1,6,5,4,1,0,8,3,5,13,Q,EU_UC,Highfield Road,Coventry
1992/93,6,3,Blackburn Rovers,3,9,5,3,1,15,8,7,18,4,3,0,1,8,4,4,9,5,2,3,0,7,4,3,9,Q,EU_UC,Ewood Park,Blackburn
1992/93,6,12,Manchester United,4,9,5,2,2,11,7,4,17,4,2,1,1,4,4,0,7,5,3,1,1,7,3,4,10,,,Old Trafford,Manchester
1992/93,6,17,Queens Park Rangers,5,9,4,4,1,13,9,4,16,5,2,3,0,9,6,3,9,4,2,1,1,4,3,1,7,,,MATRADE Loftus Road Stadium,London
1992/93,6,13,Middlesbrough,6,8,4,2,2,16,10,6,14,4,3,1,0,10,3,7,10,4,1,1,2,6,7,-1,4,,,Ayresome Park,Middlesbrough
1992/93,6,2,Aston Villa,7,9,3,4,2,14,10,4,13,5,2,2,1,10,7,3,8,4,1,2,1,4,3,1,5,,,Villa Park,Birmingham
1992/93,6,4,Chelsea,8,9,3,3,3,13,12,1,12,4,1,2,1,4,4,0,5,5,2,1,2,9,8,1,7,,,Stamford Bridge,London
1992/93,6,8,Ipswich Town,9,9,2,6,1,12,12,0,12,4,1,3,0,6,5,1,6,5,1,3,1,6,7,-1,6,,,Portman Road,Ipswich
1992/93,6,7,Everton,10,9,3,3,3,10,10,0,12,5,1,2,2,2,5,-3,5,4,2,1,1,8,5,3,7,,,Goodison Park,Liverpool
1992/93,6,16,Oldham Athletic,11,9,2,5,2,18,17,1,11,5,2,2,1,12,9,3,8,4,0,3,1,6,8,-2,3,,,Boundary Park,Oldham
1992/93,6,9,Leeds United,12,9,2,5,2,15,14,1,11,4,2,2,0,10,4,6,8,5,0,3,2,5,10,-5,3,,,Elland Road,Leeds
1992/93,6,11,Manchester City,13,9,3,2,4,11,10,1,11,5,1,2,2,7,7,0,5,4,2,0,2,4,3,1,6,,,Maine Road,Manchester
1992/93,6,1,Arsenal,14,9,3,2,4,11,11,0,11,4,2,0,2,6,6,0,6,5,1,2,2,5,5,0,5,Q,EU_CWC,Highbury,London
1992/93,6,21,Tottenham Hotspur,15,9,2,4,3,8,13,-5,10,5,2,2,1,7,6,1,8,4,0,2,2,1,7,-6,2,,,White Hart Lane,London
1992/93,6,19,Sheffield Wednesday,16,9,2,3,4,11,14,-3,9,4,1,1,2,6,8,-2,4,5,1,2,2,5,6,-1,5,,,Hillsborough,Sheffield
1992/93,6,10,Liverpool,17,9,2,3,4,11,15,-4,9,4,2,1,1,5,5,0,7,5,0,2,3,6,10,-4,2,,,Anfield,Liverpool
1992/93,6,6,Crystal Palace,18,9,1,5,3,12,15,-3,8,4,0,3,1,7,8,-1,3,5,1,2,2,5,7,-2,5,,,Selhurst Park,London
1992/93,6,18,Sheffield United,19,9,2,2,5,9,15,-6,8,5,2,2,1,6,6,0,8,4,0,0,4,3,9,-6,0,,,Bramall Lane,Sheffield
1992/93,6,20,Southampton,20,9,1,4,4,7,11,-4,7,5,1,2,2,4,5,-1,5,4,0,2,2,3,6,-3,2,R,EN_D1,The Dell,Southampton
1992/93,6,22,Wimbledon,21,9,1,3,5,9,13,-4,6,5,1,1,3,5,7,-2,4,4,0,2,2,4,6,-2,2,R,EN_D1,Selhurst Park,London
1992/93,6,15,Nottingham Forest,22,8,1,1,6,8,19,-11,4,4,1,1,2,3,5,-2,4,4,0,0,4,5,14,-9,0,R,EN_D1,The City Ground,Nottingham
1992/93,7,14,Norwich City,1,10,7,2,1,19,12,7,23,5,4,1,0,8,3,5,13,5,3,1,1,11,9,2,10,Q,EU_CL,Carrow Road,Norwich
1992/93,7,3,Blackburn Rovers,2,10,6,3,1,17,8,9,21,5,4,0,1,10,4,6,12,5,2,3,0,7,4,3,9,Q,EU_UC,Ewood Park,Blackburn
1992/93,7,5,Coventry City,3,10,6,2,2,12,8,4,20,5,2,1,2,4,5,-1,7,5,4,1,0,8,3,5,13,Q,EU_UC,Highfield Road,Coventry
1992/93,7,12,Manchester United,4,10,5,3,2,11,7,4,18,5,2,2,1,4,4,0,8,5,3,1,1,7,3,4,10,,,Old Trafford,Manchester
1992/93,7,17,Queens Park Rangers,5,10,4,5,1,13,9,4,17,5,2,3,0,9,6,3,9,5,2,2,1,4,3,1,8,,,MATRADE Loftus Road Stadium,London
1992/93,7,2,Aston Villa,6,10,4,4,2,17,12,5,16,5,2,2,1,10,7,3,8,5,2,2,1,7,5,2,8,,,Villa Park,Birmingham
1992/93,7,13,Middlesbrough,7,9,4,2,3,18,13,5,14,5,3,1,1,12,6,6,10,4,1,1,2,6,7,-1,4,,,Ayresome Park,Middlesbrough
1992/93,7,9,Leeds United,8,10,3,5,2,17,14,3,14,5,3,2,0,12,4,8,11,5,0,3,2,5,10,-5,3,,,Elland Road,Leeds
1992/93,7,1,Arsenal,9,10,4,2,4,12,11,1,14,5,3,0,2,7,6,1,9,5,1,2,2,5,5,0,5,Q,EU_CWC,Highbury,London
1992/93,7,4,Chelsea,10,10,3,4,3,13,12,1,13,5,1,3,1,4,4,0,6,5,2,1,2,9,8,1,7,,,Stamford Bridge,London
1992/93,7,8,Ipswich Town,11,10,2,7,1,12,12,0,13,5,1,4,0,6,5,1,7,5,1,3,1,6,7,-1,6,,,Portman Road,Ipswich
1992/93,7,19,Sheffield Wednesday,12,10,3,3,4,13,14,-1,12,5,2,1,2,8,8,0,7,5,1,2,2,5,6,-1,5,,,Hillsborough,Sheffield
1992/93,7,7,Everton,13,10,3,3,4,10,12,-2,12,5,1,2,2,2,5,-3,5,5,2,1,2,8,7,1,7,,,Goodison Park,Liverpool
1992/93,7,11,Manchester City,14,10,3,2,5,11,11,0,11,5,1,2,2,7,7,0,5,5,2,0,3,4,4,0,6,,,Maine Road,Manchester
1992/93,7,16,Oldham Athletic,15,10,2,5,3,18,19,-1,11,5,2,2,1,12,9,3,8,5,0,3,2,6,10,-4,3,,,Boundary Park,Oldham
1992/93,7,20,Southampton,16,10,2,4,4,9,12,-3,10,5,1,2,2,4,5,-1,5,5,1,2,2,5,7,-2,5,,,The Dell,Southampton
1992/93,7,21,Tottenham Hotspur,17,10,2,4,4,8,15,-7,10,5,2,2,1,7,6,1,8,5,0,2,3,1,9,-8,2,,,White Hart Lane,London
1992/93,7,22,Wimbledon,18,10,2,3,5,12,15,-3,9,5,1,1,3,5,7,-2,4,5,1,2,2,7,8,-1,5,,,Selhurst Park,London
1992/93,7,10,Liverpool,19,10,2,3,5,13,18,-5,9,5,2,1,2,7,8,-1,7,5,0,2,3,6,10,-4,2,,,Anfield,Liverpool
1992/93,7,18,Sheffield United,20,10,2,3,5,9,15,-6,9,5,2,2,1,6,6,0,8,5,0,1,4,3,9,-6,1,R,EN_D1,Bramall Lane,Sheffield
1992/93,7,6,Crystal Palace,21,10,1,5,4,13,17,-4,8,5,0,3,2,8,10,-2,3,5,1,2,2,5,7,-2,5,R,EN_D1,Selhurst Park,London
1992/93,7,15,Nottingham Forest,22,9,1,2,6,8,19,-11,5,4,1,1,2,3,5,-2,4,5,0,1,4,5,14,-9,1,R,EN_D1,The City Ground,Nottingham
1992/93,8,3,Blackburn Rovers,1,11,7,3,1,24,9,15,24,6,5,0,1,17,5,12,15,5,2,3,0,7,4,3,9,Q,EU_CL,Ewood Park,Blackburn
1992/93,8,14,Norwich City,2,11,7,2,2,20,19,1,23,5,4,1,0,8,3,5,13,6,3,1,2,12,16,-4,10,Q,EU_UC,Carrow Road,Norwich
1992/93,8,5,Coventry City,3,11,6,3,2,14,10,4,21,6,2,2,2,6,7,-1,8,5,4,1,0,8,3,5,13,Q,EU_UC,Highfield Road,Coventry
1992/93,8,17,Queens Park Rangers,4,11,5,5,1,17,10,7,20,6,3,3,0,13,7,6,12,5,2,2,1,4,3,1,8,,,MATRADE Loftus Road Stadium,London
1992/93,8,2,Aston Villa,5,11,5,4,2,20,14,6,19,5,2,2,1,10,7,3,8,6,3,2,1,10,7,3,11,,,Villa Park,Birmingham
1992/93,8,12,Manchester United,6,11,5,4,2,12,8,4,19,5,2,2,1,4,4,0,8,6,3,2,1,8,4,4,11,,,Old Trafford,Manchester
1992/93,8,1,Arsenal,7,11,5,2,4,14,12,2,17,6,4,0,2,9,7,2,12,5,1,2,2,5,5,0,5,Q,EU_CWC,Highbury,London
1992/93,8,8,Ipswich Town,8,11,3,7,1,16,14,2,16,6,2,4,0,10,7,3,10,5,1,3,1,6,7,-1,6,,,Portman Road,Ipswich
1992/93,8,13,Middlesbrough,9,10,4,3,3,19,14,5,15,6,3,2,1,13,7,6,11,4,1,1,2,6,7,-1,4,,,Ayresome Park,Middlesbrough
1992/93,8,9,Leeds United,10,11,3,5,3,19,18,1,14,5,3,2,0,12,4,8,11,6,0,3,3,7,14,-7,3,,,Elland Road,Leeds
1992/93,8,16,Oldham Athletic,11,11,3,5,3,19,19,0,14,6,3,2,1,13,9,4,11,5,0,3,2,6,10,-4,3,,,Boundary Park,Oldham
1992/93,8,4,Chelsea,12,11,3,4,4,14,14,0,13,5,1,3,1,4,4,0,6,6,2,1,3,10,10,0,7,,,Stamford Bridge,London
1992/93,8,11,Manchester City,13,11,3,3,5,13,13,0,12,6,1,3,2,9,9,0,6,5,2,0,3,4,4,0,6,,,Maine Road,Manchester
1992/93,8,19,Sheffield Wednesday,14,11,3,3,5,13,15,-2,12,5,2,1,2,8,8,0,7,6,1,2,3,5,7,-2,5,,,Hillsborough,Sheffield
1992/93,8,7,Everton,15,11,3,3,5,10,13,-3,12,5,1,2,2,2,5,-3,5,6,2,1,3,8,8,0,7,,,Goodison Park,Liverpool
1992/93,8,10,Liverpool,16,11,3,3,5,14,18,-4,12,6,3,1,2,8,8,0,10,5,0,2,3,6,10,-4,2,,,Anfield,Liverpool
1992/93,8,18,Sheffield United,17,11,3,3,5,11,15,-4,12,6,3,2,1,8,6,2,11,5,0,1,4,3,9,-6,1,,,Bramall Lane,Sheffield
1992/93,8,20,Southampton,18,11,2,4,5,9,14,-5,10,5,1,2,2,4,5,-1,5,6,1,2,3,5,9,-4,5,,,The Dell,Southampton
1992/93,8,21,Tottenham Hotspur,19,11,2,4,5,9,19,-10,10,5,2,2,1,7,6,1,8,6,0,2,4,2,13,-11,2,,,White Hart Lane,London
1992/93,8,6,Crystal Palace,20,11,1,6,4,15,19,-4,9,5,0,3,2,8,10,-2,3,6,1,3,2,7,9,-2,6,R,EN_D1,Selhurst Park,London
1992/93,8,22,Wimbledon,21,11,2,3,6,14,18,-4,9,6,1,1,4,7,10,-3,4,5,1,2,2,7,8,-1,5,R,EN_D1,Selhurst Park,London
1992/93,8,15,Nottingham Forest,22,10,1,3,6,10,21,-11,6,4,1,1,2,3,5,-2,4,6,0,2,4,7,16,-9,2,R,EN_D1,The City Ground,Nottingham
1992/93,9,14,Norwich City,1,12,8,2,2,22,20,2,26,6,5,1,0,10,4,6,16,6,3,1,2,12,16,-4,10,Q,EU_CL,Carrow Road,Norwich
1992/93,9,3,Blackburn Rovers,2,12,7,4,1,24,9,15,25,6,5,0,1,17,5,12,15,6,2,4,0,7,4,3,10,Q,EU_UC,Ewood Park,Blackburn
1992/93,9,5,Coventry City,3,12,6,4,2,15,11,4,22,6,2,2,2,6,7,-1,8,6,4,2,0,9,4,5,14,Q,EU_UC,Highfield Road,Coventry
1992/93,9,2,Aston Villa,4,12,5,5,2,20,14,6,20,6,2,3,1,10,7,3,9,6,3,2,1,10,7,3,11,,,Villa Park,Birmingham
1992/93,9,17,Queens Park Rangers,5,12,5,5,2,18,12,6,20,6,3,3,0,13,7,6,12,6,2,2,2,5,5,0,8,,,MATRADE Loftus Road Stadium,London
1992/93,9,12,Manchester United,6,12,5,5,2,14,10,4,20,6,2,3,1,6,6,0,9,6,3,2,1,8,4,4,11,,,Old Trafford,Manchester
1992/93,9,1,Arsenal,7,12,6,2,4,15,12,3,20,6,4,0,2,9,7,2,12,6,2,2,2,6,5,1,8,Q,EU_CWC,Highbury,London
1992/93,9,9,Leeds United,8,12,4,5,3,22,19,3,17,6,4,2,0,15,5,10,14,6,0,3,3,7,14,-7,3,,,Elland Road,Leeds
1992/93,9,13,Middlesbrough,9,12,4,4,4,21,17,4,16,6,3,2,1,13,7,6,11,6,1,2,3,8,10,-2,5,,,Ayresome Park,Middlesbrough
1992/93,9,8,Ipswich Town,10,12,3,7,2,17,16,1,16,6,2,4,0,10,7,3,10,6,1,3,2,7,9,-2,6,,,Portman Road,Ipswich
1992/93,9,4,Chelsea,11,12,4,4,4,16,15,1,16,6,2,3,1,6,5,1,9,6,2,1,3,10,10,0,7,,,Stamford Bridge,London
1992/93,9,19,Sheffield Wednesday,12,12,4,3,5,15,16,-1,15,6,3,1,2,10,9,1,10,6,1,2,3,5,7,-2,5,,,Hillsborough,Sheffield
1992/93,9,16,Oldham Athletic,13,12,3,5,4,20,21,-1,14,6,3,2,1,13,9,4,11,6,0,3,3,7,12,-5,3,,,Boundary Park,Oldham
1992/93,9,11,Manchester City,14,12,3,4,5,13,13,0,13,6,1,3,2,9,9,0,6,6,2,1,3,4,4,0,7,,,Maine Road,Manchester
1992/93,9,7,Everton,15,12,3,4,5,11,14,-3,13,6,1,3,2,3,6,-3,6,6,2,1,3,8,8,0,7,,,Goodison Park,Liverpool
1992/93,9,10,Liverpool,16,12,3,4,5,16,20,-4,13,6,3,1,2,8,8,0,10,6,0,3,3,8,12,-4,3,,,Anfield,Liverpool
1992/93,9,18,Sheffield United,17,12,3,3,6,12,18,-6,12,6,3,2,1,8,6,2,11,6,0,1,5,4,12,-8,1,,,Bramall Lane,Sheffield
1992/93,9,20,Southampton,18,12,2,5,5,11,16,-5,11,6,1,3,2,6,7,-1,6,6,1,2,3,5,9,-4,5,,,The Dell,Southampton
1992/93,9,21,Tottenham Hotspur,19,12,2,5,5,11,21,-10,11,6,2,3,1,9,8,1,9,6,0,2,4,2,13,-11,2,,,White Hart Lane,London
1992/93,9,22,Wimbledon,20,12,2,4,6,16,20,-4,10,6,1,1,4,7,10,-3,4,6,1,3,2,9,10,-1,6,R,EN_D1,Selhurst Park,London
1992/93,9,6,Crystal Palace,21,12,1,7,4,15,19,-4,10,6,0,4,2,8,10,-2,4,6,1,3,2,7,9,-2,6,R,EN_D1,Selhurst Park,London
1992/93,9,15,Nottingham Forest,22,12,2,3,7,11,22,-11,9,6,2,1,3,4,6,-2,7,6,0,2,4,7,16,-9,2,R,EN_D1,The City Ground,Nottingham
1992/93,10,3,Blackburn Rovers,1,13,7,5,1,24,9,15,26,7,5,1,1,17,5,12,16,6,2,4,0,7,4,3,10,Q,EU_CL,Ewood Park,Blackburn
1992/93,10,14,Norwich City,2,13,8,2,3,23,24,-1,26,6,5,1,0,10,4,6,16,7,3,1,3,13,20,-7,10,Q,EU_UC,Carrow Road,Norwich
1992/93,10,17,Queens Park Rangers,3,13,6,5,2,20,13,7,23,7,4,3,0,15,8,7,15,6,2,2,2,5,5,0,8,Q,EU_UC,MATRADE Loftus Road Stadium,London
1992/93,10,1,Arsenal,4,13,7,2,4,17,12,5,23,7,5,0,2,11,7,4,15,6,2,2,2,6,5,1,8,Q,EU_CWC,Highbury,London
1992/93,10,5,Coventry City,5,13,6,4,3,16,13,3,22,7,2,2,3,7,9,-2,8,6,4,2,0,9,4,5,14,,,Highfield Road,Coventry
1992/93,10,2,Aston Villa,6,13,5,6,2,21,15,6,21,6,2,3,1,10,7,3,9,7,3,3,1,11,8,3,12,,,Villa Park,Birmingham
1992/93,10,12,Manchester United,7,13,5,6,2,14,10,4,21,6,2,3,1,6,6,0,9,7,3,3,1,8,4,4,12,,,Old Trafford,Manchester
1992/93,10,4,Chelsea,8,13,5,4,4,18,16,2,19,6,2,3,1,6,5,1,9,7,3,1,3,12,11,1,10,,,Stamford Bridge,London
1992/93,10,13,Middlesbrough,9,13,4,5,4,22,18,4,17,7,3,3,1,14,8,6,12,6,1,2,3,8,10,-2,5,,,Ayresome Park,Middlesbrough
1992/93,10,9,Leeds United,10,13,4,5,4,23,21,2,17,6,4,2,0,15,5,10,14,7,0,3,4,8,16,-8,3,,,Elland Road,Leeds
1992/93,10,8,Ipswich Town,11,13,3,8,2,19,18,1,17,7,2,5,0,12,9,3,11,6,1,3,2,7,9,-2,6,,,Portman Road,Ipswich
1992/93,10,11,Manchester City,12,13,4,4,5,14,13,1,16,7,2,3,2,10,9,1,9,6,2,1,3,4,4,0,7,,,Maine Road,Manchester
1992/93,10,10,Liverpool,13,13,4,4,5,20,21,-1,16,7,4,1,2,12,9,3,13,6,0,3,3,8,12,-4,3,,,Anfield,Liverpool
1992/93,10,19,Sheffield Wednesday,14,13,4,4,5,16,17,-1,16,6,3,1,2,10,9,1,10,7,1,3,3,6,8,-2,6,,,Hillsborough,Sheffield
1992/93,10,16,Oldham Athletic,15,13,3,6,4,21,22,-1,15,7,3,3,1,14,10,4,12,6,0,3,3,7,12,-5,3,,,Boundary Park,Oldham
1992/93,10,7,Everton,16,13,3,4,6,11,16,-5,13,6,1,3,2,3,6,-3,6,7,2,1,4,8,10,-2,7,,,Goodison Park,Liverpool
1992/93,10,18,Sheffield United,17,13,3,4,6,12,18,-6,13,7,3,3,1,8,6,2,12,6,0,1,5,4,12,-8,1,,,Bramall Lane,Sheffield
1992/93,10,21,Tottenham Hotspur,18,13,2,6,5,12,22,-10,12,6,2,3,1,9,8,1,9,7,0,3,4,3,14,-11,3,,,White Hart Lane,London
1992/93,10,6,Crystal Palace,19,13,1,8,4,17,21,-4,11,6,0,4,2,8,10,-2,4,7,1,4,2,9,11,-2,7,,,Selhurst Park,London
1992/93,10,22,Wimbledon,20,13,2,5,6,17,21,-4,11,7,1,2,4,8,11,-3,5,6,1,3,2,9,10,-1,6,R,EN_D1,Selhurst Park,London
1992/93,10,20,Southampton,21,13,2,5,6,11,17,-6,11,6,1,3,2,6,7,-1,6,7,1,2,4,5,10,-5,5,R,EN_D1,The Dell,Southampton
1992/93,10,15,Nottingham Forest,22,13,2,4,7,11,22,-11,10,6,2,1,3,4,6,-2,7,7,0,3,4,7,16,-9,3,R,EN_D1,The City Ground,Nottingham
1992/93,11,3,Blackburn Rovers,1,14,7,6,1,24,9,15,27,7,5,1,1,17,5,12,16,7,2,5,0,7,4,3,11,Q,EU_CL,Ewood Park,Blackburn
1992/93,11,14,Norwich City,2,14,8,3,3,24,25,-1,27,7,5,2,0,11,5,6,17,7,3,1,3,13,20,-7,10,Q,EU_UC,Carrow Road,Norwich
1992/93,11,1,Arsenal,3,14,8,2,4,19,13,6,26,7,5,0,2,11,7,4,15,7,3,2,2,8,6,2,11,"Q,Q","EU_UC,EU_CWC",Highbury,London
1992/93,11,2,Aston Villa,4,14,6,6,2,23,15,8,24,7,3,3,1,12,7,5,12,7,3,3,1,11,8,3,12,,,Villa Park,Birmingham
1992/93,11,17,Queens Park Rangers,5,14,6,5,3,20,15,5,23,7,4,3,0,15,8,7,15,7,2,2,3,5,7,-2,8,,,MATRADE Loftus Road Stadium,London
1992/93,11,5,Coventry City,6,14,6,5,3,18,15,3,23,7,2,2,3,7,9,-2,8,7,4,3,0,11,6,5,15,,,Highfield Road,Coventry
1992/93,11,12,Manchester United,7,14,5,6,3,14,11,3,21,7,2,3,2,6,7,-1,9,7,3,3,1,8,4,4,12,,,Old Trafford,Manchester
1992/93,11,8,Ipswich Town,8,14,4,8,2,20,18,2,20,7,2,5,0,12,9,3,11,7,2,3,2,8,9,-1,9,,,Portman Road,Ipswich
1992/93,11,11,Manchester City,9,14,5,4,5,17,14,3,19,7,2,3,2,10,9,1,9,7,3,1,3,7,5,2,10,,,Maine Road,Manchester
1992/93,11,4,Chelsea,10,14,5,4,5,19,18,1,19,7,2,3,2,7,7,0,9,7,3,1,3,12,11,1,10,,,Stamford Bridge,London
1992/93,11,13,Middlesbrough,11,14,4,6,4,23,19,4,18,7,3,3,1,14,8,6,12,7,1,3,3,9,11,-2,6,,,Ayresome Park,Middlesbrough
1992/93,11,9,Leeds United,12,14,4,6,4,25,23,2,18,7,4,3,0,17,7,10,15,7,0,3,4,8,16,-8,3,,,Elland Road,Leeds
1992/93,11,19,Sheffield Wednesday,13,14,4,5,5,16,17,-1,17,7,3,2,2,10,9,1,11,7,1,3,3,6,8,-2,6,,,Hillsborough,Sheffield
1992/93,11,10,Liverpool,14,14,4,4,6,20,23,-3,16,7,4,1,2,12,9,3,13,7,0,3,4,8,14,-6,3,,,Anfield,Liverpool
1992/93,11,18,Sheffield United,15,14,4,4,6,14,19,-5,16,7,3,3,1,8,6,2,12,7,1,1,5,6,13,-7,4,,,Bramall Lane,Sheffield
1992/93,11,16,Oldham Athletic,16,14,3,6,5,21,23,-2,15,7,3,3,1,14,10,4,12,7,0,3,4,7,13,-6,3,,,Boundary Park,Oldham
1992/93,11,21,Tottenham Hotspur,17,14,3,6,5,14,22,-8,15,7,3,3,1,11,8,3,12,7,0,3,4,3,14,-11,3,,,White Hart Lane,London
1992/93,11,22,Wimbledon,18,14,3,5,6,18,21,-3,14,7,1,2,4,8,11,-3,5,7,2,3,2,10,10,0,9,,,Selhurst Park,London
1992/93,11,20,Southampton,19,14,3,5,6,12,17,-5,14,7,2,3,2,7,7,0,9,7,1,2,4,5,10,-5,5,,,The Dell,Southampton
1992/93,11,7,Everton,20,14,3,4,7,12,19,-7,13,7,1,3,3,4,9,-5,6,7,2,1,4,8,10,-2,7,R,EN_D1,Goodison Park,Liverpool
1992/93,11,6,Crystal Palace,21,14,1,8,5,18,23,-5,11,7,0,4,3,9,12,-3,4,7,1,4,2,9,11,-2,7,R,EN_D1,Selhurst Park,London
1992/93,11,15,Nottingham Forest,22,14,2,4,8,11,23,-12,10,7,2,1,4,4,7,-3,7,7,0,3,4,7,16,-9,3,R,EN_D1,The City Ground,Nottingham
1992/93,12,14,Norwich City,1,15,9,3,3,27,27,0,30,7,5,2,0,11,5,6,17,8,4,1,3,16,22,-6,13,Q,EU_CL,Carrow Road,Norwich
1992/93,12,1,Arsenal,2,15,9,2,4,22,13,9,29,8,6,0,2,14,7,7,18,7,3,2,2,8,6,2,11,"Q,Q","EU_UC,EU_CWC",Highbury,London
1992/93,12,3,Blackburn Rovers,3,15,7,6,2,24,11,13,27,8,5,1,2,17,7,10,16,7,2,5,0,7,4,3,11,Q,EU_UC,Ewood Park,Blackburn
1992/93,12,2,Aston Villa,4,15,7,6,2,24,15,9,27,8,4,3,1,13,7,6,15,7,3,3,1,11,8,3,12,,,Villa Park,Birmingham
1992/93,12,17,Queens Park Rangers,5,15,7,5,3,22,15,7,26,7,4,3,0,15,8,7,15,8,3,2,3,7,7,0,11,,,MATRADE Loftus Road Stadium,London
1992/93,12,5,Coventry City,6,15,6,5,4,18,18,0,23,7,2,2,3,7,9,-2,8,8,4,3,1,11,9,2,15,,,Highfield Road,Coventry
1992/93,12,11,Manchester City,7,15,6,4,5,21,14,7,22,8,3,3,2,14,9,5,12,7,3,1,3,7,5,2,10,,,Maine Road,Manchester
1992/93,12,4,Chelsea,8,15,6,4,5,22,19,3,22,8,3,3,2,10,8,2,12,7,3,1,3,12,11,1,10,,,Stamford Bridge,London
1992/93,12,8,Ipswich Town,9,15,4,9,2,20,18,2,21,8,2,6,0,12,9,3,12,7,2,3,2,8,9,-1,9,,,Portman Road,Ipswich
1992/93,12,12,Manchester United,10,15,5,6,4,14,12,2,21,7,2,3,2,6,7,-1,9,8,3,3,2,8,5,3,12,,,Old Trafford,Manchester
1992/93,12,10,Liverpool,11,15,5,4,6,24,24,0,19,8,5,1,2,16,10,6,16,7,0,3,4,8,14,-6,3,,,Anfield,Liverpool
1992/93,12,13,Middlesbrough,12,15,4,6,5,24,23,1,18,7,3,3,1,14,8,6,12,8,1,3,4,10,15,-5,6,,,Ayresome Park,Middlesbrough
1992/93,12,19,Sheffield Wednesday,13,15,4,6,5,17,18,-1,18,7,3,2,2,10,9,1,11,8,1,4,3,7,9,-2,7,,,Hillsborough,Sheffield
1992/93,12,9,Leeds United,14,15,4,6,5,25,27,-2,18,7,4,3,0,17,7,10,15,8,0,3,5,8,20,-12,3,,,Elland Road,Leeds
1992/93,12,21,Tottenham Hotspur,15,15,4,6,5,16,22,-6,18,7,3,3,1,11,8,3,12,8,1,3,4,5,14,-9,6,,,White Hart Lane,London
1992/93,12,18,Sheffield United,16,15,4,5,6,15,20,-5,17,8,3,4,1,9,7,2,13,7,1,1,5,6,13,-7,4,,,Bramall Lane,Sheffield
1992/93,12,7,Everton,17,15,4,4,7,13,19,-6,16,7,1,3,3,4,9,-5,6,8,3,1,4,9,10,-1,10,,,Goodison Park,Liverpool
1992/93,12,16,Oldham Athletic,18,15,3,6,6,23,26,-3,15,8,3,3,2,16,13,3,12,7,0,3,4,7,13,-6,3,,,Boundary Park,Oldham
1992/93,12,20,Southampton,19,15,3,6,6,12,17,-5,15,7,2,3,2,7,7,0,9,8,1,3,4,5,10,-5,6,,,The Dell,Southampton
1992/93,12,22,Wimbledon,20,15,3,5,7,18,23,-5,14,8,1,2,5,8,13,-5,5,7,2,3,2,10,10,0,9,R,EN_D1,Selhurst Park,London
1992/93,12,6,Crystal Palace,21,15,1,8,6,19,26,-7,11,7,0,4,3,9,12,-3,4,8,1,4,3,10,14,-4,7,R,EN_D1,Selhurst Park,London
1992/93,12,15,Nottingham Forest,22,15,2,4,9,11,24,-13,10,8,2,1,5,4,8,-4,7,7,0,3,4,7,16,-9,3,R,EN_D1,The City Ground,Nottingham
1992/93,13,14,Norwich City,1,16,10,3,3,29,28,1,33,8,6,2,0,13,6,7,20,8,4,1,3,16,22,-6,13,Q,EU_CL,Carrow Road,Norwich
1992/93,13,1,Arsenal,2,16,9,2,5,22,16,6,29,8,6,0,2,14,7,7,18,8,3,2,3,8,9,-1,11,"Q,Q","EU_UC,EU_CWC",Highbury,London
1992/93,13,3,Blackburn Rovers,3,16,7,7,2,25,12,13,28,8,5,1,2,17,7,10,16,8,2,6,0,8,5,3,12,Q,EU_UC,Ewood Park,Blackburn
1992/93,13,2,Aston Villa,4,16,7,7,2,24,15,9,28,8,4,3,1,13,7,6,15,8,3,4,1,11,8,3,13,,,Villa Park,Birmingham
1992/93,13,17,Queens Park Rangers,5,16,7,5,4,22,16,6,26,8,4,3,1,15,9,6,15,8,3,2,3,7,7,0,11,,,MATRADE Loftus Road Stadium,London
1992/93,13,11,Manchester City,6,16,7,4,5,24,16,8,25,8,3,3,2,14,9,5,12,8,4,1,3,10,7,3,13,,,Maine Road,Manchester
1992/93,13,4,Chelsea,7,16,7,4,5,23,19,4,25,8,3,3,2,10,8,2,12,8,4,1,3,13,11,2,13,,,Stamford Bridge,London
1992/93,13,12,Manchester United,8,16,6,6,4,17,12,5,24,8,3,3,2,9,7,2,12,8,3,3,2,8,5,3,12,,,Old Trafford,Manchester
1992/93,13,5,Coventry City,9,16,6,5,5,20,21,-1,23,8,2,2,4,9,12,-3,8,8,4,3,1,11,9,2,15,,,Highfield Road,Coventry
1992/93,13,8,Ipswich Town,10,16,4,10,2,21,19,2,22,8,2,6,0,12,9,3,12,8,2,4,2,9,10,-1,10,,,Portman Road,Ipswich
1992/93,13,10,Liverpool,11,16,6,4,6,25,24,1,22,8,5,1,2,16,10,6,16,8,1,3,4,9,14,-5,6,,,Anfield,Liverpool
1992/93,13,13,Middlesbrough,12,16,5,6,5,26,23,3,21,8,4,3,1,16,8,8,15,8,1,3,4,10,15,-5,6,,,Ayresome Park,Middlesbrough
1992/93,13,9,Leeds United,13,16,5,6,5,28,27,1,21,8,5,3,0,20,7,13,18,8,0,3,5,8,20,-12,3,,,Elland Road,Leeds
1992/93,13,19,Sheffield Wednesday,14,16,4,7,5,18,19,-1,19,8,3,3,2,11,10,1,12,8,1,4,3,7,9,-2,7,,,Hillsborough,Sheffield
1992/93,13,21,Tottenham Hotspur,15,16,4,7,5,16,22,-6,19,8,3,4,1,11,8,3,13,8,1,3,4,5,14,-9,6,,,White Hart Lane,London
1992/93,13,18,Sheffield United,16,16,4,5,7,16,22,-6,17,8,3,4,1,9,7,2,13,8,1,1,6,7,15,-8,4,,,Bramall Lane,Sheffield
1992/93,13,20,Southampton,17,16,3,7,6,13,18,-5,16,8,2,4,2,8,8,0,10,8,1,3,4,5,10,-5,6,,,The Dell,Southampton
1992/93,13,7,Everton,18,16,4,4,8,13,20,-7,16,8,1,3,4,4,10,-6,6,8,3,1,4,9,10,-1,10,,,Goodison Park,Liverpool
1992/93,13,16,Oldham Athletic,19,16,3,6,7,23,29,-6,15,8,3,3,2,16,13,3,12,8,0,3,5,7,16,-9,3,,,Boundary Park,Oldham
1992/93,13,22,Wimbledon,20,16,3,5,8,18,25,-7,14,8,1,2,5,8,13,-5,5,8,2,3,3,10,12,-2,9,R,EN_D1,Selhurst Park,London
1992/93,13,6,Crystal Palace,21,16,1,9,6,20,27,-7,12,8,0,5,3,10,13,-3,5,8,1,4,3,10,14,-4,7,R,EN_D1,Selhurst Park,London
1992/93,13,15,Nottingham Forest,22,16,2,5,9,12,25,-13,11,8,2,1,5,4,8,-4,7,8,0,4,4,8,17,-9,4,R,EN_D1,The City Ground,Nottingham
1992/93,14,14,Norwich City,1,17,11,3,3,32,30,2,36,8,6,2,0,13,6,7,20,9,5,1,3,19,24,-5,16,Q,EU_CL,Carrow Road,Norwich
1992/93,14,3,Blackburn Rovers,2,17,8,7,2,26,12,14,31,9,6,1,2,18,7,11,19,8,2,6,0,8,5,3,12,Q,EU_UC,Ewood Park,Blackburn
1992/93,14,1,Arsenal,3,17,9,2,6,22,17,5,29,9,6,0,3,14,8,6,18,8,3,2,3,8,9,-1,11,"Q,Q","EU_UC,EU_CWC",Highbury,London
1992/93,14,2,Aston Villa,4,17,7,7,3,26,18,8,28,9,4,3,2,15,10,5,15,8,3,4,1,11,8,3,13,,,Villa Park,Birmingham
1992/93,14,4,Chelsea,5,17,8,4,5,24,19,5,28,9,4,3,2,11,8,3,15,8,4,1,3,13,11,2,13,,,Stamford Bridge,London
1992/93,14,12,Manchester United,6,17,7,6,4,18,12,6,27,8,3,3,2,9,7,2,12,9,4,3,2,9,5,4,15,,,Old Trafford,Manchester
1992/93,14,17,Queens Park Rangers,7,17,7,5,5,22,17,5,26,8,4,3,1,15,9,6,15,9,3,2,4,7,8,-1,11,,,MATRADE Loftus Road Stadium,London
1992/93,14,11,Manchester City,8,17,7,4,6,24,17,7,25,9,3,3,3,14,10,4,12,8,4,1,3,10,7,3,13,,,Maine Road,Manchester
1992/93,14,10,Liverpool,9,17,7,4,6,30,24,6,25,9,6,1,2,21,10,11,19,8,1,3,4,9,14,-5,6,,,Anfield,Liverpool
1992/93,14,8,Ipswich Town,10,17,5,10,2,22,19,3,25,9,3,6,0,13,9,4,15,8,2,4,2,9,10,-1,10,,,Portman Road,Ipswich
1992/93,14,5,Coventry City,11,17,6,6,5,21,22,-1,24,8,2,2,4,9,12,-3,8,9,4,4,1,12,10,2,16,,,Highfield Road,Coventry
1992/93,14,21,Tottenham Hotspur,12,17,5,7,5,17,22,-5,22,8,3,4,1,11,8,3,13,9,2,3,4,6,14,-8,9,,,White Hart Lane,London
1992/93,14,9,Leeds United,13,17,5,6,6,28,28,0,21,8,5,3,0,20,7,13,18,9,0,3,6,8,21,-13,3,,,Elland Road,Leeds
1992/93,14,13,Middlesbrough,14,17,5,6,6,27,27,0,21,8,4,3,1,16,8,8,15,9,1,3,5,11,19,-8,6,,,Ayresome Park,Middlesbrough
1992/93,14,19,Sheffield Wednesday,15,17,4,8,5,19,20,-1,20,8,3,3,2,11,10,1,12,9,1,5,3,8,10,-2,8,,,Hillsborough,Sheffield
1992/93,14,20,Southampton,16,17,4,7,6,15,19,-4,19,8,2,4,2,8,8,0,10,9,2,3,4,7,11,-4,9,,,The Dell,Southampton
1992/93,14,16,Oldham Athletic,17,17,4,6,7,27,30,-3,18,9,4,3,2,20,14,6,15,8,0,3,5,7,16,-9,3,,,Boundary Park,Oldham
1992/93,14,18,Sheffield United,18,17,4,6,7,17,23,-6,18,9,3,5,1,10,8,2,14,8,1,1,6,7,15,-8,4,,,Bramall Lane,Sheffield
1992/93,14,7,Everton,19,17,4,4,9,13,21,-8,16,8,1,3,4,4,10,-6,6,9,3,1,5,9,11,-2,10,,,Goodison Park,Liverpool
1992/93,14,22,Wimbledon,20,17,3,6,8,19,26,-7,15,9,1,3,5,9,14,-5,6,8,2,3,3,10,12,-2,9,R,EN_D1,Selhurst Park,London
1992/93,14,6,Crystal Palace,21,17,1,9,7,20,32,-12,12,8,0,5,3,10,13,-3,5,9,1,4,4,10,19,-9,7,R,EN_D1,Selhurst Park,London
1992/93,14,15,Nottingham Forest,22,17,2,5,10,13,27,-14,11,9,2,1,6,5,10,-5,7,8,0,4,4,8,17,-9,4,R,EN_D1,The City Ground,Nottingham
1992/93,15,14,Norwich City,1,18,12,3,3,34,31,3,39,9,7,2,0,15,7,8,23,9,5,1,3,19,24,-5,16,Q,EU_CL,Carrow Road,Norwich
1992/93,15,3,Blackburn Rovers,2,18,8,7,3,28,15,13,31,9,6,1,2,18,7,11,19,9,2,6,1,10,8,2,12,Q,EU_UC,Ewood Park,Blackburn
1992/93,15,2,Aston Villa,3,18,8,7,3,28,19,9,31,9,4,3,2,15,10,5,15,9,4,4,1,13,9,4,16,Q,EU_UC,Villa Park,Birmingham
1992/93,15,4,Chelsea,4,18,9,4,5,26,20,6,31,9,4,3,2,11,8,3,15,9,5,1,3,15,12,3,16,,,Stamford Bridge,London
1992/93,15,12,Manchester United,5,18,8,6,4,20,13,7,30,9,4,3,2,11,8,3,15,9,4,3,2,9,5,4,15,,,Old Trafford,Manchester
1992/93,15,17,Queens Park Rangers,6,18,8,5,5,25,19,6,29,9,5,3,1,18,11,7,18,9,3,2,4,7,8,-1,11,,,MATRADE Loftus Road Stadium,London
1992/93,15,1,Arsenal,7,18,9,2,7,22,19,3,29,9,6,0,3,14,8,6,18,9,3,2,4,8,11,-3,11,Q,EU_CWC,Highbury,London
1992/93,15,8,Ipswich Town,8,18,5,11,2,24,21,3,26,9,3,6,0,13,9,4,15,9,2,5,2,11,12,-1,11,,,Portman Road,Ipswich
1992/93,15,11,Manchester City,9,18,7,4,7,25,19,6,25,9,3,3,3,14,10,4,12,9,4,1,4,11,9,2,13,,,Maine Road,Manchester
1992/93,15,10,Liverpool,10,18,7,4,7,31,26,5,25,9,6,1,2,21,10,11,19,9,1,3,5,10,16,-6,6,,,Anfield,Liverpool
1992/93,15,5,Coventry City,11,18,6,7,5,23,24,-1,25,9,2,3,4,11,14,-3,9,9,4,4,1,12,10,2,16,,,Highfield Road,Coventry
1992/93,15,13,Middlesbrough,12,18,6,6,6,30,29,1,24,9,5,3,1,19,10,9,18,9,1,3,5,11,19,-8,6,,,Ayresome Park,Middlesbrough
1992/93,15,20,Southampton,13,18,5,7,6,17,19,-2,22,9,3,4,2,10,8,2,13,9,2,3,4,7,11,-4,9,,,The Dell,Southampton
1992/93,15,21,Tottenham Hotspur,14,18,5,7,6,18,24,-6,22,9,3,4,2,12,10,2,13,9,2,3,4,6,14,-8,9,,,White Hart Lane,London
1992/93,15,9,Leeds United,15,18,5,6,7,29,32,-3,21,9,5,3,1,21,11,10,18,9,0,3,6,8,21,-13,3,,,Elland Road,Leeds
1992/93,15,19,Sheffield Wednesday,16,18,4,8,6,20,22,-2,20,9,3,3,3,12,12,0,12,9,1,5,3,8,10,-2,8,,,Hillsborough,Sheffield
1992/93,15,7,Everton,17,18,5,4,9,15,22,-7,19,9,2,3,4,6,11,-5,9,9,3,1,5,9,11,-2,10,,,Goodison Park,Liverpool
1992/93,15,16,Oldham Athletic,18,18,4,6,8,29,33,-4,18,9,4,3,2,20,14,6,15,9,0,3,6,9,19,-10,3,,,Boundary Park,Oldham
1992/93,15,18,Sheffield United,19,18,4,6,8,17,25,-8,18,9,3,5,1,10,8,2,14,9,1,1,7,7,17,-10,4,,,Bramall Lane,Sheffield
1992/93,15,22,Wimbledon,20,18,3,6,9,20,28,-8,15,9,1,3,5,9,14,-5,6,9,2,3,4,11,14,-3,9,R,EN_D1,Selhurst Park,London
1992/93,15,6,Crystal Palace,21,18,2,9,7,22,32,-10,15,9,1,5,3,12,13,-1,8,9,1,4,4,10,19,-9,7,R,EN_D1,Selhurst Park,London
1992/93,15,15,Nottingham Forest,22,18,3,5,10,17,28,-11,14,9,2,1,6,5,10,-5,7,9,1,4,4,12,18,-6,7,R,EN_D1,The City Ground,Nottingham
1992/93,16,14,Norwich City,1,19,12,3,4,34,32,2,39,9,7,2,0,15,7,8,23,10,5,1,4,19,25,-6,16,Q,EU_CL,Carrow Road,Norwich
1992/93,16,2,Aston Villa,2,19,9,7,3,30,20,10,34,10,5,3,2,17,11,6,18,9,4,4,1,13,9,4,16,Q,EU_UC,Villa Park,Birmingham
1992/93,16,12,Manchester United,3,19,9,6,4,21,13,8,33,10,5,3,2,12,8,4,18,9,4,3,2,9,5,4,15,Q,EU_UC,Old Trafford,Manchester
1992/93,16,4,Chelsea,4,19,9,5,5,26,20,6,32,9,4,3,2,11,8,3,15,10,5,2,3,15,12,3,17,,,Stamford Bridge,London
1992/93,16,3,Blackburn Rovers,5,19,8,7,4,29,17,12,31,9,6,1,2,18,7,11,19,10,2,6,2,11,10,1,12,,,Ewood Park,Blackburn
1992/93,16,8,Ipswich Town,6,19,6,11,2,27,22,5,29,10,4,6,0,16,10,6,18,9,2,5,2,11,12,-1,11,,,Portman Road,Ipswich
1992/93,16,17,Queens Park Rangers,7,19,8,5,6,26,22,4,29,10,5,3,2,19,14,5,18,9,3,2,4,7,8,-1,11,,,MATRADE Loftus Road Stadium,London
1992/93,16,1,Arsenal,8,19,9,2,8,22,20,2,29,9,6,0,3,14,8,6,18,10,3,2,5,8,12,-4,11,Q,EU_CWC,Highbury,London
1992/93,16,10,Liverpool,9,19,8,4,7,33,27,6,28,10,7,1,2,23,11,12,22,9,1,3,5,10,16,-6,6,,,Anfield,Liverpool
1992/93,16,5,Coventry City,10,19,6,8,5,25,26,-1,26,9,2,3,4,11,14,-3,9,10,4,5,1,14,12,2,17,,,Highfield Road,Coventry
1992/93,16,11,Manchester City,11,19,7,4,8,26,22,4,25,9,3,3,3,14,10,4,12,10,4,1,5,12,12,0,13,,,Maine Road,Manchester
1992/93,16,13,Middlesbrough,12,19,6,7,6,30,29,1,25,10,5,4,1,19,10,9,19,9,1,3,5,11,19,-8,6,,,Ayresome Park,Middlesbrough
1992/93,16,21,Tottenham Hotspur,13,19,6,7,6,19,24,-5,25,10,4,4,2,13,10,3,16,9,2,3,4,6,14,-8,9,,,White Hart Lane,London
1992/93,16,9,Leeds United,14,19,6,6,7,32,33,-1,24,10,6,3,1,24,12,12,21,9,0,3,6,8,21,-13,3,,,Elland Road,Leeds
1992/93,16,20,Southampton,15,19,5,8,6,19,21,-2,23,10,3,5,2,12,10,2,14,9,2,3,4,7,11,-4,9,,,The Dell,Southampton
1992/93,16,18,Sheffield United,16,19,5,6,8,18,25,-7,21,10,4,5,1,11,8,3,17,9,1,1,7,7,17,-10,4,,,Bramall Lane,Sheffield
1992/93,16,19,Sheffield Wednesday,17,19,4,8,7,21,25,-4,20,9,3,3,3,12,12,0,12,10,1,5,4,9,13,-4,8,,,Hillsborough,Sheffield
1992/93,16,7,Everton,18,19,5,4,10,15,23,-8,19,9,2,3,4,6,11,-5,9,10,3,1,6,9,12,-3,10,,,Goodison Park,Liverpool
1992/93,16,22,Wimbledon,19,19,4,6,9,25,30,-5,18,10,2,3,5,14,16,-2,9,9,2,3,4,11,14,-3,9,,,Selhurst Park,London
1992/93,16,16,Oldham Athletic,20,19,4,6,9,31,38,-7,18,9,4,3,2,20,14,6,15,10,0,3,7,11,24,-13,3,R,EN_D1,Boundary Park,Oldham
1992/93,16,6,Crystal Palace,21,19,3,9,7,25,33,-8,18,9,1,5,3,12,13,-1,8,10,2,4,4,13,20,-7,10,R,EN_D1,Selhurst Park,London
1992/93,16,15,Nottingham Forest,22,19,3,5,11,18,30,-12,14,9,2,1,6,5,10,-5,7,10,1,4,5,13,20,-7,7,R,EN_D1,The City Ground,Nottingham
1992/93,17,14,Norwich City,1,20,12,3,5,34,34,0,39,10,7,2,1,15,9,6,23,10,5,1,4,19,25,-6,16,Q,EU_CL,Carrow Road,Norwich
1992/93,17,2,Aston Villa,2,20,9,8,3,31,21,10,35,10,5,3,2,17,11,6,18,10,4,5,1,14,10,4,17,Q,EU_UC,Villa Park,Birmingham
1992/93,17,3,Blackburn Rovers,3,20,9,7,4,30,17,13,34,10,7,1,2,19,7,12,22,10,2,6,2,11,10,1,12,Q,EU_UC,Ewood Park,Blackburn
1992/93,17,12,Manchester United,4,20,9,7,4,22,14,8,34,10,5,3,2,12,8,4,18,10,4,4,2,10,6,4,16,,,Old Trafford,Manchester
1992/93,17,4,Chelsea,5,20,9,6,5,27,21,6,33,10,4,4,2,12,9,3,16,10,5,2,3,15,12,3,17,,,Stamford Bridge,London
1992/93,17,8,Ipswich Town,6,20,7,11,2,29,22,7,32,10,4,6,0,16,10,6,18,10,3,5,2,13,12,1,14,,,Portman Road,Ipswich
1992/93,17,1,Arsenal,7,20,9,3,8,23,21,2,30,10,6,1,3,15,9,6,19,10,3,2,5,8,12,-4,11,Q,EU_CWC,Highbury,London
1992/93,17,5,Coventry City,8,20,7,8,5,30,27,3,29,10,3,3,4,16,15,1,12,10,4,5,1,14,12,2,17,,,Highfield Road,Coventry
1992/93,17,17,Queens Park Rangers,9,20,8,5,7,26,23,3,29,10,5,3,2,19,14,5,18,10,3,2,5,7,9,-2,11,,,MATRADE Loftus Road Stadium,London
1992/93,17,10,Liverpool,10,20,8,4,8,34,32,2,28,10,7,1,2,23,11,12,22,10,1,3,6,11,21,-10,6,,,Anfield,Liverpool
1992/93,17,11,Manchester City,11,20,7,5,8,27,23,4,26,10,3,4,3,15,11,4,13,10,4,1,5,12,12,0,13,,,Maine Road,Manchester
1992/93,17,13,Middlesbrough,12,20,6,8,6,31,30,1,26,10,5,4,1,19,10,9,19,10,1,4,5,12,20,-8,7,,,Ayresome Park,Middlesbrough
1992/93,17,21,Tottenham Hotspur,13,20,6,7,7,20,26,-6,25,10,4,4,2,13,10,3,16,10,2,3,5,7,16,-9,9,,,White Hart Lane,London
1992/93,17,9,Leeds United,14,20,6,6,8,32,34,-2,24,10,6,3,1,24,12,12,21,10,0,3,7,8,22,-14,3,,,Elland Road,Leeds
1992/93,17,19,Sheffield Wednesday,15,20,5,8,7,22,25,-3,23,10,4,3,3,13,12,1,15,10,1,5,4,9,13,-4,8,,,Hillsborough,Sheffield
1992/93,17,20,Southampton,16,20,5,8,7,20,23,-3,23,10,3,5,2,12,10,2,14,10,2,3,5,8,13,-5,9,,,The Dell,Southampton
1992/93,17,7,Everton,17,20,6,4,10,17,24,-7,22,10,3,3,4,8,12,-4,12,10,3,1,6,9,12,-3,10,,,Goodison Park,Liverpool
1992/93,17,16,Oldham Athletic,18,20,5,6,9,33,39,-6,21,10,5,3,2,22,15,7,18,10,0,3,7,11,24,-13,3,,,Boundary Park,Oldham
1992/93,17,6,Crystal Palace,19,20,4,9,7,26,33,-7,21,10,2,5,3,13,13,0,11,10,2,4,4,13,20,-7,10,,,Selhurst Park,London
1992/93,17,18,Sheffield United,20,20,5,6,9,18,26,-8,21,10,4,5,1,11,8,3,17,10,1,1,8,7,18,-11,4,R,EN_D1,Bramall Lane,Sheffield
1992/93,17,22,Wimbledon,21,20,4,7,9,26,31,-5,19,10,2,3,5,14,16,-2,9,10,2,4,4,12,15,-3,10,R,EN_D1,Selhurst Park,London
1992/93,17,15,Nottingham Forest,22,20,3,6,11,19,31,-12,15,10,2,2,6,6,11,-5,8,10,1,4,5,13,20,-7,7,R,EN_D1,The City Ground,Nottingham
1992/93,18,14,Norwich City,1,21,12,4,5,34,34,0,40,11,7,3,1,15,9,6,24,10,5,1,4,19,25,-6,16,Q,EU_CL,Carrow Road,Norwich
1992/93,18,3,Blackburn Rovers,2,21,10,7,4,33,18,15,37,11,8,1,2,22,8,14,25,10,2,6,2,11,10,1,12,Q,EU_UC,Ewood Park,Blackburn
1992/93,18,12,Manchester United,3,21,9,8,4,25,17,8,35,10,5,3,2,12,8,4,18,11,4,5,2,13,9,4,17,Q,EU_UC,Old Trafford,Manchester
1992/93,18,2,Aston Villa,4,21,9,8,4,31,24,7,35,10,5,3,2,17,11,6,18,11,4,5,2,14,13,1,17,,,Villa Park,Birmingham
1992/93,18,4,Chelsea,5,21,9,7,5,28,22,6,34,11,4,5,2,13,10,3,17,10,5,2,3,15,12,3,17,,,Stamford Bridge,London
1992/93,18,8,Ipswich Town,6,21,7,12,2,29,22,7,33,10,4,6,0,16,10,6,18,11,3,6,2,13,12,1,15,,,Portman Road,Ipswich
1992/93,18,5,Coventry City,7,21,8,8,5,33,27,6,32,11,4,3,4,19,15,4,15,10,4,5,1,14,12,2,17,,,Highfield Road,Coventry
1992/93,18,1,Arsenal,8,21,9,4,8,23,21,2,31,11,6,2,3,15,9,6,20,10,3,2,5,8,12,-4,11,Q,EU_CWC,Highbury,London
1992/93,18,11,Manchester City,9,21,8,5,8,29,23,6,29,11,4,4,3,17,11,6,16,10,4,1,5,12,12,0,13,,,Maine Road,Manchester
1992/93,18,17,Queens Park Rangers,10,20,8,5,7,26,23,3,29,10,5,3,2,19,14,5,18,10,3,2,5,7,9,-2,11,,,MATRADE Loftus Road Stadium,London
1992/93,18,10,Liverpool,11,20,8,4,8,34,32,2,28,10,7,1,2,23,11,12,22,10,1,3,6,11,21,-10,6,,,Anfield,Liverpool
1992/93,18,13,Middlesbrough,12,21,6,9,6,33,32,1,27,10,5,4,1,19,10,9,19,11,1,5,5,14,22,-8,8,,,Ayresome Park,Middlesbrough
1992/93,18,21,Tottenham Hotspur,13,21,6,8,7,20,26,-6,26,10,4,4,2,13,10,3,16,11,2,4,5,7,16,-9,10,,,White Hart Lane,London
1992/93,18,19,Sheffield Wednesday,14,21,5,9,7,25,28,-3,24,11,4,4,3,16,15,1,16,10,1,5,4,9,13,-4,8,,,Hillsborough,Sheffield
1992/93,18,20,Southampton,15,21,5,9,7,21,24,-3,24,10,3,5,2,12,10,2,14,11,2,4,5,9,14,-5,10,,,The Dell,Southampton
1992/93,18,9,Leeds United,16,21,6,6,9,33,37,-4,24,10,6,3,1,24,12,12,21,11,0,3,8,9,25,-16,3,,,Elland Road,Leeds
1992/93,18,6,Crystal Palace,17,21,5,9,7,28,33,-5,24,11,3,5,3,15,13,2,14,10,2,4,4,13,20,-7,10,,,Selhurst Park,London
1992/93,18,7,Everton,18,21,6,5,10,19,26,-7,23,11,3,4,4,10,14,-4,13,10,3,1,6,9,12,-3,10,,,Goodison Park,Liverpool
1992/93,18,16,Oldham Athletic,19,20,5,6,9,33,39,-6,21,10,5,3,2,22,15,7,18,10,0,3,7,11,24,-13,3,,,Boundary Park,Oldham
1992/93,18,18,Sheffield United,20,21,5,6,10,18,28,-10,21,10,4,5,1,11,8,3,17,11,1,1,9,7,20,-13,4,R,EN_D1,Bramall Lane,Sheffield
1992/93,18,22,Wimbledon,21,21,4,7,10,26,33,-7,19,10,2,3,5,14,16,-2,9,11,2,4,5,12,17,-5,10,R,EN_D1,Selhurst Park,London
1992/93,18,15,Nottingham Forest,22,20,3,6,11,19,31,-12,15,10,2,2,6,6,11,-5,8,10,1,4,5,13,20,-7,7,R,EN_D1,The City Ground,Nottingham
1992/93,19,14,Norwich City,1,22,12,5,5,34,34,0,41,11,7,3,1,15,9,6,24,11,5,2,4,19,25,-6,17,Q,EU_CL,Carrow Road,Norwich
1992/93,19,12,Manchester United,2,22,10,8,4,30,17,13,38,11,6,3,2,17,8,9,21,11,4,5,2,13,9,4,17,Q,EU_UC,Old Trafford,Manchester
1992/93,19,2,Aston Villa,3,22,10,8,4,32,24,8,38,11,6,3,2,18,11,7,21,11,4,5,2,14,13,1,17,Q,EU_UC,Villa Park,Birmingham
1992/93,19,3,Blackburn Rovers,4,22,10,7,5,34,20,14,37,11,8,1,2,22,8,14,25,11,2,6,3,12,12,0,12,,,Ewood Park,Blackburn
1992/93,19,8,Ipswich Town,5,22,8,12,2,31,23,8,36,11,5,6,0,18,11,7,21,11,3,6,2,13,12,1,15,,,Portman Road,Ipswich
1992/93,19,4,Chelsea,6,22,9,8,5,28,22,6,35,11,4,5,2,13,10,3,17,11,5,3,3,15,12,3,18,,,Stamford Bridge,London
1992/93,19,17,Queens Park Rangers,7,21,9,5,7,30,25,5,32,11,6,3,2,23,16,7,21,10,3,2,5,7,9,-2,11,,,MATRADE Loftus Road Stadium,London
1992/93,19,5,Coventry City,8,22,8,8,6,33,32,1,32,11,4,3,4,19,15,4,15,11,4,5,2,14,17,-3,17,,,Highfield Road,Coventry
1992/93,19,1,Arsenal,9,22,9,4,9,23,22,1,31,11,6,2,3,15,9,6,20,11,3,2,6,8,13,-5,11,Q,EU_CWC,Highbury,London
1992/93,19,11,Manchester City,10,22,8,6,8,30,24,6,30,11,4,4,3,17,11,6,16,11,4,2,5,13,13,0,14,,,Maine Road,Manchester
1992/93,19,10,Liverpool,11,21,8,5,8,35,33,2,29,11,7,2,2,24,12,12,23,10,1,3,6,11,21,-10,6,,,Anfield,Liverpool
1992/93,19,21,Tottenham Hotspur,12,22,7,8,7,22,27,-5,29,11,5,4,2,15,11,4,19,11,2,4,5,7,16,-9,10,,,White Hart Lane,London
1992/93,19,13,Middlesbrough,13,22,6,9,7,33,33,0,27,11,5,4,2,19,11,8,19,11,1,5,5,14,22,-8,8,,,Ayresome Park,Middlesbrough
1992/93,19,19,Sheffield Wednesday,14,22,6,9,7,27,29,-2,27,11,4,4,3,16,15,1,16,11,2,5,4,11,14,-3,11,,,Hillsborough,Sheffield
1992/93,19,6,Crystal Palace,15,22,6,9,7,29,33,-4,27,11,3,5,3,15,13,2,14,11,3,4,4,14,20,-6,13,,,Selhurst Park,London
1992/93,19,9,Leeds United,16,22,6,7,9,33,37,-4,25,11,6,4,1,24,12,12,22,11,0,3,8,9,25,-16,3,,,Elland Road,Leeds
1992/93,19,20,Southampton,17,22,5,9,8,22,26,-4,24,11,3,5,3,13,12,1,14,11,2,4,5,9,14,-5,10,,,The Dell,Southampton
1992/93,19,7,Everton,18,22,6,5,11,21,30,-9,23,11,3,4,4,10,14,-4,13,11,3,1,7,11,16,-5,10,,,Goodison Park,Liverpool
1992/93,19,16,Oldham Athletic,19,20,5,6,9,33,39,-6,21,10,5,3,2,22,15,7,18,10,0,3,7,11,24,-13,3,,,Boundary Park,Oldham
1992/93,19,18,Sheffield United,20,21,5,6,10,18,28,-10,21,10,4,5,1,11,8,3,17,11,1,1,9,7,20,-13,4,R,EN_D1,Bramall Lane,Sheffield
1992/93,19,22,Wimbledon,21,22,4,8,10,26,33,-7,20,11,2,4,5,14,16,-2,10,11,2,4,5,12,17,-5,10,R,EN_D1,Selhurst Park,London
1992/93,19,15,Nottingham Forest,22,21,3,6,12,20,33,-13,15,10,2,2,6,6,11,-5,8,11,1,4,6,14,22,-8,7,R,EN_D1,The City Ground,Nottingham
1992/93,20,12,Manchester United,1,23,11,8,4,34,18,16,41,12,7,3,2,21,9,12,24,11,4,5,2,13,9,4,17,Q,EU_CL,Old Trafford,Manchester
1992/93,20,2,Aston Villa,2,23,11,8,4,34,25,9,41,11,6,3,2,18,11,7,21,12,5,5,2,16,14,2,20,Q,EU_UC,Villa Park,Birmingham
1992/93,20,14,Norwich City,3,23,12,5,6,34,35,-1,41,11,7,3,1,15,9,6,24,12,5,2,5,19,26,-7,17,Q,EU_UC,Carrow Road,Norwich
1992/93,20,3,Blackburn Rovers,4,23,10,8,5,34,20,14,38,12,8,2,2,22,8,14,26,11,2,6,3,12,12,0,12,,,Ewood Park,Blackburn
1992/93,20,8,Ipswich Town,5,23,8,12,3,32,25,7,36,12,5,6,1,19,13,6,21,11,3,6,2,13,12,1,15,,,Portman Road,Ipswich
1992/93,20,17,Queens Park Rangers,6,22,10,5,7,31,25,6,35,11,6,3,2,23,16,7,21,11,4,2,5,8,9,-1,14,,,MATRADE Loftus Road Stadium,London
1992/93,20,4,Chelsea,7,23,9,8,6,30,26,4,35,12,4,5,3,15,14,1,17,11,5,3,3,15,12,3,18,,,Stamford Bridge,London
1992/93,20,11,Manchester City,8,23,9,6,8,34,26,8,33,11,4,4,3,17,11,6,16,12,5,2,5,17,15,2,17,,,Maine Road,Manchester
1992/93,20,1,Arsenal,9,23,9,5,9,24,23,1,32,12,6,3,3,16,10,6,21,11,3,2,6,8,13,-5,11,Q,EU_CWC,Highbury,London
1992/93,20,5,Coventry City,10,23,8,8,7,33,33,0,32,12,4,3,5,19,16,3,15,11,4,5,2,14,17,-3,17,,,Highfield Road,Coventry
1992/93,20,19,Sheffield Wednesday,11,23,7,9,7,28,29,-1,30,12,5,4,3,17,15,2,19,11,2,5,4,11,14,-3,11,,,Hillsborough,Sheffield
1992/93,20,10,Liverpool,12,22,8,5,9,36,35,1,29,12,7,2,3,25,14,11,23,10,1,3,6,11,21,-10,6,,,Anfield,Liverpool
1992/93,20,21,Tottenham Hotspur,13,23,7,8,8,23,31,-8,29,11,5,4,2,15,11,4,19,12,2,4,6,8,20,-12,10,,,White Hart Lane,London
1992/93,20,9,Leeds United,14,23,7,7,9,35,38,-3,28,12,7,4,1,26,13,13,25,11,0,3,8,9,25,-16,3,,,Elland Road,Leeds
1992/93,20,13,Middlesbrough,15,23,6,9,8,33,34,-1,27,12,5,4,3,19,12,7,19,11,1,5,5,14,22,-8,8,,,Ayresome Park,Middlesbrough
1992/93,20,6,Crystal Palace,16,23,6,9,8,29,35,-6,27,12,3,5,4,15,15,0,14,11,3,4,4,14,20,-6,13,,,Selhurst Park,London
1992/93,20,7,Everton,17,23,7,5,11,23,30,-7,26,11,3,4,4,10,14,-4,13,12,4,1,7,13,16,-3,13,,,Goodison Park,Liverpool
1992/93,20,16,Oldham Athletic,18,21,6,6,9,35,40,-5,24,10,5,3,2,22,15,7,18,11,1,3,7,13,25,-12,6,,,Boundary Park,Oldham
1992/93,20,20,Southampton,19,23,5,9,9,23,28,-5,24,11,3,5,3,13,12,1,14,12,2,4,6,10,16,-6,10,,,The Dell,Southampton
1992/93,20,18,Sheffield United,20,22,5,7,10,19,29,-10,22,10,4,5,1,11,8,3,17,12,1,2,9,8,21,-13,5,R,EN_D1,Bramall Lane,Sheffield
1992/93,20,22,Wimbledon,21,23,4,9,10,26,33,-7,21,11,2,4,5,14,16,-2,10,12,2,5,5,12,17,-5,11,R,EN_D1,Selhurst Park,London
1992/93,20,15,Nottingham Forest,22,22,4,6,12,21,33,-12,18,10,2,2,6,6,11,-5,8,12,2,4,6,15,22,-7,10,R,EN_D1,The City Ground,Nottingham
1992/93,21,12,Manchester United,1,24,12,8,4,37,19,18,44,12,7,3,2,21,9,12,24,12,5,5,2,16,10,6,20,Q,EU_CL,Old Trafford,Manchester
1992/93,21,2,Aston Villa,2,24,12,8,4,39,26,13,44,12,7,3,2,23,12,11,24,12,5,5,2,16,14,2,20,Q,EU_UC,Villa Park,Birmingham
1992/93,21,14,Norwich City,3,24,12,6,6,35,36,-1,42,12,7,4,1,16,10,6,25,12,5,2,5,19,26,-7,17,Q,EU_UC,Carrow Road,Norwich
1992/93,21,3,Blackburn Rovers,4,24,11,8,5,35,20,15,41,12,8,2,2,22,8,14,26,12,3,6,3,13,12,1,15,,,Ewood Park,Blackburn
1992/93,21,8,Ipswich Town,5,24,8,12,4,32,28,4,36,12,5,6,1,19,13,6,21,12,3,6,3,13,15,-2,15,,,Portman Road,Ipswich
1992/93,21,5,Coventry City,6,25,9,9,7,37,34,3,36,13,5,3,5,22,16,6,18,12,4,6,2,15,18,-3,18,,,Highfield Road,Coventry
1992/93,21,17,Queens Park Rangers,7,23,10,5,8,32,28,4,35,12,6,3,3,24,19,5,21,11,4,2,5,8,9,-1,14,,,MATRADE Loftus Road Stadium,London
1992/93,21,1,Arsenal,8,24,10,5,9,25,23,2,35,12,6,3,3,16,10,6,21,12,4,2,6,9,13,-4,14,Q,EU_CWC,Highbury,London
1992/93,21,4,Chelsea,9,24,9,8,7,30,29,1,35,12,4,5,3,15,14,1,17,12,5,3,4,15,15,0,18,,,Stamford Bridge,London
1992/93,21,11,Manchester City,10,24,9,6,9,34,27,7,33,12,4,4,4,17,12,5,16,12,5,2,5,17,15,2,17,,,Maine Road,Manchester
1992/93,21,19,Sheffield Wednesday,11,24,8,9,7,30,29,1,33,12,5,4,3,17,15,2,19,12,3,5,4,13,14,-1,14,,,Hillsborough,Sheffield
1992/93,21,10,Liverpool,12,23,8,5,10,36,37,-1,29,12,7,2,3,25,14,11,23,11,1,3,7,11,23,-12,6,,,Anfield,Liverpool
1992/93,21,7,Everton,13,24,8,5,11,25,30,-5,29,12,4,4,4,12,14,-2,16,12,4,1,7,13,16,-3,13,,,Goodison Park,Liverpool
1992/93,21,21,Tottenham Hotspur,14,24,7,8,9,23,33,-10,29,12,5,4,3,15,13,2,19,12,2,4,6,8,20,-12,10,,,White Hart Lane,London
1992/93,21,9,Leeds United,15,24,7,7,10,35,40,-5,28,12,7,4,1,26,13,13,25,12,0,3,9,9,27,-18,3,,,Elland Road,Leeds
1992/93,21,20,Southampton,16,24,6,9,9,24,28,-4,27,12,4,5,3,14,12,2,17,12,2,4,6,10,16,-6,10,,,The Dell,Southampton
1992/93,21,13,Middlesbrough,17,24,6,9,9,34,39,-5,27,12,5,4,3,19,12,7,19,12,1,5,6,15,27,-12,8,,,Ayresome Park,Middlesbrough
1992/93,21,6,Crystal Palace,18,24,6,9,9,29,36,-7,27,12,3,5,4,15,15,0,14,12,3,4,5,14,21,-7,13,,,Selhurst Park,London
1992/93,21,18,Sheffield United,19,23,6,7,10,22,29,-7,25,11,5,5,1,14,8,6,20,12,1,2,9,8,21,-13,5,,,Bramall Lane,Sheffield
1992/93,21,22,Wimbledon,20,24,5,9,10,28,33,-5,24,12,3,4,5,16,16,0,13,12,2,5,5,12,17,-5,11,R,EN_D1,Selhurst Park,London
1992/93,21,16,Oldham Athletic,21,23,6,6,11,35,44,-9,24,11,5,3,3,22,16,6,18,12,1,3,8,13,28,-15,6,R,EN_D1,Boundary Park,Oldham
1992/93,21,15,Nottingham Forest,22,23,5,6,12,24,33,-9,21,11,3,2,6,9,11,-2,11,12,2,4,6,15,22,-7,10,R,EN_D1,The City Ground,Nottingham
1992/93,22,12,Manchester United,1,25,13,8,4,39,19,20,47,13,8,3,2,23,9,14,27,12,5,5,2,16,10,6,20,Q,EU_CL,Old Trafford,Manchester
1992/93,22,2,Aston Villa,2,25,13,8,4,42,27,15,47,13,8,3,2,26,13,13,27,12,5,5,2,16,14,2,20,Q,EU_UC,Villa Park,Birmingham
1992/93,22,14,Norwich City,3,25,13,6,6,39,38,1,45,13,8,4,1,20,12,8,28,12,5,2,5,19,26,-7,17,Q,EU_UC,Carrow Road,Norwich
1992/93,22,3,Blackburn Rovers,4,25,11,8,6,37,25,12,41,13,8,2,3,24,13,11,26,12,3,6,3,13,12,1,15,,,Ewood Park,Blackburn
1992/93,22,5,Coventry City,5,26,10,9,7,42,36,6,39,13,5,3,5,22,16,6,18,13,5,6,2,20,20,0,21,,,Highfield Road,Coventry
1992/93,22,8,Ipswich Town,6,25,9,12,4,34,28,6,39,12,5,6,1,19,13,6,21,13,4,6,3,15,15,0,18,,,Portman Road,Ipswich
1992/93,22,11,Manchester City,7,25,10,6,9,35,27,8,36,12,4,4,4,17,12,5,16,13,6,2,5,18,15,3,20,,,Maine Road,Manchester
1992/93,22,17,Queens Park Rangers,8,24,10,6,8,33,29,4,36,13,6,4,3,25,20,5,22,11,4,2,5,8,9,-1,14,,,MATRADE Loftus Road Stadium,London
1992/93,22,4,Chelsea,9,25,9,9,7,31,30,1,36,12,4,5,3,15,14,1,17,13,5,4,4,16,16,0,19,,,Stamford Bridge,London
1992/93,22,1,Arsenal,10,24,10,5,9,25,23,2,35,12,6,3,3,16,10,6,21,12,4,2,6,9,13,-4,14,Q,EU_CWC,Highbury,London
1992/93,22,19,Sheffield Wednesday,11,24,8,9,7,30,29,1,33,12,5,4,3,17,15,2,19,12,3,5,4,13,14,-1,14,,,Hillsborough,Sheffield
1992/93,22,7,Everton,12,25,9,5,11,28,31,-3,32,12,4,4,4,12,14,-2,16,13,5,1,7,16,17,-1,16,,,Goodison Park,Liverpool
1992/93,22,13,Middlesbrough,13,25,7,9,9,36,40,-4,30,13,6,4,3,21,13,8,22,12,1,5,6,15,27,-12,8,,,Ayresome Park,Middlesbrough
1992/93,22,10,Liverpool,14,23,8,5,10,36,37,-1,29,12,7,2,3,25,14,11,23,11,1,3,7,11,23,-12,6,,,Anfield,Liverpool
1992/93,22,21,Tottenham Hotspur,15,25,7,8,10,23,35,-12,29,13,5,4,4,15,15,0,19,12,2,4,6,8,20,-12,10,,,White Hart Lane,London
1992/93,22,9,Leeds United,16,24,7,7,10,35,40,-5,28,12,7,4,1,26,13,13,25,12,0,3,9,9,27,-18,3,,,Elland Road,Leeds
1992/93,22,20,Southampton,17,25,6,9,10,25,30,-5,27,12,4,5,3,14,12,2,17,13,2,4,7,11,18,-7,10,,,The Dell,Southampton
1992/93,22,6,Crystal Palace,18,25,6,9,10,31,40,-9,27,12,3,5,4,15,15,0,14,13,3,4,6,16,25,-9,13,,,Selhurst Park,London
1992/93,22,18,Sheffield United,19,24,6,7,11,23,32,-9,25,11,5,5,1,14,8,6,20,13,1,2,10,9,24,-15,5,,,Bramall Lane,Sheffield
1992/93,22,22,Wimbledon,20,25,5,9,11,29,36,-7,24,13,3,4,6,17,19,-2,13,12,2,5,5,12,17,-5,11,R,EN_D1,Selhurst Park,London
1992/93,22,16,Oldham Athletic,21,24,6,6,12,35,45,-10,24,12,5,3,4,22,17,5,18,12,1,3,8,13,28,-15,6,R,EN_D1,Boundary Park,Oldham
1992/93,22,15,Nottingham Forest,22,24,5,6,13,24,35,-11,21,11,3,2,6,9,11,-2,11,13,2,4,7,15,24,-9,10,R,EN_D1,The City Ground,Nottingham
1992/93,23,14,Norwich City,1,26,14,6,6,40,38,2,48,13,8,4,1,20,12,8,28,13,6,2,5,20,26,-6,20,Q,EU_CL,Carrow Road,Norwich
1992/93,23,12,Manchester United,2,26,13,8,5,40,21,19,47,13,8,3,2,23,9,14,27,13,5,5,3,17,12,5,20,Q,EU_UC,Old Trafford,Manchester
1992/93,23,2,Aston Villa,3,26,13,8,5,42,29,13,47,13,8,3,2,26,13,13,27,13,5,5,3,16,16,0,20,Q,EU_UC,Villa Park,Birmingham
1992/93,23,8,Ipswich Town,4,26,10,12,4,36,29,7,42,13,6,6,1,21,14,7,24,13,4,6,3,15,15,0,18,,,Portman Road,Ipswich
1992/93,23,3,Blackburn Rovers,5,27,11,8,8,40,30,10,41,14,8,2,4,25,15,10,26,13,3,6,4,15,15,0,15,,,Ewood Park,Blackburn
1992/93,23,11,Manchester City,6,26,11,6,9,38,29,9,39,13,5,4,4,20,14,6,19,13,6,2,5,18,15,3,20,,,Maine Road,Manchester
1992/93,23,17,Queens Park Rangers,7,25,11,6,8,35,30,5,39,13,6,4,3,25,20,5,22,12,5,2,5,10,10,0,17,,,MATRADE Loftus Road Stadium,London
1992/93,23,5,Coventry City,8,27,10,9,8,42,38,4,39,14,5,3,6,22,18,4,18,13,5,6,2,20,20,0,21,,,Highfield Road,Coventry
1992/93,23,19,Sheffield Wednesday,9,25,9,9,7,32,29,3,36,12,5,4,3,17,15,2,19,13,4,5,4,15,14,1,17,,,Hillsborough,Sheffield
1992/93,23,4,Chelsea,10,26,9,9,8,31,32,-1,36,13,4,5,4,15,16,-1,17,13,5,4,4,16,16,0,19,,,Stamford Bridge,London
1992/93,23,1,Arsenal,11,25,10,5,10,25,24,1,35,13,6,3,4,16,11,5,21,12,4,2,6,9,13,-4,14,Q,EU_CWC,Highbury,London
1992/93,23,10,Liverpool,12,24,9,5,10,37,37,0,32,12,7,2,3,25,14,11,23,12,2,3,7,12,23,-11,9,,,Anfield,Liverpool
1992/93,23,7,Everton,13,26,9,5,12,28,32,-4,32,13,4,4,5,12,15,-3,16,13,5,1,7,16,17,-1,16,,,Goodison Park,Liverpool
1992/93,23,21,Tottenham Hotspur,14,26,8,8,10,26,36,-10,32,13,5,4,4,15,15,0,19,13,3,4,6,11,21,-10,13,,,White Hart Lane,London
1992/93,23,9,Leeds United,15,25,8,7,10,38,40,-2,31,13,8,4,1,29,13,16,28,12,0,3,9,9,27,-18,3,,,Elland Road,Leeds
1992/93,23,20,Southampton,16,26,7,9,10,27,30,-3,30,13,5,5,3,16,12,4,20,13,2,4,7,11,18,-7,10,,,The Dell,Southampton
1992/93,23,13,Middlesbrough,17,26,7,9,10,36,43,-7,30,13,6,4,3,21,13,8,22,13,1,5,7,15,30,-15,8,,,Ayresome Park,Middlesbrough
1992/93,23,6,Crystal Palace,18,27,7,9,11,34,44,-10,30,13,3,5,5,16,18,-2,14,14,4,4,6,18,26,-8,16,,,Selhurst Park,London
1992/93,23,22,Wimbledon,19,26,6,9,11,31,36,-5,27,13,3,4,6,17,19,-2,13,13,3,5,5,14,17,-3,14,,,Selhurst Park,London
1992/93,23,18,Sheffield United,20,25,6,7,12,24,34,-10,25,12,5,5,2,15,10,5,20,13,1,2,10,9,24,-15,5,R,EN_D1,Bramall Lane,Sheffield
1992/93,23,15,Nottingham Forest,21,25,6,6,13,26,35,-9,24,12,4,2,6,11,11,0,14,13,2,4,7,15,24,-9,10,R,EN_D1,The City Ground,Nottingham
1992/93,23,16,Oldham Athletic,22,25,6,6,13,35,47,-12,24,12,5,3,4,22,17,5,18,13,1,3,9,13,30,-17,6,R,EN_D1,Boundary Park,Oldham
1992/93,24,12,Manchester United,1,28,14,9,5,42,22,20,51,14,9,3,2,25,10,15,30,14,5,6,3,17,12,5,21,Q,EU_CL,Old Trafford,Manchester
1992/93,24,2,Aston Villa,2,28,14,8,6,44,30,14,50,14,9,3,2,28,13,15,30,14,5,5,4,16,17,-1,20,Q,EU_UC,Villa Park,Birmingham
1992/93,24,14,Norwich City,3,27,14,6,7,40,41,-1,48,13,8,4,1,20,12,8,28,14,6,2,6,20,29,-9,20,Q,EU_UC,Carrow Road,Norwich
1992/93,24,8,Ipswich Town,4,28,10,13,5,37,32,5,43,14,6,7,1,22,15,7,25,14,4,6,4,15,17,-2,18,,,Portman Road,Ipswich
1992/93,24,5,Coventry City,5,28,11,9,8,44,38,6,42,14,5,3,6,22,18,4,18,14,6,6,2,22,20,2,24,,,Highfield Road,Coventry
1992/93,24,3,Blackburn Rovers,6,27,11,8,8,40,30,10,41,14,8,2,4,25,15,10,26,13,3,6,4,15,15,0,15,,,Ewood Park,Blackburn
1992/93,24,17,Queens Park Rangers,7,27,11,8,8,37,32,5,41,14,6,5,3,26,21,5,23,13,5,3,5,11,11,0,18,,,MATRADE Loftus Road Stadium,London
1992/93,24,11,Manchester City,8,27,11,7,9,39,30,9,40,13,5,4,4,20,14,6,19,14,6,3,5,19,16,3,21,,,Maine Road,Manchester
1992/93,24,19,Sheffield Wednesday,9,26,10,9,7,35,30,5,39,13,6,4,3,20,16,4,22,13,4,5,4,15,14,1,17,,,Hillsborough,Sheffield
1992/93,24,21,Tottenham Hotspur,10,28,10,8,10,32,39,-7,38,14,6,4,4,19,17,2,22,14,4,4,6,13,22,-9,16,,,White Hart Lane,London
1992/93,24,4,Chelsea,11,28,9,10,9,32,35,-3,37,14,4,6,4,15,16,-1,18,14,5,4,5,17,19,-2,19,,,Stamford Bridge,London
1992/93,24,1,Arsenal,12,26,10,5,11,25,25,0,35,14,6,3,5,16,12,4,21,12,4,2,6,9,13,-4,14,Q,EU_CWC,Highbury,London
1992/93,24,10,Liverpool,13,26,9,7,10,37,37,0,34,13,7,3,3,25,14,11,24,13,2,4,7,12,23,-11,10,,,Anfield,Liverpool
1992/93,24,20,Southampton,14,28,8,9,11,32,34,-2,33,14,6,5,3,19,12,7,23,14,2,4,8,13,22,-9,10,,,The Dell,Southampton
1992/93,24,22,Wimbledon,15,28,8,9,11,33,36,-3,33,14,4,4,6,18,19,-1,16,14,4,5,5,15,17,-2,17,,,Selhurst Park,London
1992/93,24,6,Crystal Palace,16,28,8,9,11,35,44,-9,33,14,4,5,5,17,18,-1,17,14,4,4,6,18,26,-8,16,,,Selhurst Park,London
1992/93,24,9,Leeds United,17,27,8,8,11,38,41,-3,32,14,8,5,1,29,13,16,29,13,0,3,10,9,28,-19,3,,,Elland Road,Leeds
1992/93,24,7,Everton,18,28,9,5,14,30,37,-7,32,14,4,4,6,13,17,-4,16,14,5,1,8,17,20,-3,16,,,Goodison Park,Liverpool
1992/93,24,13,Middlesbrough,19,28,7,9,12,36,47,-11,30,14,6,4,4,21,15,6,22,14,1,5,8,15,32,-17,8,,,Ayresome Park,Middlesbrough
1992/93,24,18,Sheffield United,20,27,7,7,13,27,36,-9,28,13,6,5,2,17,10,7,23,14,1,2,11,10,26,-16,5,R,EN_D1,Bramall Lane,Sheffield
1992/93,24,16,Oldham Athletic,21,26,7,6,13,38,48,-10,27,13,6,3,4,25,18,7,21,13,1,3,9,13,30,-17,6,R,EN_D1,Boundary Park,Oldham
1992/93,24,15,Nottingham Forest,22,26,6,7,13,26,35,-9,25,12,4,2,6,11,11,0,14,14,2,5,7,15,24,-9,11,R,EN_D1,The City Ground,Nottingham
1992/93,25,2,Aston Villa,1,29,15,8,6,45,30,15,53,14,9,3,2,28,13,15,30,15,6,5,4,17,17,0,23,Q,EU_CL,Villa Park,Birmingham
1992/93,25,12,Manchester United,2,28,14,9,5,42,22,20,51,14,9,3,2,25,10,15,30,14,5,6,3,17,12,5,21,Q,EU_UC,Old Trafford,Manchester
1992/93,25,14,Norwich City,3,27,14,6,7,40,41,-1,48,13,8,4,1,20,12,8,28,14,6,2,6,20,29,-9,20,Q,EU_UC,Carrow Road,Norwich
1992/93,25,8,Ipswich Town,4,28,10,13,5,37,32,5,43,14,6,7,1,22,15,7,25,14,4,6,4,15,17,-2,18,,,Portman Road,Ipswich
1992/93,25,5,Coventry City,5,28,11,9,8,44,38,6,42,14,5,3,6,22,18,4,18,14,6,6,2,22,20,2,24,,,Highfield Road,Coventry
1992/93,25,3,Blackburn Rovers,6,27,11,8,8,40,30,10,41,14,8,2,4,25,15,10,26,13,3,6,4,15,15,0,15,,,Ewood Park,Blackburn
1992/93,25,17,Queens Park Rangers,7,27,11,8,8,37,32,5,41,14,6,5,3,26,21,5,23,13,5,3,5,11,11,0,18,,,MATRADE Loftus Road Stadium,London
1992/93,25,11,Manchester City,8,27,11,7,9,39,30,9,40,13,5,4,4,20,14,6,19,14,6,3,5,19,16,3,21,,,Maine Road,Manchester
1992/93,25,19,Sheffield Wednesday,9,26,10,9,7,35,30,5,39,13,6,4,3,20,16,4,22,13,4,5,4,15,14,1,17,,,Hillsborough,Sheffield
1992/93,25,21,Tottenham Hotspur,10,28,10,8,10,32,39,-7,38,14,6,4,4,19,17,2,22,14,4,4,6,13,22,-9,16,,,White Hart Lane,London
1992/93,25,4,Chelsea,11,29,9,10,10,32,36,-4,37,15,4,6,5,15,17,-2,18,14,5,4,5,17,19,-2,19,,,Stamford Bridge,London
1992/93,25,20,Southampton,12,29,9,9,11,34,35,-1,36,15,7,5,3,21,13,8,26,14,2,4,8,13,22,-9,10,,,The Dell,Southampton
1992/93,25,1,Arsenal,13,26,10,5,11,25,25,0,35,14,6,3,5,16,12,4,21,12,4,2,6,9,13,-4,14,Q,EU_CWC,Highbury,London
1992/93,25,9,Leeds United,14,28,9,8,11,40,41,-1,35,15,9,5,1,31,13,18,32,13,0,3,10,9,28,-19,3,,,Elland Road,Leeds
1992/93,25,10,Liverpool,15,27,9,7,11,38,39,-1,34,13,7,3,3,25,14,11,24,14,2,4,8,13,25,-12,10,,,Anfield,Liverpool
1992/93,25,22,Wimbledon,16,28,8,9,11,33,36,-3,33,14,4,4,6,18,19,-1,16,14,4,5,5,15,17,-2,17,,,Selhurst Park,London
1992/93,25,6,Crystal Palace,17,28,8,9,11,35,44,-9,33,14,4,5,5,17,18,-1,17,14,4,4,6,18,26,-8,16,,,Selhurst Park,London
1992/93,25,7,Everton,18,28,9,5,14,30,37,-7,32,14,4,4,6,13,17,-4,16,14,5,1,8,17,20,-3,16,,,Goodison Park,Liverpool
1992/93,25,13,Middlesbrough,19,28,7,9,12,36,47,-11,30,14,6,4,4,21,15,6,22,14,1,5,8,15,32,-17,8,,,Ayresome Park,Middlesbrough
1992/93,25,18,Sheffield United,20,27,7,7,13,27,36,-9,28,13,6,5,2,17,10,7,23,14,1,2,11,10,26,-16,5,R,EN_D1,Bramall Lane,Sheffield
1992/93,25,16,Oldham Athletic,21,27,7,6,14,38,50,-12,27,13,6,3,4,25,18,7,21,14,1,3,10,13,32,-19,6,R,EN_D1,Boundary Park,Oldham
1992/93,25,15,Nottingham Forest,22,26,6,7,13,26,35,-9,25,12,4,2,6,11,11,0,14,14,2,5,7,15,24,-9,11,R,EN_D1,The City Ground,Nottingham
1992/93,26,2,Aston Villa,1,30,16,8,6,47,31,16,56,15,10,3,2,30,14,16,33,15,6,5,4,17,17,0,23,Q,EU_CL,Villa Park,Birmingham
1992/93,26,12,Manchester United,2,29,15,9,5,44,23,21,54,15,10,3,2,27,11,16,33,14,5,6,3,17,12,5,21,Q,EU_UC,Old Trafford,Manchester
1992/93,26,14,Norwich City,3,28,15,6,7,42,42,0,51,14,9,4,1,22,13,9,31,14,6,2,6,20,29,-9,20,Q,EU_UC,Carrow Road,Norwich
1992/93,26,19,Sheffield Wednesday,4,28,12,9,7,39,32,7,45,14,7,4,3,22,17,5,25,14,5,5,4,17,15,2,20,,,Hillsborough,Sheffield
1992/93,26,3,Blackburn Rovers,5,28,12,8,8,42,30,12,44,15,9,2,4,27,15,12,29,13,3,6,4,15,15,0,15,,,Ewood Park,Blackburn
1992/93,26,17,Queens Park Rangers,6,29,12,8,9,39,33,6,44,15,7,5,3,28,21,7,26,14,5,3,6,11,12,-1,18,,,MATRADE Loftus Road Stadium,London
1992/93,26,8,Ipswich Town,7,29,10,14,5,37,32,5,44,14,6,7,1,22,15,7,25,15,4,7,4,15,17,-2,19,,,Portman Road,Ipswich
1992/93,26,5,Coventry City,8,29,11,9,9,44,40,4,42,14,5,3,6,22,18,4,18,15,6,6,3,22,22,0,24,,,Highfield Road,Coventry
1992/93,26,21,Tottenham Hotspur,9,29,11,8,10,36,39,-3,41,15,7,4,4,23,17,6,25,14,4,4,6,13,22,-9,16,,,White Hart Lane,London
1992/93,26,11,Manchester City,10,29,11,7,11,41,34,7,40,14,5,4,5,21,16,5,19,15,6,3,6,20,18,2,21,,,Maine Road,Manchester
1992/93,26,1,Arsenal,11,28,11,6,11,26,25,1,39,15,6,4,5,16,12,4,22,13,5,2,6,10,13,-3,17,Q,EU_CWC,Highbury,London
1992/93,26,4,Chelsea,12,30,9,10,11,32,38,-6,37,15,4,6,5,15,17,-2,18,15,5,4,6,17,21,-4,19,,,Stamford Bridge,London
1992/93,26,22,Wimbledon,13,29,9,9,11,35,36,-1,36,15,5,4,6,20,19,1,19,14,4,5,5,15,17,-2,17,,,Selhurst Park,London
1992/93,26,20,Southampton,14,30,9,9,12,35,37,-2,36,15,7,5,3,21,13,8,26,15,2,4,9,14,24,-10,10,,,The Dell,Southampton
1992/93,26,9,Leeds United,15,30,9,9,12,40,45,-5,36,15,9,5,1,31,13,18,32,15,0,4,11,9,32,-23,4,,,Elland Road,Leeds
1992/93,26,10,Liverpool,16,28,9,8,11,38,39,-1,35,14,7,4,3,25,14,11,25,14,2,4,8,13,25,-12,10,,,Anfield,Liverpool
1992/93,26,6,Crystal Palace,17,29,8,9,12,36,46,-10,33,14,4,5,5,17,18,-1,17,15,4,4,7,19,28,-9,16,,,Selhurst Park,London
1992/93,26,7,Everton,18,29,9,5,15,31,39,-8,32,14,4,4,6,13,17,-4,16,15,5,1,9,18,22,-4,16,,,Goodison Park,Liverpool
1992/93,26,15,Nottingham Forest,19,28,8,7,13,29,36,-7,31,13,5,2,6,12,11,1,17,15,3,5,7,17,25,-8,14,,,The City Ground,Nottingham
1992/93,26,18,Sheffield United,20,29,8,7,14,29,38,-9,31,14,7,5,2,19,10,9,26,15,1,2,12,10,28,-18,5,R,EN_D1,Bramall Lane,Sheffield
1992/93,26,13,Middlesbrough,21,29,7,9,13,37,49,-12,30,15,6,4,5,22,17,5,22,14,1,5,8,15,32,-17,8,R,EN_D1,Ayresome Park,Middlesbrough
1992/93,26,16,Oldham Athletic,22,29,7,6,16,38,53,-15,27,14,6,3,5,25,19,6,21,15,1,3,11,13,34,-21,6,R,EN_D1,Boundary Park,Oldham
1992/93,27,2,Aston Villa,1,31,17,8,6,48,31,17,59,16,11,3,2,31,14,17,36,15,6,5,4,17,17,0,23,Q,EU_CL,Villa Park,Birmingham
1992/93,27,12,Manchester United,2,30,16,9,5,47,23,24,57,16,11,3,2,30,11,19,36,14,5,6,3,17,12,5,21,Q,EU_UC,Old Trafford,Manchester
1992/93,27,14,Norwich City,3,30,15,8,7,43,43,0,53,16,9,6,1,23,14,9,33,14,6,2,6,20,29,-9,20,Q,EU_UC,Carrow Road,Norwich
1992/93,27,19,Sheffield Wednesday,4,30,12,10,8,40,34,6,46,15,7,5,3,23,18,5,26,15,5,5,5,17,16,1,20,,,Hillsborough,Sheffield
1992/93,27,5,Coventry City,5,31,12,10,9,45,40,5,46,15,6,3,6,23,18,5,21,16,6,7,3,22,22,0,25,,,Highfield Road,Coventry
1992/93,27,3,Blackburn Rovers,6,30,12,9,9,43,32,11,45,15,9,2,4,27,15,12,29,15,3,7,5,16,17,-1,16,,,Ewood Park,Blackburn
1992/93,27,17,Queens Park Rangers,7,30,12,8,10,41,36,5,44,15,7,5,3,28,21,7,26,15,5,3,7,13,15,-2,18,,,MATRADE Loftus Road Stadium,London
1992/93,27,8,Ipswich Town,8,31,10,14,7,37,34,3,44,15,6,7,2,22,16,6,25,16,4,7,5,15,18,-3,19,,,Portman Road,Ipswich
1992/93,27,21,Tottenham Hotspur,9,31,12,8,11,39,47,-8,44,16,8,4,4,26,19,7,28,15,4,4,7,13,28,-15,16,,,White Hart Lane,London
1992/93,27,11,Manchester City,10,30,12,7,11,43,34,9,43,14,5,4,5,21,16,5,19,16,7,3,6,22,18,4,24,,,Maine Road,Manchester
1992/93,27,1,Arsenal,11,30,11,7,12,27,27,0,40,15,6,4,5,16,12,4,22,15,5,3,7,11,15,-4,18,Q,EU_CWC,Highbury,London
1992/93,27,4,Chelsea,12,31,10,10,11,33,38,-5,40,16,5,6,5,16,17,-1,21,15,5,4,6,17,21,-4,19,,,Stamford Bridge,London
1992/93,27,20,Southampton,13,31,10,9,12,38,39,-1,39,16,8,5,3,24,15,9,29,15,2,4,9,14,24,-10,10,,,The Dell,Southampton
1992/93,27,9,Leeds United,14,31,10,9,12,41,45,-4,39,16,10,5,1,32,13,19,35,15,0,4,11,9,32,-23,4,,,Elland Road,Leeds
1992/93,27,10,Liverpool,15,29,9,9,11,39,40,-1,36,14,7,4,3,25,14,11,25,15,2,5,8,14,26,-12,11,,,Anfield,Liverpool
1992/93,27,22,Wimbledon,16,30,9,9,12,35,37,-2,36,15,5,4,6,20,19,1,19,15,4,5,6,15,18,-3,17,,,Selhurst Park,London
1992/93,27,7,Everton,17,31,10,6,15,35,42,-7,36,16,5,5,6,17,20,-3,20,15,5,1,9,18,22,-4,16,,,Goodison Park,Liverpool
1992/93,27,6,Crystal Palace,18,31,8,11,12,37,47,-10,35,15,4,6,5,17,18,-1,18,16,4,5,7,20,29,-9,17,,,Selhurst Park,London
1992/93,27,18,Sheffield United,19,31,9,7,15,37,41,-4,34,15,8,5,2,25,10,15,29,16,1,2,13,12,31,-19,5,,,Bramall Lane,Sheffield
1992/93,27,13,Middlesbrough,20,31,8,9,14,38,52,-14,33,15,6,4,5,22,17,5,22,16,2,5,9,16,35,-19,11,R,EN_D1,Ayresome Park,Middlesbrough
1992/93,27,15,Nottingham Forest,21,30,8,8,14,30,39,-9,32,15,5,3,7,13,14,-1,18,15,3,5,7,17,25,-8,14,R,EN_D1,The City Ground,Nottingham
1992/93,27,16,Oldham Athletic,22,30,7,7,16,40,55,-15,28,14,6,3,5,25,19,6,21,16,1,4,11,15,36,-21,7,R,EN_D1,Boundary Park,Oldham
1992/93,28,12,Manchester United,1,31,17,9,5,49,24,25,60,16,11,3,2,30,11,19,36,15,6,6,3,19,13,6,24,Q,EU_CL,Old Trafford,Manchester
1992/93,28,2,Aston Villa,2,31,17,8,6,48,31,17,59,16,11,3,2,31,14,17,36,15,6,5,4,17,17,0,23,Q,EU_UC,Villa Park,Birmingham
1992/93,28,14,Norwich City,3,31,15,8,8,44,46,-2,53,16,9,6,1,23,14,9,33,15,6,2,7,21,32,-11,20,Q,EU_UC,Carrow Road,Norwich
1992/93,28,17,Queens Park Rangers,4,31,13,8,10,44,37,7,47,16,8,5,3,31,22,9,29,15,5,3,7,13,15,-2,18,,,MATRADE Loftus Road Stadium,London
1992/93,28,19,Sheffield Wednesday,5,30,12,10,8,40,34,6,46,15,7,5,3,23,18,5,26,15,5,5,5,17,16,1,20,,,Hillsborough,Sheffield
1992/93,28,5,Coventry City,6,32,12,10,10,45,41,4,46,16,6,3,7,23,19,4,21,16,6,7,3,22,22,0,25,,,Highfield Road,Coventry
1992/93,28,3,Blackburn Rovers,7,30,12,9,9,43,32,11,45,15,9,2,4,27,15,12,29,15,3,7,5,16,17,-1,16,,,Ewood Park,Blackburn
1992/93,28,8,Ipswich Town,8,31,10,14,7,37,34,3,44,15,6,7,2,22,16,6,25,16,4,7,5,15,18,-3,19,,,Portman Road,Ipswich
1992/93,28,21,Tottenham Hotspur,9,31,12,8,11,39,47,-8,44,16,8,4,4,26,19,7,28,15,4,4,7,13,28,-15,16,,,White Hart Lane,London
1992/93,28,11,Manchester City,10,30,12,7,11,43,34,9,43,14,5,4,5,21,16,5,19,16,7,3,6,22,18,4,24,,,Maine Road,Manchester
1992/93,28,20,Southampton,11,32,11,9,12,40,40,0,42,16,8,5,3,24,15,9,29,16,3,4,9,16,25,-9,13,,,The Dell,Southampton
1992/93,28,1,Arsenal,12,30,11,7,12,27,27,0,40,15,6,4,5,16,12,4,22,15,5,3,7,11,15,-4,18,Q,EU_CWC,Highbury,London
1992/93,28,4,Chelsea,13,31,10,10,11,33,38,-5,40,16,5,6,5,16,17,-1,21,15,5,4,6,17,21,-4,19,,,Stamford Bridge,London
1992/93,28,9,Leeds United,14,31,10,9,12,41,45,-4,39,16,10,5,1,32,13,19,35,15,0,4,11,9,32,-23,4,,,Elland Road,Leeds
1992/93,28,7,Everton,15,32,11,6,15,36,42,-6,39,16,5,5,6,17,20,-3,20,16,6,1,9,19,22,-3,19,,,Goodison Park,Liverpool
1992/93,28,10,Liverpool,16,30,9,9,12,40,42,-2,36,15,7,4,4,26,16,10,25,15,2,5,8,14,26,-12,11,,,Anfield,Liverpool
1992/93,28,22,Wimbledon,17,31,9,9,13,36,39,-3,36,16,5,4,7,21,21,0,19,15,4,5,6,15,18,-3,17,,,Selhurst Park,London
1992/93,28,6,Crystal Palace,18,31,8,11,12,37,47,-10,35,15,4,6,5,17,18,-1,18,16,4,5,7,20,29,-9,17,,,Selhurst Park,London
1992/93,28,18,Sheffield United,19,31,9,7,15,37,41,-4,34,15,8,5,2,25,10,15,29,16,1,2,13,12,31,-19,5,,,Bramall Lane,Sheffield
1992/93,28,13,Middlesbrough,20,31,8,9,14,38,52,-14,33,15,6,4,5,22,17,5,22,16,2,5,9,16,35,-19,11,R,EN_D1,Ayresome Park,Middlesbrough
1992/93,28,15,Nottingham Forest,21,30,8,8,14,30,39,-9,32,15,5,3,7,13,14,-1,18,15,3,5,7,17,25,-8,14,R,EN_D1,The City Ground,Nottingham
1992/93,28,16,Oldham Athletic,22,30,7,7,16,40,55,-15,28,14,6,3,5,25,19,6,21,16,1,4,11,15,36,-21,7,R,EN_D1,Boundary Park,Oldham
1992/93,29,12,Manchester United,1,32,17,9,6,49,25,24,60,16,11,3,2,30,11,19,36,16,6,6,4,19,14,5,24,Q,EU_CL,Old Trafford,Manchester
1992/93,29,2,Aston Villa,2,32,17,9,6,48,31,17,60,17,11,4,2,31,14,17,37,15,6,5,4,17,17,0,23,Q,EU_UC,Villa Park,Birmingham
1992/93,29,14,Norwich City,3,32,16,8,8,45,46,-1,56,16,9,6,1,23,14,9,33,16,7,2,7,22,32,-10,23,Q,EU_UC,Carrow Road,Norwich
1992/93,29,19,Sheffield Wednesday,4,31,13,10,8,41,34,7,49,15,7,5,3,23,18,5,26,16,6,5,5,18,16,2,23,,,Hillsborough,Sheffield
1992/93,29,17,Queens Park Rangers,5,32,13,8,11,44,38,6,47,16,8,5,3,31,22,9,29,16,5,3,8,13,16,-3,18,,,MATRADE Loftus Road Stadium,London
1992/93,29,3,Blackburn Rovers,6,31,12,10,9,43,32,11,46,16,9,3,4,27,15,12,30,15,3,7,5,16,17,-1,16,,,Ewood Park,Blackburn
1992/93,29,11,Manchester City,7,31,13,7,11,44,34,10,46,15,6,4,5,22,16,6,22,16,7,3,6,22,18,4,24,,,Maine Road,Manchester
1992/93,29,5,Coventry City,8,33,12,10,11,45,42,3,46,16,6,3,7,23,19,4,21,17,6,7,4,22,23,-1,25,,,Highfield Road,Coventry
1992/93,29,21,Tottenham Hotspur,9,32,12,9,11,39,47,-8,45,16,8,4,4,26,19,7,28,16,4,5,7,13,28,-15,17,,,White Hart Lane,London
1992/93,29,8,Ipswich Town,10,32,10,14,8,37,35,2,44,16,6,7,3,22,17,5,25,16,4,7,5,15,18,-3,19,,,Portman Road,Ipswich
1992/93,29,20,Southampton,11,33,11,10,12,40,40,0,43,16,8,5,3,24,15,9,29,17,3,5,9,16,25,-9,14,,,The Dell,Southampton
1992/93,29,4,Chelsea,12,32,11,10,11,35,39,-4,43,17,6,6,5,18,18,0,24,15,5,4,6,17,21,-4,19,,,Stamford Bridge,London
1992/93,29,1,Arsenal,13,30,11,7,12,27,27,0,40,15,6,4,5,16,12,4,22,15,5,3,7,11,15,-4,18,Q,EU_CWC,Highbury,London
1992/93,29,10,Liverpool,14,31,10,9,12,41,42,-1,39,16,8,4,4,27,16,11,28,15,2,5,8,14,26,-12,11,,,Anfield,Liverpool
1992/93,29,22,Wimbledon,15,32,10,9,13,38,39,-1,39,17,6,4,7,23,21,2,22,15,4,5,6,15,18,-3,17,,,Selhurst Park,London
1992/93,29,9,Leeds United,16,31,10,9,12,41,45,-4,39,16,10,5,1,32,13,19,35,15,0,4,11,9,32,-23,4,,,Elland Road,Leeds
1992/93,29,7,Everton,17,33,11,6,16,37,44,-7,39,16,5,5,6,17,20,-3,20,17,6,1,10,20,24,-4,19,,,Goodison Park,Liverpool
1992/93,29,6,Crystal Palace,18,31,8,11,12,37,47,-10,35,15,4,6,5,17,18,-1,18,16,4,5,7,20,29,-9,17,,,Selhurst Park,London
1992/93,29,18,Sheffield United,19,32,9,7,16,37,42,-5,34,16,8,5,3,25,11,14,29,16,1,2,13,12,31,-19,5,,,Bramall Lane,Sheffield
1992/93,29,13,Middlesbrough,20,32,8,9,15,38,54,-16,33,15,6,4,5,22,17,5,22,17,2,5,10,16,37,-21,11,R,EN_D1,Ayresome Park,Middlesbrough
1992/93,29,15,Nottingham Forest,21,30,8,8,14,30,39,-9,32,15,5,3,7,13,14,-1,18,15,3,5,7,17,25,-8,14,R,EN_D1,The City Ground,Nottingham
1992/93,29,16,Oldham Athletic,22,31,8,7,16,41,55,-14,31,15,7,3,5,26,19,7,24,16,1,4,11,15,36,-21,7,R,EN_D1,Boundary Park,Oldham
1992/93,30,14,Norwich City,1,34,18,8,8,49,46,3,62,17,10,6,1,24,14,10,36,17,8,2,7,25,32,-7,26,Q,EU_CL,Carrow Road,Norwich
1992/93,30,12,Manchester United,2,33,17,10,6,50,26,24,61,17,11,4,2,31,12,19,37,16,6,6,4,19,14,5,24,Q,EU_UC,Old Trafford,Manchester
1992/93,30,2,Aston Villa,3,33,17,10,6,49,32,17,61,17,11,4,2,31,14,17,37,16,6,6,4,18,18,0,24,Q,EU_UC,Villa Park,Birmingham
1992/93,30,19,Sheffield Wednesday,4,31,13,10,8,41,34,7,49,15,7,5,3,23,18,5,26,16,6,5,5,18,16,2,23,,,Hillsborough,Sheffield
1992/93,30,17,Queens Park Rangers,5,33,13,8,12,45,40,5,47,17,8,5,4,32,24,8,29,16,5,3,8,13,16,-3,18,,,MATRADE Loftus Road Stadium,London
1992/93,30,3,Blackburn Rovers,6,31,12,10,9,43,32,11,46,16,9,3,4,27,15,12,30,15,3,7,5,16,17,-1,16,,,Ewood Park,Blackburn
1992/93,30,11,Manchester City,7,32,13,7,12,44,35,9,46,15,6,4,5,22,16,6,22,17,7,3,7,22,19,3,24,,,Maine Road,Manchester
1992/93,30,5,Coventry City,8,34,12,10,12,45,44,1,46,17,6,3,8,23,21,2,21,17,6,7,4,22,23,-1,25,,,Highfield Road,Coventry
1992/93,30,20,Southampton,9,34,12,10,12,44,43,1,46,17,9,5,3,28,18,10,32,17,3,5,9,16,25,-9,14,,,The Dell,Southampton
1992/93,30,21,Tottenham Hotspur,10,32,12,9,11,39,47,-8,45,16,8,4,4,26,19,7,28,16,4,5,7,13,28,-15,17,,,White Hart Lane,London
1992/93,30,8,Ipswich Town,11,33,10,14,9,40,39,1,44,16,6,7,3,22,17,5,25,17,4,7,6,18,22,-4,19,,,Portman Road,Ipswich
1992/93,30,4,Chelsea,12,33,11,11,11,36,40,-4,44,17,6,6,5,18,18,0,24,16,5,5,6,18,22,-4,20,,,Stamford Bridge,London
1992/93,30,1,Arsenal,13,31,12,7,12,29,27,2,43,15,6,4,5,16,12,4,22,16,6,3,7,13,15,-2,21,Q,EU_CWC,Highbury,London
1992/93,30,10,Liverpool,14,32,11,9,12,43,43,0,42,16,8,4,4,27,16,11,28,16,3,5,8,16,27,-11,14,,,Anfield,Liverpool
1992/93,30,22,Wimbledon,15,33,11,9,13,40,40,0,42,17,6,4,7,23,21,2,22,16,5,5,6,17,19,-2,20,,,Selhurst Park,London
1992/93,30,9,Leeds United,16,32,11,9,12,42,45,-3,42,17,11,5,1,33,13,20,38,15,0,4,11,9,32,-23,4,,,Elland Road,Leeds
1992/93,30,7,Everton,17,34,12,6,16,40,44,-4,42,17,6,5,6,20,20,0,23,17,6,1,10,20,24,-4,19,,,Goodison Park,Liverpool
1992/93,30,6,Crystal Palace,18,32,8,12,12,38,48,-10,36,16,4,7,5,18,19,-1,19,16,4,5,7,20,29,-9,17,,,Selhurst Park,London
1992/93,30,18,Sheffield United,19,32,9,7,16,37,42,-5,34,16,8,5,3,25,11,14,29,16,1,2,13,12,31,-19,5,,,Bramall Lane,Sheffield
1992/93,30,13,Middlesbrough,20,33,8,9,16,39,56,-17,33,16,6,4,6,23,19,4,22,17,2,5,10,16,37,-21,11,R,EN_D1,Ayresome Park,Middlesbrough
1992/93,30,15,Nottingham Forest,21,32,8,8,16,30,45,-15,32,16,5,3,8,13,17,-4,18,16,3,5,8,17,28,-11,14,R,EN_D1,The City Ground,Nottingham
1992/93,30,16,Oldham Athletic,22,32,8,7,17,41,56,-15,31,15,7,3,5,26,19,7,24,17,1,4,12,15,37,-22,7,R,EN_D1,Boundary Park,Oldham
1992/93,31,14,Norwich City,1,36,19,8,9,50,49,1,65,18,11,6,1,25,14,11,39,18,8,2,8,25,35,-10,26,Q,EU_CL,Carrow Road,Norwich
1992/93,31,2,Aston Villa,2,35,18,10,7,51,33,18,64,18,12,4,2,33,14,19,40,17,6,6,5,18,19,-1,24,Q,EU_UC,Villa Park,Birmingham
1992/93,31,12,Manchester United,3,35,17,12,6,51,27,24,63,18,11,5,2,31,12,19,38,17,6,7,4,20,15,5,25,Q,EU_UC,Old Trafford,Manchester
1992/93,31,3,Blackburn Rovers,4,33,13,11,9,47,33,14,50,17,9,4,4,28,16,12,31,16,4,7,5,19,17,2,19,,,Ewood Park,Blackburn
1992/93,31,19,Sheffield Wednesday,5,33,13,11,9,42,37,5,50,16,7,6,3,24,19,5,27,17,6,5,6,18,18,0,23,,,Hillsborough,Sheffield
1992/93,31,21,Tottenham Hotspur,6,34,13,10,11,43,49,-6,49,17,9,4,4,29,20,9,31,17,4,6,7,14,29,-15,18,,,White Hart Lane,London
1992/93,31,17,Queens Park Rangers,7,35,13,9,13,47,45,2,48,18,8,5,5,32,27,5,29,17,5,4,8,15,18,-3,19,,,MATRADE Loftus Road Stadium,London
1992/93,31,11,Manchester City,8,34,13,8,13,46,39,7,47,16,6,5,5,23,17,6,23,18,7,3,8,23,22,1,24,,,Maine Road,Manchester
1992/93,31,1,Arsenal,9,33,13,8,12,33,30,3,47,16,7,4,5,20,15,5,25,17,6,4,7,13,15,-2,22,Q,EU_CWC,Highbury,London
1992/93,31,5,Coventry City,10,36,12,11,13,46,47,-1,47,18,6,3,9,24,24,0,21,18,6,8,4,22,23,-1,26,,,Highfield Road,Coventry
1992/93,31,22,Wimbledon,11,35,12,10,13,44,41,3,46,18,7,4,7,26,21,5,25,17,5,6,6,18,20,-2,21,,,Selhurst Park,London
1992/93,31,10,Liverpool,12,34,12,10,12,45,44,1,46,17,9,4,4,28,16,12,31,17,3,6,8,17,28,-11,15,,,Anfield,Liverpool
1992/93,31,20,Southampton,13,36,12,10,14,48,49,-1,46,18,9,5,4,29,20,9,32,18,3,5,10,19,29,-10,14,,,The Dell,Southampton
1992/93,31,4,Chelsea,14,35,11,13,11,38,42,-4,46,18,6,7,5,19,19,0,25,17,5,6,6,19,23,-4,21,,,Stamford Bridge,London
1992/93,31,7,Everton,15,36,13,6,17,43,45,-2,45,18,7,5,6,23,20,3,26,18,6,1,11,20,25,-5,19,,,Goodison Park,Liverpool
1992/93,31,8,Ipswich Town,16,35,10,15,10,40,42,-2,45,17,6,8,3,22,17,5,26,18,4,7,7,18,25,-7,19,,,Portman Road,Ipswich
1992/93,31,9,Leeds United,17,34,11,11,12,44,47,-3,44,18,11,6,1,34,14,20,39,16,0,5,11,10,33,-23,5,,,Elland Road,Leeds
1992/93,31,6,Crystal Palace,18,34,9,13,12,40,49,-9,40,17,4,8,5,19,20,-1,20,17,5,5,7,21,29,-8,20,,,Selhurst Park,London
1992/93,31,18,Sheffield United,19,34,10,7,17,40,44,-4,37,17,8,5,4,25,12,13,29,17,2,2,13,15,32,-17,8,,,Bramall Lane,Sheffield
1992/93,31,15,Nottingham Forest,20,34,9,9,16,33,47,-14,36,17,5,4,8,14,18,-4,19,17,4,5,8,19,29,-10,17,R,EN_D1,The City Ground,Nottingham
1992/93,31,16,Oldham Athletic,21,34,9,8,17,46,60,-14,35,16,7,4,5,28,21,7,25,18,2,4,12,18,39,-21,10,R,EN_D1,Boundary Park,Oldham
1992/93,31,13,Middlesbrough,22,35,8,10,17,42,60,-18,34,17,6,4,7,25,22,3,22,18,2,6,10,17,38,-21,12,R,EN_D1,Ayresome Park,Middlesbrough
1992/93,32,2,Aston Villa,1,36,19,10,7,52,33,19,67,18,12,4,2,33,14,19,40,18,7,6,5,19,19,0,27,Q,EU_CL,Villa Park,Birmingham
1992/93,32,12,Manchester United,2,36,18,12,6,54,28,26,66,18,11,5,2,31,12,19,38,18,7,7,4,23,16,7,28,Q,EU_UC,Old Trafford,Manchester
1992/93,32,14,Norwich City,3,37,19,8,10,51,52,-1,65,19,11,6,2,26,17,9,39,18,8,2,8,25,35,-10,26,Q,EU_UC,Carrow Road,Norwich
1992/93,32,3,Blackburn Rovers,4,35,15,11,9,54,35,19,56,18,10,4,4,32,17,15,34,17,5,7,5,22,18,4,22,,,Ewood Park,Blackburn
1992/93,32,19,Sheffield Wednesday,5,34,13,12,9,43,38,5,51,16,7,6,3,24,19,5,27,18,6,6,6,19,19,0,24,,,Hillsborough,Sheffield
1992/93,32,11,Manchester City,6,35,14,8,13,49,40,9,50,17,7,5,5,26,18,8,26,18,7,3,8,23,22,1,24,,,Maine Road,Manchester
1992/93,32,5,Coventry City,7,37,13,11,13,48,47,1,50,19,7,3,9,26,24,2,24,18,6,8,4,22,23,-1,26,,,Highfield Road,Coventry
1992/93,32,4,Chelsea,8,37,12,14,11,43,43,0,50,19,7,7,5,23,19,4,28,18,5,7,6,20,24,-4,22,,,Stamford Bridge,London
1992/93,32,17,Queens Park Rangers,9,36,13,10,13,48,46,2,49,18,8,5,5,32,27,5,29,18,5,5,8,16,19,-3,20,,,MATRADE Loftus Road Stadium,London
1992/93,32,21,Tottenham Hotspur,10,34,13,10,11,43,49,-6,49,17,9,4,4,29,20,9,31,17,4,6,7,14,29,-15,18,,,White Hart Lane,London
1992/93,32,1,Arsenal,11,34,13,8,13,33,31,2,47,16,7,4,5,20,15,5,25,18,6,4,8,13,16,-3,22,Q,EU_CWC,Highbury,London
1992/93,32,22,Wimbledon,12,36,12,10,14,46,47,-1,46,18,7,4,7,26,21,5,25,18,5,6,7,20,26,-6,21,,,Selhurst Park,London
1992/93,32,10,Liverpool,13,35,12,10,13,46,48,-2,46,17,9,4,4,28,16,12,31,18,3,6,9,18,32,-14,15,,,Anfield,Liverpool
1992/93,32,20,Southampton,14,37,12,10,15,48,51,-3,46,18,9,5,4,29,20,9,32,19,3,5,11,19,31,-12,14,,,The Dell,Southampton
1992/93,32,8,Ipswich Town,15,37,10,16,11,42,46,-4,46,18,6,9,3,23,18,5,27,19,4,7,8,19,28,-9,19,,,Portman Road,Ipswich
1992/93,32,7,Everton,16,36,13,6,17,43,45,-2,45,18,7,5,6,23,20,3,26,18,6,1,11,20,25,-5,19,,,Goodison Park,Liverpool
1992/93,32,9,Leeds United,17,35,11,11,13,45,49,-4,44,18,11,6,1,34,14,20,39,17,0,5,12,11,35,-24,5,,,Elland Road,Leeds
1992/93,32,6,Crystal Palace,18,35,9,14,12,41,50,-9,41,18,4,9,5,20,21,-1,21,17,5,5,7,21,29,-8,20,,,Selhurst Park,London
1992/93,32,18,Sheffield United,19,35,11,7,17,42,45,-3,40,18,9,5,4,27,13,14,32,17,2,2,13,15,32,-17,8,,,Bramall Lane,Sheffield
1992/93,32,16,Oldham Athletic,20,36,10,9,17,53,63,-10,39,18,8,5,5,35,24,11,29,18,2,4,12,18,39,-21,10,R,EN_D1,Boundary Park,Oldham
1992/93,32,13,Middlesbrough,21,37,9,10,18,43,64,-21,37,18,7,4,7,26,22,4,25,19,2,6,11,17,42,-25,12,R,EN_D1,Ayresome Park,Middlesbrough
1992/93,32,15,Nottingham Forest,22,36,9,9,18,34,51,-17,36,19,5,4,10,15,22,-7,19,17,4,5,8,19,29,-10,17,R,EN_D1,The City Ground,Nottingham
1992/93,33,12,Manchester United,1,37,19,12,6,56,29,27,69,19,12,5,2,33,13,20,41,18,7,7,4,23,16,7,28,Q,EU_CL,Old Trafford,Manchester
1992/93,33,2,Aston Villa,2,37,19,11,7,52,33,19,68,19,12,5,2,33,14,19,41,18,7,6,5,19,19,0,27,Q,EU_UC,Villa Park,Birmingham
1992/93,33,14,Norwich City,3,38,19,8,11,52,57,-5,65,19,11,6,2,26,17,9,39,19,8,2,9,26,40,-14,26,Q,EU_UC,Carrow Road,Norwich
1992/93,33,3,Blackburn Rovers,4,36,15,11,10,56,40,16,56,18,10,4,4,32,17,15,34,18,5,7,6,24,23,1,22,,,Ewood Park,Blackburn
1992/93,33,17,Queens Park Rangers,5,37,14,10,13,52,49,3,52,19,9,5,5,36,30,6,32,18,5,5,8,16,19,-3,20,,,MATRADE Loftus Road Stadium,London
1992/93,33,21,Tottenham Hotspur,6,35,14,10,11,48,50,-2,52,18,10,4,4,34,21,13,34,17,4,6,7,14,29,-15,18,,,White Hart Lane,London
1992/93,33,11,Manchester City,7,36,14,9,13,50,41,9,51,17,7,5,5,26,18,8,26,19,7,4,8,24,23,1,25,,,Maine Road,Manchester
1992/93,33,19,Sheffield Wednesday,8,35,13,12,10,44,40,4,51,16,7,6,3,24,19,5,27,19,6,6,7,20,21,-1,24,,,Hillsborough,Sheffield
1992/93,33,5,Coventry City,9,38,13,12,13,48,47,1,51,19,7,3,9,26,24,2,24,19,6,9,4,22,23,-1,27,,,Highfield Road,Coventry
1992/93,33,1,Arsenal,10,35,14,8,13,35,32,3,50,16,7,4,5,20,15,5,25,19,7,4,8,15,17,-2,25,Q,EU_CWC,Highbury,London
1992/93,33,4,Chelsea,11,38,12,14,12,43,44,-1,50,19,7,7,5,23,19,4,28,19,5,7,7,20,25,-5,22,,,Stamford Bridge,London
1992/93,33,22,Wimbledon,12,37,13,10,14,50,47,3,49,19,8,4,7,30,21,9,28,18,5,6,7,20,26,-6,21,,,Selhurst Park,London
1992/93,33,10,Liverpool,13,36,13,10,13,47,48,-1,49,18,10,4,4,29,16,13,34,18,3,6,9,18,32,-14,15,,,Anfield,Liverpool
1992/93,33,20,Southampton,14,38,13,10,15,49,51,-2,49,19,10,5,4,30,20,10,35,19,3,5,11,19,31,-12,14,,,The Dell,Southampton
1992/93,33,7,Everton,15,37,14,6,17,45,46,-1,48,18,7,5,6,23,20,3,26,19,7,1,11,22,26,-4,22,,,Goodison Park,Liverpool
1992/93,33,9,Leeds United,16,36,12,11,13,50,51,-1,47,19,12,6,1,39,16,23,42,17,0,5,12,11,35,-24,5,,,Elland Road,Leeds
1992/93,33,8,Ipswich Town,17,38,10,16,12,43,48,-5,46,19,6,9,4,24,20,4,27,19,4,7,8,19,28,-9,19,,,Portman Road,Ipswich
1992/93,33,18,Sheffield United,18,36,11,8,17,43,46,-3,41,19,9,6,4,28,14,14,33,17,2,2,13,15,32,-17,8,,,Bramall Lane,Sheffield
1992/93,33,6,Crystal Palace,19,36,9,14,13,41,54,-13,41,18,4,9,5,20,21,-1,21,18,5,5,8,21,33,-12,20,,,Selhurst Park,London
1992/93,33,16,Oldham Athletic,20,37,10,9,18,53,64,-11,39,18,8,5,5,35,24,11,29,19,2,4,13,18,40,-22,10,R,EN_D1,Boundary Park,Oldham
1992/93,33,13,Middlesbrough,21,38,9,10,19,44,66,-22,37,19,7,4,8,27,24,3,25,19,2,6,11,17,42,-25,12,R,EN_D1,Ayresome Park,Middlesbrough
1992/93,33,15,Nottingham Forest,22,37,9,9,19,37,55,-18,36,19,5,4,10,15,22,-7,19,18,4,5,9,22,33,-11,17,R,EN_D1,The City Ground,Nottingham
1992/93,34,12,Manchester United,1,38,20,12,6,57,29,28,72,19,12,5,2,33,13,20,41,19,8,7,4,24,16,8,31,Q,EU_CL,Old Trafford,Manchester
1992/93,34,2,Aston Villa,2,38,20,11,7,53,33,20,71,19,12,5,2,33,14,19,41,19,8,6,5,20,19,1,30,Q,EU_UC,Villa Park,Birmingham
1992/93,34,14,Norwich City,3,39,20,8,11,56,59,-3,68,20,12,6,2,30,19,11,42,19,8,2,9,26,40,-14,26,Q,EU_UC,Carrow Road,Norwich
1992/93,34,3,Blackburn Rovers,4,37,16,11,10,58,41,17,59,19,11,4,4,34,18,16,37,18,5,7,6,24,23,1,22,,,Ewood Park,Blackburn
1992/93,34,17,Queens Park Rangers,5,38,15,10,13,57,52,5,55,19,9,5,5,36,30,6,32,19,6,5,8,21,22,-1,23,,,MATRADE Loftus Road Stadium,London
1992/93,34,19,Sheffield Wednesday,6,36,14,12,10,49,42,7,54,17,8,6,3,29,21,8,30,19,6,6,7,20,21,-1,24,,,Hillsborough,Sheffield
1992/93,34,4,Chelsea,7,39,13,14,12,47,46,1,53,20,8,7,5,27,21,6,31,19,5,7,7,20,25,-5,22,,,Stamford Bridge,London
1992/93,34,11,Manchester City,8,37,14,10,13,51,42,9,52,18,7,6,5,27,19,8,27,19,7,4,8,24,23,1,25,,,Maine Road,Manchester
1992/93,34,21,Tottenham Hotspur,9,36,14,10,12,49,52,-3,52,18,10,4,4,34,21,13,34,18,4,6,8,15,31,-16,18,,,White Hart Lane,London
1992/93,34,5,Coventry City,10,39,13,12,14,48,48,0,51,20,7,3,10,26,25,1,24,19,6,9,4,22,23,-1,27,,,Highfield Road,Coventry
1992/93,34,1,Arsenal,11,36,14,8,14,35,33,2,50,17,7,4,6,20,16,4,25,19,7,4,8,15,17,-2,25,Q,EU_CWC,Highbury,London
1992/93,34,10,Liverpool,12,37,13,11,13,48,49,-1,50,18,10,4,4,29,16,13,34,19,3,7,9,19,33,-14,16,,,Anfield,Liverpool
1992/93,34,22,Wimbledon,13,38,13,10,15,52,51,1,49,19,8,4,7,30,21,9,28,19,5,6,8,22,30,-8,21,,,Selhurst Park,London
1992/93,34,20,Southampton,14,39,13,10,16,51,56,-5,49,19,10,5,4,30,20,10,35,20,3,5,12,21,36,-15,14,,,The Dell,Southampton
1992/93,34,7,Everton,15,38,14,6,18,48,51,-3,48,19,7,5,7,26,25,1,26,19,7,1,11,22,26,-4,22,,,Goodison Park,Liverpool
1992/93,34,9,Leeds United,16,37,12,11,14,52,55,-3,47,19,12,6,1,39,16,23,42,18,0,5,13,13,39,-26,5,,,Elland Road,Leeds
1992/93,34,8,Ipswich Town,17,39,10,16,13,44,50,-6,46,19,6,9,4,24,20,4,27,20,4,7,9,20,30,-10,19,,,Portman Road,Ipswich
1992/93,34,6,Crystal Palace,18,37,10,14,13,45,55,-10,44,19,5,9,5,24,22,2,24,18,5,5,8,21,33,-12,20,,,Selhurst Park,London
1992/93,34,18,Sheffield United,19,37,11,9,17,44,47,-3,42,19,9,6,4,28,14,14,33,18,2,3,13,16,33,-17,9,,,Bramall Lane,Sheffield
1992/93,34,16,Oldham Athletic,20,38,10,10,18,54,65,-11,40,19,8,6,5,36,25,11,30,19,2,4,13,18,40,-22,10,R,EN_D1,Boundary Park,Oldham
1992/93,34,15,Nottingham Forest,21,38,10,9,19,39,56,-17,39,20,6,4,10,17,23,-6,22,18,4,5,9,22,33,-11,17,R,EN_D1,The City Ground,Nottingham
1992/93,34,13,Middlesbrough,22,39,9,10,20,45,70,-25,37,19,7,4,8,27,24,3,25,20,2,6,12,18,46,-28,12,R,EN_D1,Ayresome Park,Middlesbrough
1992/93,35,12,Manchester United,1,40,22,12,6,62,29,33,78,20,13,5,2,36,13,23,44,20,9,7,4,26,16,10,34,Q,EU_CL,Old Trafford,Manchester
1992/93,35,2,Aston Villa,2,40,21,11,8,56,37,19,74,20,13,5,2,36,15,21,44,20,8,6,6,20,22,-2,30,Q,EU_UC,Villa Park,Birmingham
1992/93,35,14,Norwich City,3,40,20,8,12,57,62,-5,68,20,12,6,2,30,19,11,42,20,8,2,10,27,43,-16,26,Q,EU_UC,Carrow Road,Norwich
1992/93,35,3,Blackburn Rovers,4,39,18,11,10,64,42,22,65,20,12,4,4,37,18,19,40,19,6,7,6,27,24,3,25,,,Ewood Park,Blackburn
1992/93,35,10,Liverpool,5,39,15,11,13,54,49,5,56,20,12,4,4,35,16,19,40,19,3,7,9,19,33,-14,16,,,Anfield,Liverpool
1992/93,35,19,Sheffield Wednesday,6,37,14,13,10,50,43,7,55,18,8,7,3,30,22,8,31,19,6,6,7,20,21,-1,24,,,Hillsborough,Sheffield
1992/93,35,17,Queens Park Rangers,7,38,15,10,13,57,52,5,55,19,9,5,5,36,30,6,32,19,6,5,8,21,22,-1,23,,,MATRADE Loftus Road Stadium,London
1992/93,35,21,Tottenham Hotspur,8,38,15,10,13,53,56,-3,55,19,11,4,4,38,22,16,37,19,4,6,9,15,34,-19,18,,,White Hart Lane,London
1992/93,35,11,Manchester City,9,39,14,11,14,53,46,7,53,19,7,7,5,28,20,8,28,20,7,4,9,25,26,-1,25,,,Maine Road,Manchester
1992/93,35,22,Wimbledon,10,40,14,11,15,54,52,2,53,20,9,4,7,31,21,10,31,20,5,7,8,23,31,-8,22,,,Selhurst Park,London
1992/93,35,4,Chelsea,11,40,13,14,13,47,49,-2,53,20,8,7,5,27,21,6,31,20,5,7,8,20,28,-8,22,,,Stamford Bridge,London
1992/93,35,1,Arsenal,12,37,14,9,14,36,34,2,51,18,7,5,6,21,17,4,26,19,7,4,8,15,17,-2,25,Q,EU_CWC,Highbury,London
1992/93,35,5,Coventry City,13,40,13,12,15,48,52,-4,51,20,7,3,10,26,25,1,24,20,6,9,5,22,27,-5,27,,,Highfield Road,Coventry
1992/93,35,20,Southampton,14,40,13,11,16,51,56,-5,50,20,10,6,4,30,20,10,36,20,3,5,12,21,36,-15,14,,,The Dell,Southampton
1992/93,35,7,Everton,15,39,14,7,18,48,51,-3,49,19,7,5,7,26,25,1,26,20,7,2,11,22,26,-4,23,,,Goodison Park,Liverpool
1992/93,35,8,Ipswich Town,16,40,11,16,13,47,51,-4,49,20,7,9,4,27,21,6,30,20,4,7,9,20,30,-10,19,,,Portman Road,Ipswich
1992/93,35,9,Leeds United,17,39,12,12,15,52,57,-5,48,20,12,7,1,39,16,23,43,19,0,5,14,13,41,-28,5,,,Elland Road,Leeds
1992/93,35,6,Crystal Palace,18,39,10,15,14,45,57,-12,45,20,5,9,6,24,24,0,24,19,5,6,8,21,33,-12,21,,,Selhurst Park,London
1992/93,35,18,Sheffield United,19,39,11,10,18,46,51,-5,43,20,9,6,5,29,17,12,33,19,2,4,13,17,34,-17,10,,,Bramall Lane,Sheffield
1992/93,35,16,Oldham Athletic,20,39,10,10,19,55,69,-14,40,19,8,6,5,36,25,11,30,20,2,4,14,19,44,-25,10,R,EN_D1,Boundary Park,Oldham
1992/93,35,15,Nottingham Forest,21,40,10,10,20,40,58,-18,40,20,6,4,10,17,23,-6,22,20,4,6,10,23,35,-12,18,R,EN_D1,The City Ground,Nottingham
1992/93,35,13,Middlesbrough,22,40,10,10,20,48,70,-22,40,20,8,4,8,30,24,6,28,20,2,6,12,18,46,-28,12,R,EN_D1,Ayresome Park,Middlesbrough
1992/93,36,12,Manchester United,1,41,23,12,6,65,30,35,81,21,14,5,2,39,14,25,47,20,9,7,4,26,16,10,34,Q,EU_CL,Old Trafford,Manchester
1992/93,36,2,Aston Villa,2,41,21,11,9,56,38,18,74,21,13,5,3,36,16,20,44,20,8,6,6,20,22,-2,30,Q,EU_UC,Villa Park,Birmingham
1992/93,36,14,Norwich City,3,41,21,8,12,58,62,-4,71,21,13,6,2,31,19,12,45,20,8,2,10,27,43,-16,26,Q,EU_UC,Carrow Road,Norwich
1992/93,36,3,Blackburn Rovers,4,41,19,11,11,67,46,21,68,20,12,4,4,37,18,19,40,21,7,7,7,30,28,2,28,,,Ewood Park,Blackburn
1992/93,36,19,Sheffield Wednesday,5,40,15,14,11,54,47,7,59,21,9,8,4,34,26,8,35,19,6,6,7,20,21,-1,24,,,Hillsborough,Sheffield
1992/93,36,11,Manchester City,6,41,15,12,14,54,46,8,57,20,7,8,5,28,20,8,29,21,8,4,9,26,26,0,28,,,Maine Road,Manchester
1992/93,36,17,Queens Park Rangers,7,40,15,12,13,58,53,5,57,19,9,5,5,36,30,6,32,21,6,7,8,22,23,-1,25,,,MATRADE Loftus Road Stadium,London
1992/93,36,10,Liverpool,8,41,15,11,15,56,53,3,56,20,12,4,4,35,16,19,40,21,3,7,11,21,37,-16,16,,,Anfield,Liverpool
1992/93,36,4,Chelsea,9,41,14,14,13,49,50,-1,56,21,9,7,5,29,22,7,34,20,5,7,8,20,28,-8,22,,,Stamford Bridge,London
1992/93,36,21,Tottenham Hotspur,10,40,15,11,14,55,59,-4,56,21,11,5,5,40,25,15,38,19,4,6,9,15,34,-19,18,,,White Hart Lane,London
1992/93,36,22,Wimbledon,11,41,14,12,15,55,53,2,54,20,9,4,7,31,21,10,31,21,5,8,8,24,32,-8,23,,,Selhurst Park,London
1992/93,36,1,Arsenal,12,40,14,11,15,36,35,1,53,19,7,6,6,21,17,4,27,21,7,5,9,15,18,-3,26,Q,EU_CWC,Highbury,London
1992/93,36,5,Coventry City,13,41,13,12,16,49,54,-5,51,20,7,3,10,26,25,1,24,21,6,9,6,23,29,-6,27,,,Highfield Road,Coventry
1992/93,36,9,Leeds United,14,41,12,14,15,54,59,-5,50,21,12,8,1,40,17,23,44,20,0,6,14,14,42,-28,6,,,Elland Road,Leeds
1992/93,36,7,Everton,15,41,14,8,19,48,53,-5,50,21,7,6,8,26,27,-1,27,20,7,2,11,22,26,-4,23,,,Goodison Park,Liverpool
1992/93,36,20,Southampton,16,41,13,11,17,51,57,-6,50,21,10,6,5,30,21,9,36,20,3,5,12,21,36,-15,14,,,The Dell,Southampton
1992/93,36,18,Sheffield United,17,41,13,10,18,50,51,-1,49,20,9,6,5,29,17,12,33,21,4,4,13,21,34,-13,16,,,Bramall Lane,Sheffield
1992/93,36,8,Ipswich Town,18,41,11,16,14,48,54,-6,49,20,7,9,4,27,21,6,30,21,4,7,10,21,33,-12,19,,,Portman Road,Ipswich
1992/93,36,6,Crystal Palace,19,41,11,16,14,48,58,-10,49,21,6,9,6,27,25,2,27,20,5,7,8,21,33,-12,22,,,Selhurst Park,London
1992/93,36,16,Oldham Athletic,20,41,12,10,19,59,71,-12,46,20,9,6,5,39,27,12,33,21,3,4,14,20,44,-24,13,R,EN_D1,Boundary Park,Oldham
1992/93,36,13,Middlesbrough,21,41,11,10,20,51,72,-21,43,20,8,4,8,30,24,6,28,21,3,6,12,21,48,-27,15,R,EN_D1,Ayresome Park,Middlesbrough
1992/93,36,15,Nottingham Forest,22,41,10,10,21,40,60,-20,40,21,6,4,11,17,25,-8,22,20,4,6,10,23,35,-12,18,R,EN_D1,The City Ground,Nottingham
1992/93,37,12,Manchester United,1,42,24,12,6,67,31,36,84,21,14,5,2,39,14,25,47,21,10,7,4,28,17,11,37,Q,EU_CL,Old Trafford,Manchester
1992/93,37,2,Aston Villa,2,42,21,11,10,57,40,17,74,21,13,5,3,36,16,20,44,21,8,6,7,21,24,-3,30,Q,EU_UC,Villa Park,Birmingham
1992/93,37,14,Norwich City,3,42,21,9,12,61,65,-4,72,21,13,6,2,31,19,12,45,21,8,3,10,30,46,-16,27,Q,EU_UC,Carrow Road,Norwich
1992/93,37,3,Blackburn Rovers,4,42,20,11,11,68,46,22,71,21,13,4,4,38,18,20,43,21,7,7,7,30,28,2,28,,,Ewood Park,Blackburn
1992/93,37,17,Queens Park Rangers,5,41,16,12,13,60,54,6,60,20,10,5,5,38,31,7,35,21,6,7,8,22,23,-1,25,,,MATRADE Loftus Road Stadium,London
1992/93,37,10,Liverpool,6,42,16,11,15,62,55,7,59,21,13,4,4,41,18,23,43,21,3,7,11,21,37,-16,16,,,Anfield,Liverpool
1992/93,37,19,Sheffield Wednesday,7,41,15,14,12,54,48,6,59,21,9,8,4,34,26,8,35,20,6,6,8,20,22,-2,24,,,Hillsborough,Sheffield
1992/93,37,11,Manchester City,8,42,15,12,15,56,51,5,57,21,7,8,6,30,25,5,29,21,8,4,9,26,26,0,28,,,Maine Road,Manchester
1992/93,37,1,Arsenal,9,41,15,11,15,39,35,4,56,20,8,6,6,24,17,7,30,21,7,5,9,15,18,-3,26,Q,EU_CWC,Highbury,London
1992/93,37,4,Chelsea,10,42,14,14,14,51,54,-3,56,21,9,7,5,29,22,7,34,21,5,7,9,22,32,-10,22,,,Stamford Bridge,London
1992/93,37,21,Tottenham Hotspur,11,41,15,11,15,57,65,-8,56,21,11,5,5,40,25,15,38,20,4,6,10,17,40,-23,18,,,White Hart Lane,London
1992/93,37,22,Wimbledon,12,42,14,12,16,56,55,1,54,21,9,4,8,32,23,9,31,21,5,8,8,24,32,-8,23,,,Selhurst Park,London
1992/93,37,7,Everton,13,42,15,8,19,53,55,-2,53,21,7,6,8,26,27,-1,27,21,8,2,11,27,28,-1,26,,,Goodison Park,Liverpool
1992/93,37,18,Sheffield United,14,42,14,10,18,54,53,1,52,21,10,6,5,33,19,14,36,21,4,4,13,21,34,-13,16,,,Bramall Lane,Sheffield
1992/93,37,5,Coventry City,15,42,13,13,16,52,57,-5,52,21,7,4,10,29,28,1,25,21,6,9,6,23,29,-6,27,,,Highfield Road,Coventry
1992/93,37,8,Ipswich Town,16,42,12,16,14,50,55,-5,52,21,8,9,4,29,22,7,33,21,4,7,10,21,33,-12,19,,,Portman Road,Ipswich
1992/93,37,9,Leeds United,17,42,12,15,15,57,62,-5,51,21,12,8,1,40,17,23,44,21,0,7,14,17,45,-28,7,,,Elland Road,Leeds
1992/93,37,20,Southampton,18,42,13,11,18,54,61,-7,50,21,10,6,5,30,21,9,36,21,3,5,13,24,40,-16,14,,,The Dell,Southampton
1992/93,37,16,Oldham Athletic,19,42,13,10,19,63,74,-11,49,21,10,6,5,43,30,13,36,21,3,4,14,20,44,-24,13,,,Boundary Park,Oldham
1992/93,37,6,Crystal Palace,20,42,11,16,15,48,61,-13,49,21,6,9,6,27,25,2,27,21,5,7,9,21,36,-15,22,R,EN_D1,Selhurst Park,London
1992/93,37,13,Middlesbrough,21,42,11,11,20,54,75,-21,44,21,8,5,8,33,27,6,29,21,3,6,12,21,48,-27,15,R,EN_D1,Ayresome Park,Middlesbrough
1992/93,37,15,Nottingham Forest,22,42,10,10,22,41,62,-21,40,21,6,4,11,17,25,-8,22,21,4,6,11,24,37,-13,18,R,EN_D1,The City Ground,Nottingham
1992/93,38,12,Manchester United,1,42,24,12,6,67,31,36,84,21,14,5,2,39,14,25,47,21,10,7,4,28,17,11,37,Q,EU_CL,Old Trafford,Manchester
1992/93,38,2,Aston Villa,2,42,21,11,10,57,40,17,74,21,13,5,3,36,16,20,44,21,8,6,7,21,24,-3,30,Q,EU_UC,Villa Park,Birmingham
1992/93,38,14,Norwich City,3,42,21,9,12,61,65,-4,72,21,13,6,2,31,19,12,45,21,8,3,10,30,46,-16,27,Q,EU_UC,Carrow Road,Norwich
1992/93,38,3,Blackburn Rovers,4,42,20,11,11,68,46,22,71,21,13,4,4,38,18,20,43,21,7,7,7,30,28,2,28,,,Ewood Park,Blackburn
1992/93,38,17,Queens Park Rangers,5,42,17,12,13,63,55,8,63,21,11,5,5,41,32,9,38,21,6,7,8,22,23,-1,25,,,MATRADE Loftus Road Stadium,London
1992/93,38,10,Liverpool,6,42,16,11,15,62,55,7,59,21,13,4,4,41,18,23,43,21,3,7,11,21,37,-16,16,,,Anfield,Liverpool
1992/93,38,19,Sheffield Wednesday,7,42,15,14,13,55,51,4,59,21,9,8,4,34,26,8,35,21,6,6,9,21,25,-4,24,,,Hillsborough,Sheffield
1992/93,38,21,Tottenham Hotspur,8,42,16,11,15,60,66,-6,59,21,11,5,5,40,25,15,38,21,5,6,10,20,41,-21,21,,,White Hart Lane,London
1992/93,38,11,Manchester City,9,42,15,12,15,56,51,5,57,21,7,8,6,30,25,5,29,21,8,4,9,26,26,0,28,,,Maine Road,Manchester
1992/93,38,1,Arsenal,10,42,15,11,16,40,38,2,56,21,8,6,7,25,20,5,30,21,7,5,9,15,18,-3,26,Q,EU_CWC,Highbury,London
1992/93,38,4,Chelsea,11,42,14,14,14,51,54,-3,56,21,9,7,5,29,22,7,34,21,5,7,9,22,32,-10,22,,,Stamford Bridge,London
1992/93,38,22,Wimbledon,12,42,14,12,16,56,55,1,54,21,9,4,8,32,23,9,31,21,5,8,8,24,32,-8,23,,,Selhurst Park,London
1992/93,38,7,Everton,13,42,15,8,19,53,55,-2,53,21,7,6,8,26,27,-1,27,21,8,2,11,27,28,-1,26,,,Goodison Park,Liverpool
1992/93,38,18,Sheffield United,14,42,14,10,18,54,53,1,52,21,10,6,5,33,19,14,36,21,4,4,13,21,34,-13,16,,,Bramall Lane,Sheffield
1992/93,38,5,Coventry City,15,42,13,13,16,52,57,-5,52,21,7,4,10,29,28,1,25,21,6,9,6,23,29,-6,27,,,Highfield Road,Coventry
1992/93,38,8,Ipswich Town,16,42,12,16,14,50,55,-5,52,21,8,9,4,29,22,7,33,21,4,7,10,21,33,-12,19,,,Portman Road,Ipswich
1992/93,38,9,Leeds United,17,42,12,15,15,57,62,-5,51,21,12,8,1,40,17,23,44,21,0,7,14,17,45,-28,7,,,Elland Road,Leeds
1992/93,38,20,Southampton,18,42,13,11,18,54,61,-7,50,21,10,6,5,30,21,9,36,21,3,5,13,24,40,-16,14,,,The Dell,Southampton
1992/93,38,16,Oldham Athletic,19,42,13,10,19,63,74,-11,49,21,10,6,5,43,30,13,36,21,3,4,14,20,44,-24,13,,,Boundary Park,Oldham
1992/93,38,6,Crystal Palace,20,42,11,16,15,48,61,-13,49,21,6,9,6,27,25,2,27,21,5,7,9,21,36,-15,22,R,EN_D1,Selhurst Park,London
1992/93,38,13,Middlesbrough,21,42,11,11,20,54,75,-21,44,21,8,5,8,33,27,6,29,21,3,6,12,21,48,-27,15,R,EN_D1,Ayresome Park,Middlesbrough
1992/93,38,15,Nottingham Forest,22,42,10,10,22,41,62,-21,40,21,6,4,11,17,25,-8,22,21,4,6,11,24,37,-13,18,R,EN_D1,The City Ground,Nottingham
