season,match_week,team_id,team_name,position,played,won,drawn,lost,goals_for,goals_against,goal_difference,points,home_played,home_won,home_drawn,home_lost,home_goals_for,home_goals_against,home_goal_difference,home_points,away_played,away_won,away_drawn,away_lost,away_goals_for,away_goals_against,away_goal_difference,away_points,annotation_types,annotation_destinations,stadium_name,stadium_city
1994/95,1,23,Newcastle United,1,2,2,0,0,7,1,6,6,1,1,0,0,4,0,4,3,1,1,0,0,3,1,2,3,Q,EU_CL,St. James' Park,Newcastle
1994/95,1,21,Tottenham Hotspur,2,2,2,0,0,6,4,2,6,1,1,0,0,2,1,1,3,1,1,0,0,4,3,1,3,Q,EU_UC,White Hart Lane,London
1994/95,1,3,Blackburn Rovers,3,2,1,1,0,4,1,3,4,1,1,0,0,3,0,3,3,1,0,1,0,1,1,0,1,Q,EU_UC,Ewood Park,Blackburn
1994/95,1,12,Manchester United,4,2,1,1,0,3,1,2,4,1,1,0,0,2,0,2,3,1,0,1,0,1,1,0,1,Q,EU_UC,Old Trafford,Manchester
1994/95,1,15,Nottingham Forest,5,2,1,1,0,2,1,1,4,1,0,1,0,1,1,0,1,1,1,0,0,1,0,1,3,Q,EU_UC,City Ground,Nottingham
1994/95,1,9,Leeds United,6,2,1,1,0,1,0,1,4,1,1,0,0,1,0,1,3,1,0,1,0,0,0,0,1,,,Elland Road,Leeds
1994/95,1,10,Liverpool,7,1,1,0,0,6,1,5,3,0,0,0,0,0,0,0,0,1,1,0,0,6,1,5,3,,,Anfield,Liverpool
1994/95,1,1,Arsenal,8,2,1,0,1,3,1,2,3,1,1,0,0,3,0,3,3,1,0,0,1,0,1,-1,0,,,Highbury,London
1994/95,1,4,Chelsea,9,1,1,0,0,2,0,2,3,1,1,0,0,2,0,2,3,0,0,0,0,0,0,0,0,,,Stamford Bridge,London
1994/95,1,11,Manchester City,10,2,1,0,1,3,3,0,3,1,1,0,0,3,0,3,3,1,0,0,1,0,3,-3,0,,,Maine Road,Manchester
1994/95,1,17,Queens Park Rangers,11,2,1,0,1,3,4,-1,3,1,1,0,0,3,2,1,3,1,0,0,1,0,2,-2,0,,,Loftus Road,London
1994/95,1,2,Aston Villa,12,2,0,2,0,3,3,0,2,1,0,1,0,1,1,0,1,1,0,1,0,2,2,0,1,,,Villa Park,Birmingham
1994/95,1,20,Southampton,13,2,0,2,0,2,2,0,2,1,0,1,0,1,1,0,1,1,0,1,0,1,1,0,1,,,The Dell,Southampton
1994/95,1,22,Wimbledon,14,2,0,2,0,2,2,0,2,1,0,1,0,1,1,0,1,1,0,1,0,1,1,0,1,,,Selhurst Park,London
1994/95,1,7,Everton,15,2,0,1,1,3,4,-1,1,1,0,1,0,2,2,0,1,1,0,0,1,1,2,-1,0,Q,EU_CWC,Goodison Park,Liverpool
1994/95,1,8,Ipswich Town,16,2,0,1,1,1,2,-1,1,1,0,0,1,0,1,-1,0,1,0,1,0,1,1,0,1,,,Portman Road,Ipswich
1994/95,1,14,Norwich City,17,2,0,1,1,0,2,-2,1,1,0,1,0,0,0,0,1,1,0,0,1,0,2,-2,0,,,Carrow Road,Norwich
1994/95,1,25,West Ham United,18,2,0,1,1,0,3,-3,1,1,0,1,0,0,0,0,1,1,0,0,1,0,3,-3,0,,,Boleyn Ground,London
1994/95,1,5,Coventry City,19,2,0,1,1,1,5,-4,1,1,0,1,0,1,1,0,1,1,0,0,1,0,4,-4,0,R,EN_D1,Highfield Road,Coventry
1994/95,1,6,Crystal Palace,20,2,0,1,1,1,6,-5,1,1,0,0,1,1,6,-5,0,1,0,1,0,0,0,0,1,R,EN_D1,Selhurst Park,London
1994/95,1,19,Sheffield Wednesday,21,2,0,0,2,5,7,-2,0,1,0,0,1,3,4,-1,0,1,0,0,1,2,3,-1,0,R,EN_D1,Hillsborough,Sheffield
1994/95,1,26,Leicester City,22,2,0,0,2,1,6,-5,0,1,0,0,1,1,3,-2,0,1,0,0,1,0,3,-3,0,R,EN_D1,Filbert Street,Leicester
1994/95,2,23,Newcastle United,1,4,4,0,0,15,3,12,12,2,2,0,0,9,1,8,6,2,2,0,0,6,2,4,6,Q,EU_CL,St. James' Park,Newcastle
1994/95,2,12,Manchester United,2,4,3,1,0,7,1,6,10,2,2,0,0,5,0,5,6,2,1,1,0,2,1,1,4,Q,EU_UC,Old Trafford,Manchester
1994/95,2,15,Nottingham Forest,3,4,3,1,0,5,2,3,10,2,1,1,0,2,1,1,4,2,2,0,0,3,1,2,6,Q,EU_UC,City Ground,Nottingham
1994/95,2,10,Liverpool,4,3,3,0,0,11,1,10,9,1,1,0,0,3,0,3,3,2,2,0,0,8,1,7,6,Q,EU_UC,Anfield,Liverpool
1994/95,2,4,Chelsea,5,3,3,0,0,8,2,6,9,2,2,0,0,5,0,5,6,1,1,0,0,3,2,1,3,Q,EU_UC,Stamford Bridge,London
1994/95,2,21,Tottenham Hotspur,6,4,3,0,1,9,6,3,9,2,1,0,1,2,2,0,3,2,2,0,0,7,4,3,6,,,White Hart Lane,London
1994/95,2,3,Blackburn Rovers,7,4,2,2,0,8,1,7,8,2,2,0,0,7,0,7,6,2,0,2,0,1,1,0,2,,,Ewood Park,Blackburn
1994/95,2,9,Leeds United,8,4,2,1,1,5,4,1,7,2,1,0,1,3,3,0,3,2,1,1,0,2,1,1,4,,,Elland Road,Leeds
1994/95,2,11,Manchester City,9,4,2,0,2,7,6,1,6,2,2,0,0,7,0,7,6,2,0,0,2,0,6,-6,0,,,Maine Road,Manchester
1994/95,2,2,Aston Villa,10,4,1,3,0,5,4,1,6,2,0,2,0,2,2,0,2,2,1,1,0,3,2,1,4,,,Villa Park,Birmingham
1994/95,2,14,Norwich City,11,4,1,2,1,1,2,-1,5,2,1,1,0,1,0,1,4,2,0,1,1,0,2,-2,1,,,Carrow Road,Norwich
1994/95,2,19,Sheffield Wednesday,12,4,1,1,2,6,7,-1,4,2,0,1,1,3,4,-1,1,2,1,0,1,3,3,0,3,,,Hillsborough,Sheffield
1994/95,2,1,Arsenal,13,4,1,1,2,3,4,-1,4,2,1,1,0,3,0,3,4,2,0,0,2,0,4,-4,0,,,Highbury,London
1994/95,2,17,Queens Park Rangers,14,4,1,1,2,5,7,-2,4,2,1,0,1,4,4,0,3,2,0,1,1,1,3,-2,1,,,Loftus Road,London
1994/95,2,8,Ipswich Town,15,4,1,1,2,4,6,-2,4,2,0,0,2,1,4,-3,0,2,1,1,0,3,2,1,4,,,Portman Road,Ipswich
1994/95,2,22,Wimbledon,16,4,0,2,2,2,6,-4,2,2,0,1,1,1,2,-1,1,2,0,1,1,1,4,-3,1,,,Selhurst Park,London
1994/95,2,6,Crystal Palace,17,4,0,2,2,3,9,-6,2,2,0,0,2,2,8,-6,0,2,0,2,0,1,1,0,2,,,Selhurst Park,London
1994/95,2,20,Southampton,18,4,0,2,2,3,9,-6,2,2,0,1,1,1,3,-2,1,2,0,1,1,2,6,-4,1,,,The Dell,Southampton
1994/95,2,7,Everton,19,4,0,1,3,4,10,-6,1,2,0,1,1,3,4,-1,1,2,0,0,2,1,6,-5,0,"R,Q","EN_D1,EU_CWC",Goodison Park,Liverpool
1994/95,2,26,Leicester City,20,4,0,1,3,2,8,-6,1,2,0,1,1,2,4,-2,1,2,0,0,2,0,4,-4,0,R,EN_D1,Filbert Street,Leicester
1994/95,2,25,West Ham United,21,4,0,1,3,1,7,-6,1,2,0,1,1,1,3,-2,1,2,0,0,2,0,4,-4,0,R,EN_D1,Boleyn Ground,London
1994/95,2,5,Coventry City,22,4,0,1,3,1,10,-9,1,2,0,1,1,1,2,-1,1,2,0,0,2,0,8,-8,0,R,EN_D1,Highfield Road,Coventry
1994/95,3,23,Newcastle United,1,5,5,0,0,19,5,14,15,3,3,0,0,13,3,10,9,2,2,0,0,6,2,4,6,Q,EU_CL,St. James' Park,Newcastle
1994/95,3,15,Nottingham Forest,2,5,4,1,0,9,3,6,13,3,2,1,0,6,2,4,7,2,2,0,0,3,1,2,6,Q,EU_UC,City Ground,Nottingham
1994/95,3,3,Blackburn Rovers,3,5,3,2,0,11,1,10,11,3,3,0,0,10,0,10,9,2,0,2,0,1,1,0,2,Q,EU_UC,Ewood Park,Blackburn
1994/95,3,10,Liverpool,4,4,3,1,0,11,1,10,10,2,1,1,0,3,0,3,4,2,2,0,0,8,1,7,6,Q,EU_UC,Anfield,Liverpool
1994/95,3,12,Manchester United,5,5,3,1,1,8,3,5,10,2,2,0,0,5,0,5,6,3,1,1,1,3,3,0,4,Q,EU_UC,Old Trafford,Manchester
1994/95,3,9,Leeds United,6,5,3,1,1,7,5,2,10,3,2,0,1,5,4,1,6,2,1,1,0,2,1,1,4,,,Elland Road,Leeds
1994/95,3,4,Chelsea,7,4,3,0,1,10,6,4,9,2,2,0,0,5,0,5,6,2,1,0,1,5,6,-1,3,,,Stamford Bridge,London
1994/95,3,2,Aston Villa,8,5,2,3,0,7,4,3,9,3,1,2,0,4,2,2,5,2,1,1,0,3,2,1,4,,,Villa Park,Birmingham
1994/95,3,21,Tottenham Hotspur,9,5,3,0,2,10,8,2,9,3,1,0,2,3,4,-1,3,2,2,0,0,7,4,3,6,,,White Hart Lane,London
1994/95,3,11,Manchester City,10,5,2,1,2,8,7,1,7,3,2,1,0,8,1,7,7,2,0,0,2,0,6,-6,0,,,Maine Road,Manchester
1994/95,3,14,Norwich City,11,5,1,3,1,1,2,-1,6,3,1,2,0,1,0,1,5,2,0,1,1,0,2,-2,1,,,Carrow Road,Norwich
1994/95,3,1,Arsenal,12,5,1,2,2,3,4,-1,5,2,1,1,0,3,0,3,4,3,0,1,2,0,4,-4,1,,,Highbury,London
1994/95,3,17,Queens Park Rangers,13,5,1,2,2,7,9,-2,5,3,1,1,1,6,6,0,4,2,0,1,1,1,3,-2,1,,,Loftus Road,London
1994/95,3,22,Wimbledon,14,5,1,2,2,4,7,-3,5,3,1,1,1,3,3,0,4,2,0,1,1,1,4,-3,1,,,Selhurst Park,London
1994/95,3,20,Southampton,15,5,1,2,2,5,10,-5,5,2,0,1,1,1,3,-2,1,3,1,1,1,4,7,-3,4,,,The Dell,Southampton
1994/95,3,19,Sheffield Wednesday,16,5,1,1,3,7,11,-4,4,2,0,1,1,3,4,-1,1,3,1,0,2,4,7,-3,3,,,Hillsborough,Sheffield
1994/95,3,8,Ipswich Town,17,5,1,1,3,4,8,-4,4,2,0,0,2,1,4,-3,0,3,1,1,1,3,4,-1,4,,,Portman Road,Ipswich
1994/95,3,6,Crystal Palace,18,5,0,3,2,4,10,-6,3,2,0,0,2,2,8,-6,0,3,0,3,0,2,2,0,3,,,Selhurst Park,London
1994/95,3,25,West Ham United,19,5,0,2,3,1,7,-6,2,2,0,1,1,1,3,-2,1,3,0,1,2,0,4,-4,1,R,EN_D1,Boleyn Ground,London
1994/95,3,5,Coventry City,20,5,0,2,3,3,12,-9,2,2,0,1,1,1,2,-1,1,3,0,1,2,2,10,-8,1,R,EN_D1,Highfield Road,Coventry
1994/95,3,26,Leicester City,21,5,0,1,4,3,10,-7,1,2,0,1,1,2,4,-2,1,3,0,0,3,1,6,-5,0,R,EN_D1,Filbert Street,Leicester
1994/95,3,7,Everton,22,5,0,1,4,4,13,-9,1,2,0,1,1,3,4,-1,1,3,0,0,3,1,9,-8,0,"R,Q","EN_D1,EU_CWC",Goodison Park,Liverpool
1994/95,4,23,Newcastle United,1,6,6,0,0,22,7,15,18,3,3,0,0,13,3,10,9,3,3,0,0,9,4,5,9,Q,EU_CL,St. James' Park,Newcastle
1994/95,4,3,Blackburn Rovers,2,6,4,2,0,13,2,11,14,3,3,0,0,10,0,10,9,3,1,2,0,3,2,1,5,Q,EU_UC,Ewood Park,Blackburn
1994/95,4,15,Nottingham Forest,3,6,4,2,0,10,4,6,14,3,2,1,0,6,2,4,7,3,2,1,0,4,2,2,7,Q,EU_UC,City Ground,Nottingham
1994/95,4,12,Manchester United,4,6,4,1,1,10,3,7,13,3,3,0,0,7,0,7,9,3,1,1,1,3,3,0,4,Q,EU_UC,Old Trafford,Manchester
1994/95,4,10,Liverpool,5,5,3,1,1,11,3,8,10,2,1,1,0,3,0,3,4,3,2,0,1,8,3,5,6,Q,EU_UC,Anfield,Liverpool
1994/95,4,9,Leeds United,6,6,3,1,2,8,7,1,10,3,2,0,1,5,4,1,6,3,1,1,1,3,3,0,4,,,Elland Road,Leeds
1994/95,4,4,Chelsea,7,5,3,0,2,11,8,3,9,3,2,0,1,6,2,4,6,2,1,0,1,5,6,-1,3,,,Stamford Bridge,London
1994/95,4,2,Aston Villa,8,6,2,3,1,7,5,2,9,3,1,2,0,4,2,2,5,3,1,1,1,3,3,0,4,,,Villa Park,Birmingham
1994/95,4,21,Tottenham Hotspur,9,6,3,0,3,11,11,0,9,3,1,0,2,3,4,-1,3,3,2,0,1,8,7,1,6,,,White Hart Lane,London
1994/95,4,14,Norwich City,10,6,2,3,1,3,3,0,9,3,1,2,0,1,0,1,5,3,1,1,1,2,3,-1,4,,,Carrow Road,Norwich
1994/95,4,11,Manchester City,11,6,2,2,2,9,8,1,8,3,2,1,0,8,1,7,7,3,0,1,2,1,7,-6,1,,,Maine Road,Manchester
1994/95,4,17,Queens Park Rangers,12,6,1,3,2,9,11,-2,6,3,1,1,1,6,6,0,4,3,0,2,1,3,5,-2,2,,,Loftus Road,London
1994/95,4,22,Wimbledon,13,6,1,3,2,4,7,-3,6,3,1,1,1,3,3,0,4,3,0,2,1,1,4,-3,2,,,Selhurst Park,London
1994/95,4,20,Southampton,14,6,1,3,2,6,11,-5,6,3,0,2,1,2,4,-2,2,3,1,1,1,4,7,-3,4,,,The Dell,Southampton
1994/95,4,1,Arsenal,15,6,1,2,3,5,7,-2,5,3,1,1,1,5,3,2,4,3,0,1,2,0,4,-4,1,,,Highbury,London
1994/95,4,19,Sheffield Wednesday,16,6,1,2,3,8,12,-4,5,3,0,2,1,4,5,-1,2,3,1,0,2,4,7,-3,3,,,Hillsborough,Sheffield
1994/95,4,25,West Ham United,17,6,1,2,3,2,7,-5,5,3,1,1,1,2,3,-1,4,3,0,1,2,0,4,-4,1,,,Boleyn Ground,London
1994/95,4,5,Coventry City,18,6,1,2,3,5,13,-8,5,3,1,1,1,3,3,0,4,3,0,1,2,2,10,-8,1,,,Highfield Road,Coventry
1994/95,4,26,Leicester City,19,6,1,1,4,6,11,-5,4,3,1,1,1,5,5,0,4,3,0,0,3,1,6,-5,0,R,EN_D1,Filbert Street,Leicester
1994/95,4,8,Ipswich Town,20,6,1,1,4,5,10,-5,4,3,0,0,3,2,6,-4,0,3,1,1,1,3,4,-1,4,R,EN_D1,Portman Road,Ipswich
1994/95,4,6,Crystal Palace,21,6,0,4,2,4,10,-6,4,3,0,1,2,2,8,-6,1,3,0,3,0,2,2,0,3,R,EN_D1,Selhurst Park,London
1994/95,4,7,Everton,22,6,0,2,4,6,15,-9,2,3,0,2,1,5,6,-1,2,3,0,0,3,1,9,-8,0,"R,Q","EN_D1,EU_CWC",Goodison Park,Liverpool
1994/95,5,23,Newcastle United,1,7,6,1,0,23,8,15,19,4,3,1,0,14,4,10,10,3,3,0,0,9,4,5,9,Q,EU_CL,St. James' Park,Newcastle
1994/95,5,3,Blackburn Rovers,2,7,5,2,0,16,3,13,17,4,4,0,0,13,1,12,12,3,1,2,0,3,2,1,5,Q,EU_UC,Ewood Park,Blackburn
1994/95,5,15,Nottingham Forest,3,7,5,2,0,14,5,9,17,3,2,1,0,6,2,4,7,4,3,1,0,8,3,5,10,Q,EU_UC,City Ground,Nottingham
1994/95,5,12,Manchester United,4,7,4,1,2,12,6,6,13,3,3,0,0,7,0,7,9,4,1,1,2,5,6,-1,4,Q,EU_UC,Old Trafford,Manchester
1994/95,5,4,Chelsea,5,6,4,0,2,12,8,4,12,3,2,0,1,6,2,4,6,3,2,0,1,6,6,0,6,Q,EU_UC,Stamford Bridge,London
1994/95,5,10,Liverpool,6,6,3,2,1,12,4,8,11,2,1,1,0,3,0,3,4,4,2,1,1,9,4,5,7,,,Anfield,Liverpool
1994/95,5,11,Manchester City,7,7,3,2,2,11,8,3,11,4,3,1,0,10,1,9,10,3,0,1,2,1,7,-6,1,,,Maine Road,Manchester
1994/95,5,9,Leeds United,8,7,3,2,2,9,8,1,11,3,2,0,1,5,4,1,6,4,1,2,1,4,4,0,5,,,Elland Road,Leeds
1994/95,5,2,Aston Villa,9,7,2,3,2,8,8,0,9,3,1,2,0,4,2,2,5,4,1,1,2,4,6,-2,4,,,Villa Park,Birmingham
1994/95,5,22,Wimbledon,10,7,2,3,2,5,7,-2,9,3,1,1,1,3,3,0,4,4,1,2,1,2,4,-2,5,,,Selhurst Park,London
1994/95,5,14,Norwich City,11,7,2,3,2,3,5,-2,9,3,1,2,0,1,0,1,5,4,1,1,2,2,5,-3,4,,,Carrow Road,Norwich
1994/95,5,21,Tottenham Hotspur,12,7,3,0,4,12,15,-3,9,4,1,0,3,4,8,-4,3,3,2,0,1,8,7,1,6,,,White Hart Lane,London
1994/95,5,20,Southampton,13,7,2,3,2,9,12,-3,9,3,0,2,1,2,4,-2,2,4,2,1,1,7,8,-1,7,,,The Dell,Southampton
1994/95,5,1,Arsenal,14,7,2,2,3,7,7,0,8,3,1,1,1,5,3,2,4,4,1,1,2,2,4,-2,4,,,Highbury,London
1994/95,5,8,Ipswich Town,15,7,2,1,4,8,12,-4,7,4,1,0,3,5,8,-3,3,3,1,1,1,3,4,-1,4,,,Portman Road,Ipswich
1994/95,5,17,Queens Park Rangers,16,7,1,3,3,9,12,-3,6,4,1,1,2,6,7,-1,4,3,0,2,1,3,5,-2,2,,,Loftus Road,London
1994/95,5,19,Sheffield Wednesday,17,7,1,3,3,9,13,-4,6,4,0,3,1,5,6,-1,3,3,1,0,2,4,7,-3,3,,,Hillsborough,Sheffield
1994/95,5,26,Leicester City,18,7,1,2,4,7,12,-5,5,3,1,1,1,5,5,0,4,4,0,1,3,2,7,-5,1,,,Filbert Street,Leicester
1994/95,5,25,West Ham United,19,7,1,2,4,2,9,-7,5,4,1,1,2,2,5,-3,4,3,0,1,2,0,4,-4,1,R,EN_D1,Boleyn Ground,London
1994/95,5,5,Coventry City,20,7,1,2,4,6,16,-10,5,4,1,1,2,4,6,-2,4,3,0,1,2,2,10,-8,1,R,EN_D1,Highfield Road,Coventry
1994/95,5,6,Crystal Palace,21,7,0,4,3,4,11,-7,4,4,0,1,3,2,9,-7,1,3,0,3,0,2,2,0,3,R,EN_D1,Selhurst Park,London
1994/95,5,7,Everton,22,7,0,3,4,7,16,-9,3,4,0,3,1,6,7,-1,3,3,0,0,3,1,9,-8,0,"R,Q","EN_D1,EU_CWC",Goodison Park,Liverpool
1994/95,6,23,Newcastle United,1,8,7,1,0,25,8,17,22,4,3,1,0,14,4,10,10,4,4,0,0,11,4,7,12,Q,EU_CL,St. James' Park,Newcastle
1994/95,6,15,Nottingham Forest,2,8,6,2,0,17,7,10,20,4,3,1,0,9,4,5,10,4,3,1,0,8,3,5,10,Q,EU_UC,City Ground,Nottingham
1994/95,6,3,Blackburn Rovers,3,8,5,2,1,17,5,12,17,4,4,0,0,13,1,12,12,4,1,2,1,4,4,0,5,Q,EU_UC,Ewood Park,Blackburn
1994/95,6,12,Manchester United,4,8,5,1,2,14,6,8,16,4,4,0,0,9,0,9,12,4,1,1,2,5,6,-1,4,Q,EU_UC,Old Trafford,Manchester
1994/95,6,10,Liverpool,5,7,4,2,1,16,5,11,14,3,2,1,0,7,1,6,7,4,2,1,1,9,4,5,7,Q,EU_UC,Anfield,Liverpool
1994/95,6,9,Leeds United,6,8,4,2,2,11,8,3,14,4,3,0,1,7,4,3,9,4,1,2,1,4,4,0,5,,,Elland Road,Leeds
1994/95,6,4,Chelsea,7,7,4,0,3,13,10,3,12,4,2,0,2,7,4,3,6,3,2,0,1,6,6,0,6,,,Stamford Bridge,London
1994/95,6,20,Southampton,8,8,3,3,2,12,13,-1,12,4,1,2,1,5,5,0,5,4,2,1,1,7,8,-1,7,,,The Dell,Southampton
1994/95,6,14,Norwich City,9,8,3,3,2,5,6,-1,12,4,2,2,0,3,1,2,8,4,1,1,2,2,5,-3,4,,,Carrow Road,Norwich
1994/95,6,21,Tottenham Hotspur,10,8,4,0,4,14,16,-2,12,4,1,0,3,4,8,-4,3,4,3,0,1,10,8,2,9,,,White Hart Lane,London
1994/95,6,11,Manchester City,11,8,3,2,3,11,10,1,11,4,3,1,0,10,1,9,10,4,0,1,3,1,9,-8,1,,,Maine Road,Manchester
1994/95,6,2,Aston Villa,12,8,2,3,3,8,10,-2,9,4,1,2,1,4,4,0,5,4,1,1,2,4,6,-2,4,,,Villa Park,Birmingham
1994/95,6,22,Wimbledon,13,8,2,3,3,6,9,-3,9,4,1,1,2,4,5,-1,4,4,1,2,1,2,4,-2,5,,,Selhurst Park,London
1994/95,6,1,Arsenal,14,8,2,2,4,8,9,-1,8,4,1,1,2,6,5,1,4,4,1,1,2,2,4,-2,4,,,Highbury,London
1994/95,6,25,West Ham United,15,8,2,2,4,4,10,-6,8,4,1,1,2,2,5,-3,4,4,1,1,2,2,5,-3,4,,,Boleyn Ground,London
1994/95,6,8,Ipswich Town,16,8,2,1,5,9,15,-6,7,4,1,0,3,5,8,-3,3,4,1,1,2,4,7,-3,4,,,Portman Road,Ipswich
1994/95,6,6,Crystal Palace,17,8,1,4,3,6,12,-6,7,4,0,1,3,2,9,-7,1,4,1,3,0,4,3,1,6,,,Selhurst Park,London
1994/95,6,17,Queens Park Rangers,18,8,1,3,4,11,15,-4,6,4,1,1,2,6,7,-1,4,4,0,2,2,5,8,-3,2,,,Loftus Road,London
1994/95,6,26,Leicester City,19,8,1,3,4,9,14,-5,6,4,1,2,1,7,7,0,5,4,0,1,3,2,7,-5,1,R,EN_D1,Filbert Street,Leicester
1994/95,6,19,Sheffield Wednesday,20,8,1,3,4,10,17,-7,6,4,0,3,1,5,6,-1,3,4,1,0,3,5,11,-6,3,R,EN_D1,Hillsborough,Sheffield
1994/95,6,5,Coventry City,21,8,1,3,4,8,18,-10,6,4,1,1,2,4,6,-2,4,4,0,2,2,4,12,-8,2,R,EN_D1,Highfield Road,Coventry
1994/95,6,7,Everton,22,8,0,3,5,7,18,-11,3,4,0,3,1,6,7,-1,3,4,0,0,4,1,11,-10,0,"R,Q","EN_D1,EU_CWC",Goodison Park,Liverpool
1994/95,7,23,Newcastle United,1,9,7,2,0,26,9,17,23,5,3,2,0,15,5,10,11,4,4,0,0,11,4,7,12,Q,EU_CL,St. James' Park,Newcastle
1994/95,7,15,Nottingham Forest,2,9,6,3,0,20,10,10,21,4,3,1,0,9,4,5,10,5,3,2,0,11,6,5,11,Q,EU_UC,City Ground,Nottingham
1994/95,7,3,Blackburn Rovers,3,9,5,3,1,18,6,12,18,4,4,0,0,13,1,12,12,5,1,3,1,5,5,0,6,Q,EU_UC,Ewood Park,Blackburn
1994/95,7,10,Liverpool,4,8,5,2,1,19,7,12,17,4,3,1,0,10,3,7,10,4,2,1,1,9,4,5,7,Q,EU_UC,Anfield,Liverpool
1994/95,7,12,Manchester United,5,9,5,1,3,14,7,7,16,4,4,0,0,9,0,9,12,5,1,1,3,5,7,-2,4,Q,EU_UC,Old Trafford,Manchester
1994/95,7,4,Chelsea,6,8,5,0,3,17,10,7,15,5,3,0,2,11,4,7,9,3,2,0,1,6,6,0,6,,,Stamford Bridge,London
1994/95,7,20,Southampton,7,9,4,3,2,14,13,1,15,5,2,2,1,7,5,2,8,4,2,1,1,7,8,-1,7,,,The Dell,Southampton
1994/95,7,14,Norwich City,8,9,4,3,2,7,7,0,15,5,3,2,0,5,2,3,11,4,1,1,2,2,5,-3,4,,,Carrow Road,Norwich
1994/95,7,9,Leeds United,9,9,4,2,3,12,10,2,14,4,3,0,1,7,4,3,9,5,1,2,2,5,6,-1,5,,,Elland Road,Leeds
1994/95,7,21,Tottenham Hotspur,10,9,4,1,4,15,17,-2,13,5,1,1,3,5,9,-4,4,4,3,0,1,10,8,2,9,,,White Hart Lane,London
1994/95,7,11,Manchester City,11,9,3,3,3,14,13,1,12,5,3,2,0,13,4,9,11,4,0,1,3,1,9,-8,1,,,Maine Road,Manchester
1994/95,7,1,Arsenal,12,9,3,2,4,11,10,1,11,4,1,1,2,6,5,1,4,5,2,1,2,5,5,0,7,,,Highbury,London
1994/95,7,25,West Ham United,13,9,3,2,4,5,10,-5,11,5,2,1,2,3,5,-2,7,4,1,1,2,2,5,-3,4,,,Boleyn Ground,London
1994/95,7,2,Aston Villa,14,9,2,3,4,10,13,-3,9,4,1,2,1,4,4,0,5,5,1,1,3,6,9,-3,4,,,Villa Park,Birmingham
1994/95,7,22,Wimbledon,15,9,2,3,4,7,12,-5,9,5,1,1,3,5,8,-3,4,4,1,2,1,2,4,-2,5,,,Selhurst Park,London
1994/95,7,19,Sheffield Wednesday,16,9,2,3,4,11,17,-6,9,5,1,3,1,6,6,0,6,4,1,0,3,5,11,-6,3,,,Hillsborough,Sheffield
1994/95,7,5,Coventry City,17,9,2,3,4,10,18,-8,9,5,2,1,2,6,6,0,7,4,0,2,2,4,12,-8,2,,,Highfield Road,Coventry
1994/95,7,17,Queens Park Rangers,18,9,1,4,4,12,16,-4,7,4,1,1,2,6,7,-1,4,5,0,3,2,6,9,-3,3,,,Loftus Road,London
1994/95,7,6,Crystal Palace,19,9,1,4,4,6,13,-7,7,4,0,1,3,2,9,-7,1,5,1,3,1,4,4,0,6,R,EN_D1,Selhurst Park,London
1994/95,7,8,Ipswich Town,20,9,2,1,6,9,17,-8,7,4,1,0,3,5,8,-3,3,5,1,1,3,4,9,-5,4,R,EN_D1,Portman Road,Ipswich
1994/95,7,26,Leicester City,21,9,1,3,5,9,18,-9,6,4,1,2,1,7,7,0,5,5,0,1,4,2,11,-9,1,R,EN_D1,Filbert Street,Leicester
1994/95,7,7,Everton,22,9,0,3,6,7,20,-13,3,4,0,3,1,6,7,-1,3,5,0,0,5,1,13,-12,0,"R,Q","EN_D1,EU_CWC",Goodison Park,Liverpool
1994/95,8,23,Newcastle United,1,10,8,2,0,27,9,18,26,5,3,2,0,15,5,10,11,5,5,0,0,12,4,8,15,Q,EU_CL,St. James' Park,Newcastle
1994/95,8,15,Nottingham Forest,2,10,7,3,0,23,11,12,24,5,4,1,0,12,5,7,13,5,3,2,0,11,6,5,11,Q,EU_UC,City Ground,Nottingham
1994/95,8,3,Blackburn Rovers,3,10,6,3,1,21,8,13,21,5,5,0,0,16,3,13,15,5,1,3,1,5,5,0,6,Q,EU_UC,Ewood Park,Blackburn
1994/95,8,12,Manchester United,4,10,6,1,3,15,7,8,19,5,5,0,0,10,0,10,15,5,1,1,3,5,7,-2,4,Q,EU_UC,Old Trafford,Manchester
1994/95,8,10,Liverpool,5,9,5,2,2,21,10,11,17,4,3,1,0,10,3,7,10,5,2,1,2,11,7,4,7,Q,EU_UC,Anfield,Liverpool
1994/95,8,14,Norwich City,6,10,4,4,2,8,8,0,16,5,3,2,0,5,2,3,11,5,1,2,2,3,6,-3,5,,,Carrow Road,Norwich
1994/95,8,4,Chelsea,7,9,5,0,4,18,13,5,15,5,3,0,2,11,4,7,9,4,2,0,2,7,9,-2,6,,,Stamford Bridge,London
1994/95,8,11,Manchester City,8,10,4,3,3,16,14,2,15,5,3,2,0,13,4,9,11,5,1,1,3,3,10,-7,4,,,Maine Road,Manchester
1994/95,8,9,Leeds United,9,10,4,3,3,13,11,2,15,5,3,1,1,8,5,3,10,5,1,2,2,5,6,-1,5,,,Elland Road,Leeds
1994/95,8,20,Southampton,10,10,4,3,3,17,17,0,15,5,2,2,1,7,5,2,8,5,2,1,2,10,12,-2,7,,,The Dell,Southampton
1994/95,8,1,Arsenal,11,10,4,2,4,14,11,3,14,5,2,1,2,9,6,3,7,5,2,1,2,5,5,0,7,,,Highbury,London
1994/95,8,21,Tottenham Hotspur,12,10,4,2,4,16,18,-2,14,5,1,1,3,5,9,-4,4,5,3,1,1,11,9,2,10,,,White Hart Lane,London
1994/95,8,19,Sheffield Wednesday,13,10,3,3,4,13,18,-5,12,5,1,3,1,6,6,0,6,5,2,0,3,7,12,-5,6,,,Hillsborough,Sheffield
1994/95,8,5,Coventry City,14,10,3,3,4,12,18,-6,12,5,2,1,2,6,6,0,7,5,1,2,2,6,12,-6,5,,,Highfield Road,Coventry
1994/95,8,25,West Ham United,15,10,3,2,5,5,11,-6,11,5,2,1,2,3,5,-2,7,5,1,1,3,2,6,-4,4,,,Boleyn Ground,London
1994/95,8,2,Aston Villa,16,10,2,4,4,11,14,-3,10,5,1,3,1,5,5,0,6,5,1,1,3,6,9,-3,4,,,Villa Park,Birmingham
1994/95,8,22,Wimbledon,17,10,2,3,5,8,15,-7,9,5,1,1,3,5,8,-3,4,5,1,2,2,3,7,-4,5,,,Selhurst Park,London
1994/95,8,26,Leicester City,18,10,2,3,5,13,21,-8,9,5,2,2,1,11,10,1,8,5,0,1,4,2,11,-9,1,,,Filbert Street,Leicester
1994/95,8,17,Queens Park Rangers,19,10,1,4,5,13,18,-5,7,5,1,1,3,7,9,-2,4,5,0,3,2,6,9,-3,3,R,EN_D1,Loftus Road,London
1994/95,8,6,Crystal Palace,20,10,1,4,5,6,14,-8,7,5,0,1,4,2,10,-8,1,5,1,3,1,4,4,0,6,R,EN_D1,Selhurst Park,London
1994/95,8,8,Ipswich Town,21,10,2,1,7,10,19,-9,7,5,1,0,4,6,10,-4,3,5,1,1,3,4,9,-5,4,R,EN_D1,Portman Road,Ipswich
1994/95,8,7,Everton,22,10,0,3,7,7,22,-15,3,5,0,3,2,6,9,-3,3,5,0,0,5,1,13,-12,0,"R,Q","EN_D1,EU_CWC",Goodison Park,Liverpool
1994/95,9,23,Newcastle United,1,11,9,2,0,29,10,19,29,6,4,2,0,17,6,11,14,5,5,0,0,12,4,8,15,Q,EU_CL,St. James' Park,Newcastle
1994/95,9,15,Nottingham Forest,2,11,8,3,0,25,11,14,27,5,4,1,0,12,5,7,13,6,4,2,0,13,6,7,14,Q,EU_UC,City Ground,Nottingham
1994/95,9,12,Manchester United,3,11,7,1,3,19,9,10,22,5,5,0,0,10,0,10,15,6,2,1,3,9,9,0,7,Q,EU_UC,Old Trafford,Manchester
1994/95,9,3,Blackburn Rovers,4,11,6,3,2,23,12,11,21,6,5,0,1,18,7,11,15,5,1,3,1,5,5,0,6,Q,EU_UC,Ewood Park,Blackburn
1994/95,9,10,Liverpool,5,10,6,2,2,24,10,14,20,5,4,1,0,13,3,10,13,5,2,1,2,11,7,4,7,Q,EU_UC,Anfield,Liverpool
1994/95,9,14,Norwich City,6,11,5,4,2,12,10,2,19,6,4,2,0,9,4,5,14,5,1,2,2,3,6,-3,5,,,Carrow Road,Norwich
1994/95,9,4,Chelsea,7,10,6,0,4,20,13,7,18,6,4,0,2,13,4,9,12,4,2,0,2,7,9,-2,6,,,Stamford Bridge,London
1994/95,9,11,Manchester City,8,11,5,3,3,21,16,5,18,6,4,2,0,18,6,12,14,5,1,1,3,3,10,-7,4,,,Maine Road,Manchester
1994/95,9,9,Leeds United,9,11,5,3,3,15,12,3,18,6,4,1,1,10,6,4,13,5,1,2,2,5,6,-1,5,,,Elland Road,Leeds
1994/95,9,1,Arsenal,10,11,5,2,4,16,12,4,17,6,3,1,2,11,7,4,10,5,2,1,2,5,5,0,7,,,Highbury,London
1994/95,9,20,Southampton,11,11,4,3,4,17,19,-2,15,5,2,2,1,7,5,2,8,6,2,1,3,10,14,-4,7,,,The Dell,Southampton
1994/95,9,25,West Ham United,12,11,4,2,5,7,11,-4,14,6,3,1,2,5,5,0,10,5,1,1,3,2,6,-4,4,,,Boleyn Ground,London
1994/95,9,21,Tottenham Hotspur,13,11,4,2,5,18,23,-5,14,5,1,1,3,5,9,-4,4,6,3,1,2,13,14,-1,10,,,White Hart Lane,London
1994/95,9,19,Sheffield Wednesday,14,11,3,3,5,14,20,-6,12,5,1,3,1,6,6,0,6,6,2,0,4,8,14,-6,6,,,Hillsborough,Sheffield
1994/95,9,5,Coventry City,15,11,3,3,5,13,20,-7,12,5,2,1,2,6,6,0,7,6,1,2,3,7,14,-7,5,,,Highfield Road,Coventry
1994/95,9,2,Aston Villa,16,11,2,4,5,11,16,-5,10,6,1,3,2,5,7,-2,6,5,1,1,3,6,9,-3,4,,,Villa Park,Birmingham
1994/95,9,6,Crystal Palace,17,11,2,4,5,7,14,-7,10,6,1,1,4,3,10,-7,4,5,1,3,1,4,4,0,6,,,Selhurst Park,London
1994/95,9,26,Leicester City,18,11,2,3,6,14,23,-9,9,5,2,2,1,11,10,1,8,6,0,1,5,3,13,-10,1,,,Filbert Street,Leicester
1994/95,9,22,Wimbledon,19,11,2,3,6,8,18,-10,9,5,1,1,3,5,8,-3,4,6,1,2,3,3,10,-7,5,R,EN_D1,Selhurst Park,London
1994/95,9,17,Queens Park Rangers,20,11,1,4,6,15,22,-7,7,5,1,1,3,7,9,-2,4,6,0,3,3,8,13,-5,3,R,EN_D1,Loftus Road,London
1994/95,9,8,Ipswich Town,21,11,2,1,8,10,21,-11,7,5,1,0,4,6,10,-4,3,6,1,1,4,4,11,-7,4,R,EN_D1,Portman Road,Ipswich
1994/95,9,7,Everton,22,11,0,3,8,7,23,-16,3,5,0,3,2,6,9,-3,3,6,0,0,6,1,14,-13,0,"R,Q","EN_D1,EU_CWC",Goodison Park,Liverpool
1994/95,10,23,Newcastle United,1,12,9,2,1,29,12,17,29,6,4,2,0,17,6,11,14,6,5,0,1,12,6,6,15,Q,EU_CL,St. James' Park,Newcastle
1994/95,10,3,Blackburn Rovers,2,13,8,3,2,26,12,14,27,6,5,0,1,18,7,11,15,7,3,3,1,8,5,3,12,Q,EU_UC,Ewood Park,Blackburn
1994/95,10,15,Nottingham Forest,3,12,8,3,1,25,13,12,27,6,4,1,1,12,7,5,13,6,4,2,0,13,6,7,14,Q,EU_UC,City Ground,Nottingham
1994/95,10,12,Manchester United,4,12,8,1,3,21,9,12,25,6,6,0,0,12,0,12,18,6,2,1,3,9,9,0,7,Q,EU_UC,Old Trafford,Manchester
1994/95,10,10,Liverpool,5,12,7,2,3,28,13,15,23,5,4,1,0,13,3,10,13,7,3,1,3,15,10,5,10,Q,EU_UC,Anfield,Liverpool
1994/95,10,9,Leeds United,6,13,6,3,4,18,15,3,21,6,4,1,1,10,6,4,13,7,2,2,3,8,9,-1,8,,,Elland Road,Leeds
1994/95,10,14,Norwich City,7,13,5,5,3,13,12,1,20,6,4,2,0,9,4,5,14,7,1,3,3,4,8,-4,6,,,Carrow Road,Norwich
1994/95,10,4,Chelsea,8,11,6,1,4,21,14,7,19,6,4,0,2,13,4,9,12,5,2,1,2,8,10,-2,7,,,Stamford Bridge,London
1994/95,10,11,Manchester City,9,12,5,3,4,21,17,4,18,6,4,2,0,18,6,12,14,6,1,1,4,3,11,-8,4,,,Maine Road,Manchester
1994/95,10,1,Arsenal,10,12,5,3,4,17,13,4,18,6,3,1,2,11,7,4,10,6,2,2,2,6,6,0,8,,,Highbury,London
1994/95,10,21,Tottenham Hotspur,11,12,5,2,5,21,24,-3,17,6,2,1,3,8,10,-2,7,6,3,1,2,13,14,-1,10,,,White Hart Lane,London
1994/95,10,6,Crystal Palace,12,13,4,4,5,12,15,-3,16,6,1,1,4,3,10,-7,4,7,3,3,1,9,5,4,12,,,Selhurst Park,London
1994/95,10,20,Southampton,13,13,4,4,5,19,23,-4,16,7,2,3,2,9,9,0,9,6,2,1,3,10,14,-4,7,,,The Dell,Southampton
1994/95,10,5,Coventry City,14,13,4,3,6,15,24,-9,15,7,3,1,3,8,10,-2,10,6,1,2,3,7,14,-7,5,,,Highfield Road,Coventry
1994/95,10,25,West Ham United,15,13,4,2,7,8,15,-7,14,6,3,1,2,5,5,0,10,7,1,1,5,3,10,-7,4,,,Boleyn Ground,London
1994/95,10,17,Queens Park Rangers,16,13,3,4,6,19,23,-4,13,7,3,1,3,11,10,1,10,6,0,3,3,8,13,-5,3,,,Loftus Road,London
1994/95,10,19,Sheffield Wednesday,17,13,3,4,6,15,22,-7,13,7,1,4,2,7,8,-1,7,6,2,0,4,8,14,-6,6,,,Hillsborough,Sheffield
1994/95,10,22,Wimbledon,18,12,3,3,6,9,18,-9,12,6,2,1,3,6,8,-2,7,6,1,2,3,3,10,-7,5,,,Selhurst Park,London
1994/95,10,2,Aston Villa,19,12,2,4,6,11,18,-7,10,6,1,3,2,5,7,-2,6,6,1,1,4,6,11,-5,4,R,EN_D1,Villa Park,Birmingham
1994/95,10,8,Ipswich Town,20,13,3,1,9,13,24,-11,10,7,2,0,5,9,13,-4,6,6,1,1,4,4,11,-7,4,R,EN_D1,Portman Road,Ipswich
1994/95,10,26,Leicester City,21,12,2,3,7,14,24,-10,9,6,2,2,2,11,11,0,8,6,0,1,5,3,13,-10,1,R,EN_D1,Filbert Street,Leicester
1994/95,10,7,Everton,22,13,1,4,8,9,24,-15,7,7,1,4,2,8,10,-2,7,6,0,0,6,1,14,-13,0,"R,Q","EN_D1,EU_CWC",Goodison Park,Liverpool
1994/95,11,23,Newcastle United,1,14,10,3,1,31,13,18,33,7,5,2,0,19,7,12,17,7,5,1,1,12,6,6,16,Q,EU_CL,St. James' Park,Newcastle
1994/95,11,3,Blackburn Rovers,2,14,9,3,2,28,12,16,30,7,6,0,1,20,7,13,18,7,3,3,1,8,5,3,12,Q,EU_UC,Ewood Park,Blackburn
1994/95,11,12,Manchester United,3,13,9,1,3,23,10,13,28,6,6,0,0,12,0,12,18,7,3,1,3,11,10,1,10,Q,EU_UC,Old Trafford,Manchester
1994/95,11,15,Nottingham Forest,4,14,8,4,2,25,14,11,28,7,4,2,1,12,7,5,14,7,4,2,1,13,7,6,14,Q,EU_UC,City Ground,Nottingham
1994/95,11,10,Liverpool,5,13,8,2,3,29,13,16,26,6,5,1,0,14,3,11,16,7,3,1,3,15,10,5,10,Q,EU_UC,Anfield,Liverpool
1994/95,11,9,Leeds United,6,14,7,3,4,21,16,5,24,7,5,1,1,13,7,6,16,7,2,2,3,8,9,-1,8,,,Elland Road,Leeds
1994/95,11,14,Norwich City,7,14,5,6,3,13,12,1,21,7,4,3,0,9,4,5,15,7,1,3,3,4,8,-4,6,,,Carrow Road,Norwich
1994/95,11,4,Chelsea,8,12,6,2,4,23,16,7,20,7,4,1,2,15,6,9,13,5,2,1,2,8,10,-2,7,,,Stamford Bridge,London
1994/95,11,11,Manchester City,9,13,5,4,4,24,20,4,19,7,4,3,0,21,9,12,15,6,1,1,4,3,11,-8,4,,,Maine Road,Manchester
1994/95,11,1,Arsenal,10,13,5,4,4,17,13,4,19,7,3,2,2,11,7,4,11,6,2,2,2,6,6,0,8,,,Highbury,London
1994/95,11,6,Crystal Palace,11,14,5,4,5,15,15,0,19,7,2,1,4,6,10,-4,7,7,3,3,1,9,5,4,12,,,Selhurst Park,London
1994/95,11,20,Southampton,12,14,4,5,5,22,26,-4,17,7,2,3,2,9,9,0,9,7,2,2,3,13,17,-4,8,,,The Dell,Southampton
1994/95,11,21,Tottenham Hotspur,13,13,5,2,6,21,26,-5,17,6,2,1,3,8,10,-2,7,7,3,1,3,13,16,-3,10,,,White Hart Lane,London
1994/95,11,25,West Ham United,14,14,5,2,7,9,15,-6,17,7,4,1,2,6,5,1,13,7,1,1,5,3,10,-7,4,,,Boleyn Ground,London
1994/95,11,5,Coventry City,15,14,4,4,6,17,26,-9,16,7,3,1,3,8,10,-2,10,7,1,3,3,9,16,-7,6,,,Highfield Road,Coventry
1994/95,11,19,Sheffield Wednesday,16,14,3,5,6,15,22,-7,14,7,1,4,2,7,8,-1,7,7,2,1,4,8,14,-6,7,,,Hillsborough,Sheffield
1994/95,11,17,Queens Park Rangers,17,14,3,4,7,20,25,-5,13,7,3,1,3,11,10,1,10,7,0,3,4,9,15,-6,3,,,Loftus Road,London
1994/95,11,22,Wimbledon,18,13,3,3,7,10,21,-11,12,6,2,1,3,6,8,-2,7,7,1,2,4,4,13,-9,5,,,Selhurst Park,London
1994/95,11,2,Aston Villa,19,13,2,4,7,12,20,-8,10,7,1,3,3,6,9,-3,6,6,1,1,4,6,11,-5,4,R,EN_D1,Villa Park,Birmingham
1994/95,11,8,Ipswich Town,20,14,3,1,10,13,27,-14,10,7,2,0,5,9,13,-4,6,7,1,1,5,4,14,-10,4,R,EN_D1,Portman Road,Ipswich
1994/95,11,26,Leicester City,21,13,2,3,8,14,25,-11,9,6,2,2,2,11,11,0,8,7,0,1,6,3,14,-11,1,R,EN_D1,Filbert Street,Leicester
1994/95,11,7,Everton,22,14,1,5,8,9,24,-15,8,7,1,4,2,8,10,-2,7,7,0,1,6,1,14,-13,1,"R,Q","EN_D1,EU_CWC",Goodison Park,Liverpool
1994/95,12,23,Newcastle United,1,14,10,3,1,31,13,18,33,7,5,2,0,19,7,12,17,7,5,1,1,12,6,6,16,Q,EU_CL,St. James' Park,Newcastle
1994/95,12,12,Manchester United,2,14,10,1,3,28,10,18,31,7,7,0,0,17,0,17,21,7,3,1,3,11,10,1,10,Q,EU_UC,Old Trafford,Manchester
1994/95,12,3,Blackburn Rovers,3,14,9,3,2,28,12,16,30,7,6,0,1,20,7,13,18,7,3,3,1,8,5,3,12,Q,EU_UC,Ewood Park,Blackburn
1994/95,12,10,Liverpool,4,14,9,2,3,32,14,18,29,7,6,1,0,17,4,13,19,7,3,1,3,15,10,5,10,Q,EU_UC,Anfield,Liverpool
1994/95,12,15,Nottingham Forest,5,14,8,4,2,25,14,11,28,7,4,2,1,12,7,5,14,7,4,2,1,13,7,6,14,Q,EU_UC,City Ground,Nottingham
1994/95,12,9,Leeds United,6,14,7,3,4,21,16,5,24,7,5,1,1,13,7,6,16,7,2,2,3,8,9,-1,8,,,Elland Road,Leeds
1994/95,12,14,Norwich City,7,14,5,6,3,13,12,1,21,7,4,3,0,9,4,5,15,7,1,3,3,4,8,-4,6,,,Carrow Road,Norwich
1994/95,12,4,Chelsea,8,13,6,2,5,24,19,5,20,7,4,1,2,15,6,9,13,6,2,1,3,9,13,-4,7,,,Stamford Bridge,London
1994/95,12,1,Arsenal,9,13,5,4,4,17,13,4,19,7,3,2,2,11,7,4,11,6,2,2,2,6,6,0,8,,,Highbury,London
1994/95,12,6,Crystal Palace,10,14,5,4,5,15,15,0,19,7,2,1,4,6,10,-4,7,7,3,3,1,9,5,4,12,,,Selhurst Park,London
1994/95,12,11,Manchester City,11,14,5,4,5,24,25,-1,19,7,4,3,0,21,9,12,15,7,1,1,5,3,16,-13,4,,,Maine Road,Manchester
1994/95,12,20,Southampton,12,14,4,5,5,22,26,-4,17,7,2,3,2,9,9,0,9,7,2,2,3,13,17,-4,8,,,The Dell,Southampton
1994/95,12,21,Tottenham Hotspur,13,13,5,2,6,21,26,-5,17,6,2,1,3,8,10,-2,7,7,3,1,3,13,16,-3,10,,,White Hart Lane,London
1994/95,12,25,West Ham United,14,14,5,2,7,9,15,-6,17,7,4,1,2,6,5,1,13,7,1,1,5,3,10,-7,4,,,Boleyn Ground,London
1994/95,12,5,Coventry City,15,14,4,4,6,17,26,-9,16,7,3,1,3,8,10,-2,10,7,1,3,3,9,16,-7,6,,,Highfield Road,Coventry
1994/95,12,22,Wimbledon,16,14,4,3,7,14,24,-10,15,7,3,1,3,10,11,-1,10,7,1,2,4,4,13,-9,5,,,Selhurst Park,London
1994/95,12,19,Sheffield Wednesday,17,14,3,5,6,15,22,-7,14,7,1,4,2,7,8,-1,7,7,2,1,4,8,14,-6,7,,,Hillsborough,Sheffield
1994/95,12,17,Queens Park Rangers,18,14,3,4,7,20,25,-5,13,7,3,1,3,11,10,1,10,7,0,3,4,9,15,-6,3,,,Loftus Road,London
1994/95,12,2,Aston Villa,19,14,2,4,8,15,24,-9,10,7,1,3,3,6,9,-3,6,7,1,1,5,9,15,-6,4,R,EN_D1,Villa Park,Birmingham
1994/95,12,8,Ipswich Town,20,14,3,1,10,13,27,-14,10,7,2,0,5,9,13,-4,6,7,1,1,5,4,14,-10,4,R,EN_D1,Portman Road,Ipswich
1994/95,12,26,Leicester City,21,13,2,3,8,14,25,-11,9,6,2,2,2,11,11,0,8,7,0,1,6,3,14,-11,1,R,EN_D1,Filbert Street,Leicester
1994/95,12,7,Everton,22,14,1,5,8,9,24,-15,8,7,1,4,2,8,10,-2,7,7,0,1,6,1,14,-13,1,"R,Q","EN_D1,EU_CWC",Goodison Park,Liverpool
1994/95,13,12,Manchester United,1,15,11,1,3,31,10,21,34,8,8,0,0,20,0,20,24,7,3,1,3,11,10,1,10,Q,EU_CL,Old Trafford,Manchester
1994/95,13,3,Blackburn Rovers,2,15,10,3,2,31,13,18,33,7,6,0,1,20,7,13,18,8,4,3,1,11,6,5,15,Q,EU_UC,Ewood Park,Blackburn
1994/95,13,23,Newcastle United,3,15,10,3,2,33,16,17,33,7,5,2,0,19,7,12,17,8,5,1,2,14,9,5,16,Q,EU_UC,St. James' Park,Newcastle
1994/95,13,10,Liverpool,4,15,9,2,4,32,16,16,29,7,6,1,0,17,4,13,19,8,3,1,4,15,12,3,10,Q,EU_UC,Anfield,Liverpool
1994/95,13,15,Nottingham Forest,5,15,8,4,3,25,15,10,28,8,4,2,2,12,8,4,14,7,4,2,1,13,7,6,14,Q,EU_UC,City Ground,Nottingham
1994/95,13,4,Chelsea,6,15,7,3,5,25,19,6,24,7,4,1,2,15,6,9,13,8,3,2,3,10,13,-3,11,,,Stamford Bridge,London
1994/95,13,9,Leeds United,7,15,7,3,5,23,19,4,24,7,5,1,1,13,7,6,16,8,2,2,4,10,12,-2,8,,,Elland Road,Leeds
1994/95,13,11,Manchester City,8,15,6,4,5,25,25,0,22,7,4,3,0,21,9,12,15,8,2,1,5,4,16,-12,7,,,Maine Road,Manchester
1994/95,13,14,Norwich City,9,15,5,6,4,13,13,0,21,7,4,3,0,9,4,5,15,8,1,3,4,4,9,-5,6,,,Carrow Road,Norwich
1994/95,13,20,Southampton,10,15,5,5,5,23,26,-3,20,8,3,3,2,10,9,1,12,7,2,2,3,13,17,-4,8,,,The Dell,Southampton
1994/95,13,1,Arsenal,11,15,5,4,6,18,16,2,19,7,3,2,2,11,7,4,11,8,2,2,4,7,9,-2,8,,,Highbury,London
1994/95,13,6,Crystal Palace,12,15,5,4,6,15,18,-3,19,7,2,1,4,6,10,-4,7,8,3,3,2,9,8,1,12,,,Selhurst Park,London
1994/95,13,5,Coventry City,13,15,5,4,6,18,26,-8,19,8,4,1,3,9,10,-1,13,7,1,3,3,9,16,-7,6,,,Highfield Road,Coventry
1994/95,13,21,Tottenham Hotspur,14,15,5,3,7,24,30,-6,18,8,2,2,4,11,14,-3,8,7,3,1,3,13,16,-3,10,,,White Hart Lane,London
1994/95,13,22,Wimbledon,15,15,5,3,7,17,26,-9,18,8,4,1,3,13,13,0,13,7,1,2,4,4,13,-9,5,,,Selhurst Park,London
1994/95,13,19,Sheffield Wednesday,16,15,4,5,6,16,22,-6,17,8,2,4,2,8,8,0,10,7,2,1,4,8,14,-6,7,,,Hillsborough,Sheffield
1994/95,13,25,West Ham United,17,15,5,2,8,9,16,-7,17,7,4,1,2,6,5,1,13,8,1,1,6,3,11,-8,4,,,Boleyn Ground,London
1994/95,13,17,Queens Park Rangers,18,15,4,4,7,23,27,-4,16,8,4,1,3,14,12,2,13,7,0,3,4,9,15,-6,3,,,Loftus Road,London
1994/95,13,2,Aston Villa,19,15,3,4,8,19,27,-8,13,7,1,3,3,6,9,-3,6,8,2,1,5,13,18,-5,7,R,EN_D1,Villa Park,Birmingham
1994/95,13,26,Leicester City,20,15,3,3,9,16,27,-11,12,8,3,2,3,13,13,0,11,7,0,1,6,3,14,-11,1,R,EN_D1,Filbert Street,Leicester
1994/95,13,7,Everton,21,15,2,5,8,11,24,-13,11,8,2,4,2,10,10,0,10,7,0,1,6,1,14,-13,1,"R,Q","EN_D1,EU_CWC",Goodison Park,Liverpool
1994/95,13,8,Ipswich Town,22,15,3,1,11,14,30,-16,10,8,2,0,6,10,16,-6,6,7,1,1,5,4,14,-10,4,R,EN_D1,Portman Road,Ipswich
1994/95,14,3,Blackburn Rovers,1,16,11,3,2,35,13,22,36,8,7,0,1,24,7,17,21,8,4,3,1,11,6,5,15,Q,EU_CL,Ewood Park,Blackburn
1994/95,14,12,Manchester United,2,16,11,2,3,31,10,21,35,8,8,0,0,20,0,20,24,8,3,2,3,11,10,1,11,Q,EU_UC,Old Trafford,Manchester
1994/95,14,23,Newcastle United,3,16,10,4,2,34,17,17,34,8,5,3,0,20,8,12,18,8,5,1,2,14,9,5,16,Q,EU_UC,St. James' Park,Newcastle
1994/95,14,10,Liverpool,4,16,9,3,4,33,17,16,30,8,6,2,0,18,5,13,20,8,3,1,4,15,12,3,10,Q,EU_UC,Anfield,Liverpool
1994/95,14,15,Nottingham Forest,5,16,8,4,4,25,16,9,28,8,4,2,2,12,8,4,14,8,4,2,2,13,8,5,14,Q,EU_UC,City Ground,Nottingham
1994/95,14,9,Leeds United,6,16,8,3,5,24,19,5,27,8,6,1,1,14,7,7,19,8,2,2,4,10,12,-2,8,,,Elland Road,Leeds
1994/95,14,11,Manchester City,7,16,7,4,5,27,25,2,25,8,5,3,0,23,9,14,18,8,2,1,5,4,16,-12,7,,,Maine Road,Manchester
1994/95,14,4,Chelsea,8,16,7,3,6,25,20,5,24,8,4,1,3,15,7,8,13,8,3,2,3,10,13,-3,11,,,Stamford Bridge,London
1994/95,14,14,Norwich City,9,16,6,6,4,15,14,1,24,8,5,3,0,11,5,6,18,8,1,3,4,4,9,-5,6,,,Carrow Road,Norwich
1994/95,14,5,Coventry City,10,16,6,4,6,19,26,-7,22,8,4,1,3,9,10,-1,13,8,2,3,3,10,16,-6,9,,,Highfield Road,Coventry
1994/95,14,20,Southampton,11,16,5,6,5,23,26,-3,21,8,3,3,2,10,9,1,12,8,2,3,3,13,17,-4,9,,,The Dell,Southampton
1994/95,14,1,Arsenal,12,16,5,5,6,18,16,2,20,8,3,3,2,11,7,4,12,8,2,2,4,7,9,-2,8,,,Highbury,London
1994/95,14,6,Crystal Palace,13,16,5,5,6,15,18,-3,20,8,2,2,4,6,10,-4,8,8,3,3,2,9,8,1,12,,,Selhurst Park,London
1994/95,14,21,Tottenham Hotspur,14,16,5,4,7,25,31,-6,19,8,2,2,4,11,14,-3,8,8,3,2,3,14,17,-3,11,,,White Hart Lane,London
1994/95,14,19,Sheffield Wednesday,15,16,4,6,6,17,23,-6,18,8,2,4,2,8,8,0,10,8,2,2,4,9,15,-6,8,,,Hillsborough,Sheffield
1994/95,14,22,Wimbledon,16,16,5,3,8,17,28,-11,18,8,4,1,3,13,13,0,13,8,1,2,5,4,15,-11,5,,,Selhurst Park,London
1994/95,14,25,West Ham United,17,16,5,2,9,9,17,-8,17,8,4,1,3,6,6,0,13,8,1,1,6,3,11,-8,4,,,Boleyn Ground,London
1994/95,14,17,Queens Park Rangers,18,16,4,4,8,23,31,-8,16,8,4,1,3,14,12,2,13,8,0,3,5,9,19,-10,3,,,Loftus Road,London
1994/95,14,2,Aston Villa,19,16,3,5,8,20,28,-8,14,8,1,4,3,7,10,-3,7,8,2,1,5,13,18,-5,7,R,EN_D1,Villa Park,Birmingham
1994/95,14,7,Everton,20,16,3,5,8,12,24,-12,14,8,2,4,2,10,10,0,10,8,1,1,6,2,14,-12,4,"R,Q","EN_D1,EU_CWC",Goodison Park,Liverpool
1994/95,14,26,Leicester City,21,16,3,3,10,17,29,-12,12,8,3,2,3,13,13,0,11,8,0,1,7,4,16,-12,1,R,EN_D1,Filbert Street,Leicester
1994/95,14,8,Ipswich Town,22,16,3,2,11,15,31,-16,11,8,2,0,6,10,16,-6,6,8,1,2,5,5,15,-10,5,R,EN_D1,Portman Road,Ipswich
1994/95,15,3,Blackburn Rovers,1,17,12,3,2,38,13,25,39,8,7,0,1,24,7,17,21,9,5,3,1,14,6,8,18,Q,EU_CL,Ewood Park,Blackburn
1994/95,15,12,Manchester United,2,17,12,2,3,32,10,22,38,9,9,0,0,21,0,21,27,8,3,2,3,11,10,1,11,Q,EU_UC,Old Trafford,Manchester
1994/95,15,23,Newcastle United,3,17,10,4,3,36,21,15,34,8,5,3,0,20,8,12,18,9,5,1,3,16,13,3,16,Q,EU_UC,St. James' Park,Newcastle
1994/95,15,10,Liverpool,4,17,9,4,4,34,18,16,31,8,6,2,0,18,5,13,20,9,3,2,4,16,13,3,11,Q,EU_UC,Anfield,Liverpool
1994/95,15,15,Nottingham Forest,5,17,8,5,4,27,18,9,29,9,4,3,2,14,10,4,15,8,4,2,2,13,8,5,14,Q,EU_UC,City Ground,Nottingham
1994/95,15,11,Manchester City,6,17,8,4,5,29,26,3,28,8,5,3,0,23,9,14,18,9,3,1,5,6,17,-11,10,,,Maine Road,Manchester
1994/95,15,4,Chelsea,7,17,8,3,6,26,20,6,27,8,4,1,3,15,7,8,13,9,4,2,3,11,13,-2,14,,,Stamford Bridge,London
1994/95,15,9,Leeds United,8,17,8,3,6,24,22,2,27,8,6,1,1,14,7,7,19,9,2,2,5,10,15,-5,8,,,Elland Road,Leeds
1994/95,15,14,Norwich City,9,17,6,6,5,15,15,0,24,8,5,3,0,11,5,6,18,9,1,3,5,4,10,-6,6,,,Carrow Road,Norwich
1994/95,15,5,Coventry City,10,17,6,5,6,20,27,-7,23,9,4,2,3,10,11,-1,14,8,2,3,3,10,16,-6,9,,,Highfield Road,Coventry
1994/95,15,21,Tottenham Hotspur,11,17,6,4,7,29,33,-4,22,9,3,2,4,15,16,-1,11,8,3,2,3,14,17,-3,11,,,White Hart Lane,London
1994/95,15,1,Arsenal,12,17,5,6,6,20,18,2,21,8,3,3,2,11,7,4,12,9,2,3,4,9,11,-2,9,,,Highbury,London
1994/95,15,20,Southampton,13,17,5,6,6,23,27,-4,21,9,3,3,3,10,10,0,12,8,2,3,3,13,17,-4,9,,,The Dell,Southampton
1994/95,15,19,Sheffield Wednesday,14,17,5,6,6,18,23,-5,21,9,3,4,2,9,8,1,13,8,2,2,4,9,15,-6,8,,,Hillsborough,Sheffield
1994/95,15,6,Crystal Palace,15,17,5,5,7,15,19,-4,20,8,2,2,4,6,10,-4,8,9,3,3,3,9,9,0,12,,,Selhurst Park,London
1994/95,15,17,Queens Park Rangers,16,17,5,4,8,25,32,-7,19,9,5,1,3,16,13,3,16,8,0,3,5,9,19,-10,3,,,Loftus Road,London
1994/95,15,22,Wimbledon,17,17,5,3,9,17,31,-14,18,9,4,1,4,13,16,-3,13,8,1,2,5,4,15,-11,5,,,Selhurst Park,London
1994/95,15,7,Everton,18,17,4,5,8,15,24,-9,17,9,3,4,2,13,10,3,13,8,1,1,6,2,14,-12,4,Q,EU_CWC,Goodison Park,Liverpool
1994/95,15,25,West Ham United,19,17,5,2,10,10,19,-9,17,8,4,1,3,6,6,0,13,9,1,1,7,4,13,-9,4,R,EN_D1,Boleyn Ground,London
1994/95,15,2,Aston Villa,20,17,3,6,8,21,29,-8,15,8,1,4,3,7,10,-3,7,9,2,2,5,14,19,-5,8,R,EN_D1,Villa Park,Birmingham
1994/95,15,26,Leicester City,21,17,3,4,10,18,30,-12,13,9,3,3,3,14,14,0,12,8,0,1,7,4,16,-12,1,R,EN_D1,Filbert Street,Leicester
1994/95,15,8,Ipswich Town,22,17,3,2,12,16,33,-17,11,9,2,0,7,11,18,-7,6,8,1,2,5,5,15,-10,5,R,EN_D1,Portman Road,Ipswich
1994/95,16,3,Blackburn Rovers,1,18,13,3,2,41,15,26,42,9,8,0,1,27,9,18,24,9,5,3,1,14,6,8,18,Q,EU_CL,Ewood Park,Blackburn
1994/95,16,12,Manchester United,2,18,13,2,3,35,12,23,41,9,9,0,0,21,0,21,27,9,4,2,3,14,12,2,14,Q,EU_UC,Old Trafford,Manchester
1994/95,16,23,Newcastle United,3,18,11,4,3,39,22,17,37,9,6,3,0,23,9,14,21,9,5,1,3,16,13,3,16,Q,EU_UC,St. James' Park,Newcastle
1994/95,16,10,Liverpool,4,18,9,5,4,34,18,16,32,9,6,3,0,18,5,13,21,9,3,2,4,16,13,3,11,Q,EU_UC,Anfield,Liverpool
1994/95,16,15,Nottingham Forest,5,18,9,5,4,31,19,12,32,10,5,3,2,18,11,7,18,8,4,2,2,13,8,5,14,Q,EU_UC,City Ground,Nottingham
1994/95,16,11,Manchester City,6,18,8,4,6,30,28,2,28,9,5,3,1,24,11,13,18,9,3,1,5,6,17,-11,10,,,Maine Road,Manchester
1994/95,16,9,Leeds United,7,18,8,4,6,26,24,2,28,9,6,2,1,16,9,7,20,9,2,2,5,10,15,-5,8,,,Elland Road,Leeds
1994/95,16,4,Chelsea,8,18,8,3,7,26,23,3,27,8,4,1,3,15,7,8,13,10,4,2,4,11,16,-5,14,,,Stamford Bridge,London
1994/95,16,14,Norwich City,9,18,7,6,5,18,15,3,27,9,6,3,0,14,5,9,21,9,1,3,5,4,10,-6,6,,,Carrow Road,Norwich
1994/95,16,21,Tottenham Hotspur,10,18,7,4,7,32,34,-2,25,10,4,2,4,18,17,1,14,8,3,2,3,14,17,-3,11,,,White Hart Lane,London
1994/95,16,1,Arsenal,11,18,6,6,6,22,19,3,24,8,3,3,2,11,7,4,12,10,3,3,4,11,12,-1,12,,,Highbury,London
1994/95,16,5,Coventry City,12,18,6,5,7,20,29,-9,23,9,4,2,3,10,11,-1,14,9,2,3,4,10,18,-8,9,,,Highfield Road,Coventry
1994/95,16,6,Crystal Palace,13,18,5,6,7,15,19,-4,21,8,2,2,4,6,10,-4,8,10,3,4,3,9,9,0,13,,,Selhurst Park,London
1994/95,16,20,Southampton,14,18,5,6,7,25,30,-5,21,9,3,3,3,10,10,0,12,9,2,3,4,15,20,-5,9,,,The Dell,Southampton
1994/95,16,19,Sheffield Wednesday,15,18,5,6,7,19,26,-7,21,9,3,4,2,9,8,1,13,9,2,2,5,10,18,-8,8,,,Hillsborough,Sheffield
1994/95,16,22,Wimbledon,16,18,6,3,9,19,31,-12,21,10,5,1,4,15,16,-1,16,8,1,2,5,4,15,-11,5,,,Selhurst Park,London
1994/95,16,17,Queens Park Rangers,17,18,5,4,9,27,35,-8,19,10,5,1,4,18,16,2,16,8,0,3,5,9,19,-10,3,,,Loftus Road,London
1994/95,16,7,Everton,18,18,4,6,8,15,24,-9,18,9,3,4,2,13,10,3,13,9,1,2,6,2,14,-12,5,Q,EU_CWC,Goodison Park,Liverpool
1994/95,16,25,West Ham United,19,18,5,3,10,12,21,-9,18,8,4,1,3,6,6,0,13,10,1,2,7,6,15,-9,5,R,EN_D1,Boleyn Ground,London
1994/95,16,2,Aston Villa,20,18,3,7,8,21,29,-8,16,9,1,5,3,7,10,-3,8,9,2,2,5,14,19,-5,8,R,EN_D1,Villa Park,Birmingham
1994/95,16,26,Leicester City,21,18,3,4,11,19,33,-14,13,9,3,3,3,14,14,0,12,9,0,1,8,5,19,-14,1,R,EN_D1,Filbert Street,Leicester
1994/95,16,8,Ipswich Town,22,18,3,2,13,17,37,-20,11,9,2,0,7,11,18,-7,6,9,1,2,6,6,19,-13,5,R,EN_D1,Portman Road,Ipswich
1994/95,17,3,Blackburn Rovers,1,19,13,4,2,41,15,26,43,9,8,0,1,27,9,18,24,10,5,4,1,14,6,8,19,Q,EU_CL,Ewood Park,Blackburn
1994/95,17,12,Manchester United,2,19,13,2,4,36,14,22,41,10,9,0,1,22,2,20,27,9,4,2,3,14,12,2,14,Q,EU_UC,Old Trafford,Manchester
1994/95,17,23,Newcastle United,3,19,11,5,3,39,22,17,38,9,6,3,0,23,9,14,21,10,5,2,3,16,13,3,17,Q,EU_UC,St. James' Park,Newcastle
1994/95,17,15,Nottingham Forest,4,19,10,5,4,33,20,13,35,10,5,3,2,18,11,7,18,9,5,2,2,15,9,6,17,Q,EU_UC,City Ground,Nottingham
1994/95,17,10,Liverpool,5,19,9,6,4,34,18,16,33,9,6,3,0,18,5,13,21,10,3,3,4,16,13,3,12,Q,EU_UC,Anfield,Liverpool
1994/95,17,9,Leeds United,6,19,9,4,6,29,25,4,31,9,6,2,1,16,9,7,20,10,3,2,5,13,16,-3,11,,,Elland Road,Leeds
1994/95,17,14,Norwich City,7,19,8,6,5,19,15,4,30,9,6,3,0,14,5,9,21,10,2,3,5,5,10,-5,9,,,Carrow Road,Norwich
1994/95,17,4,Chelsea,8,19,8,4,7,26,23,3,28,9,4,2,3,15,7,8,14,10,4,2,4,11,16,-5,14,,,Stamford Bridge,London
1994/95,17,11,Manchester City,9,19,8,4,7,30,31,-1,28,9,5,3,1,24,11,13,18,10,3,1,6,6,20,-14,10,,,Maine Road,Manchester
1994/95,17,21,Tottenham Hotspur,10,19,7,5,7,32,34,-2,26,10,4,2,4,18,17,1,14,9,3,3,3,14,17,-3,12,,,White Hart Lane,London
1994/95,17,1,Arsenal,11,19,6,6,7,23,22,1,24,9,3,3,3,12,10,2,12,10,3,3,4,11,12,-1,12,,,Highbury,London
1994/95,17,20,Southampton,12,19,6,6,7,27,31,-4,24,10,4,3,3,12,11,1,15,9,2,3,4,15,20,-5,9,,,The Dell,Southampton
1994/95,17,5,Coventry City,13,19,6,6,7,20,29,-9,24,10,4,3,3,10,11,-1,15,9,2,3,4,10,18,-8,9,,,Highfield Road,Coventry
1994/95,17,17,Queens Park Rangers,14,19,6,4,9,29,35,-6,22,10,5,1,4,18,16,2,16,9,1,3,5,11,19,-8,6,,,Loftus Road,London
1994/95,17,22,Wimbledon,15,19,6,4,9,21,33,-12,22,10,5,1,4,15,16,-1,16,9,1,3,5,6,17,-11,6,,,Selhurst Park,London
1994/95,17,6,Crystal Palace,16,19,5,6,8,15,20,-5,21,9,2,2,5,6,11,-5,8,10,3,4,3,9,9,0,13,,,Selhurst Park,London
1994/95,17,25,West Ham United,17,19,6,3,10,15,21,-6,21,9,5,1,3,9,6,3,16,10,1,2,7,6,15,-9,5,,,Boleyn Ground,London
1994/95,17,19,Sheffield Wednesday,18,19,5,6,8,19,28,-9,21,10,3,4,3,9,10,-1,13,9,2,2,5,10,18,-8,8,,,Hillsborough,Sheffield
1994/95,17,7,Everton,19,19,4,7,8,15,24,-9,19,10,3,5,2,13,10,3,14,9,1,2,6,2,14,-12,5,"R,Q","EN_D1,EU_CWC",Goodison Park,Liverpool
1994/95,17,2,Aston Villa,20,19,3,7,9,22,31,-9,16,9,1,5,3,7,10,-3,8,10,2,2,6,15,21,-6,8,R,EN_D1,Villa Park,Birmingham
1994/95,17,26,Leicester City,21,19,3,5,11,19,33,-14,14,10,3,4,3,14,14,0,13,9,0,1,8,5,19,-14,1,R,EN_D1,Filbert Street,Leicester
1994/95,17,8,Ipswich Town,22,19,3,3,13,19,39,-20,12,10,2,1,7,13,20,-7,7,9,1,2,6,6,19,-13,5,R,EN_D1,Portman Road,Ipswich
1994/95,18,3,Blackburn Rovers,1,20,14,4,2,44,16,28,46,9,8,0,1,27,9,18,24,11,6,4,1,17,7,10,22,Q,EU_CL,Ewood Park,Blackburn
1994/95,18,12,Manchester United,2,21,14,3,4,40,17,23,45,11,9,1,1,23,3,20,28,10,5,2,3,17,14,3,17,Q,EU_UC,Old Trafford,Manchester
1994/95,18,10,Liverpool,3,21,11,6,4,38,19,19,39,10,7,3,0,20,5,15,24,11,4,3,4,18,14,4,15,Q,EU_UC,Anfield,Liverpool
1994/95,18,23,Newcastle United,4,20,11,6,3,39,22,17,39,9,6,3,0,23,9,14,21,11,5,3,3,16,13,3,18,Q,EU_UC,St. James' Park,Newcastle
1994/95,18,15,Nottingham Forest,5,21,11,6,4,34,20,14,39,11,6,3,2,19,11,8,21,10,5,3,2,15,9,6,18,Q,EU_UC,City Ground,Nottingham
1994/95,18,9,Leeds United,6,20,9,5,6,29,25,4,32,10,6,3,1,16,9,7,21,10,3,2,5,13,16,-3,11,,,Elland Road,Leeds
1994/95,18,14,Norwich City,7,21,8,6,7,19,18,1,30,10,6,3,1,14,7,7,21,11,2,3,6,5,11,-6,9,,,Carrow Road,Norwich
1994/95,18,21,Tottenham Hotspur,8,21,8,6,7,34,34,0,30,11,4,3,4,18,17,1,15,10,4,3,3,16,17,-1,15,,,White Hart Lane,London
1994/95,18,1,Arsenal,9,21,7,7,7,25,22,3,28,10,3,4,3,12,10,2,13,11,4,3,4,13,12,1,15,,,Highbury,London
1994/95,18,4,Chelsea,10,21,8,4,9,28,29,-1,28,10,4,2,4,17,10,7,14,11,4,2,5,11,19,-8,14,,,Stamford Bridge,London
1994/95,18,11,Manchester City,11,21,8,4,9,31,36,-5,28,10,5,3,2,25,14,11,18,11,3,1,7,6,22,-16,10,,,Maine Road,Manchester
1994/95,18,22,Wimbledon,12,21,8,4,9,25,35,-10,28,11,6,1,4,16,16,0,19,10,2,3,5,9,19,-10,9,,,Selhurst Park,London
1994/95,18,19,Sheffield Wednesday,13,21,7,6,8,28,30,-2,27,11,4,4,3,14,11,3,16,10,3,2,5,14,19,-5,11,,,Hillsborough,Sheffield
1994/95,18,20,Southampton,14,21,6,7,8,31,36,-5,25,11,4,3,4,14,14,0,15,10,2,4,4,17,22,-5,10,,,The Dell,Southampton
1994/95,18,5,Coventry City,15,21,6,7,8,21,34,-13,25,11,4,4,3,10,11,-1,16,10,2,3,5,11,23,-12,9,,,Highfield Road,Coventry
1994/95,18,17,Queens Park Rangers,16,21,6,6,9,31,37,-6,24,11,5,2,4,20,18,2,17,10,1,4,5,11,19,-8,7,,,Loftus Road,London
1994/95,18,6,Crystal Palace,17,21,5,8,8,15,20,-5,23,10,2,3,5,6,11,-5,9,11,3,5,3,9,9,0,14,,,Selhurst Park,London
1994/95,18,25,West Ham United,18,21,6,4,11,16,23,-7,22,10,5,2,3,10,7,3,17,11,1,2,8,6,16,-10,5,,,Boleyn Ground,London
1994/95,18,2,Aston Villa,19,21,4,8,9,25,31,-6,20,10,2,5,3,10,10,0,11,11,2,3,6,15,21,-6,9,R,EN_D1,Villa Park,Birmingham
1994/95,18,7,Everton,20,20,4,7,9,16,28,-12,19,11,3,5,3,14,14,0,14,9,1,2,6,2,14,-12,5,"R,Q","EN_D1,EU_CWC",Goodison Park,Liverpool
1994/95,18,26,Leicester City,21,21,3,6,12,21,36,-15,15,11,3,4,4,15,16,-1,13,10,0,2,8,6,20,-14,2,R,EN_D1,Filbert Street,Leicester
1994/95,18,8,Ipswich Town,22,21,3,4,14,20,42,-22,13,11,2,1,8,13,22,-9,7,10,1,3,6,7,20,-13,6,R,EN_D1,Portman Road,Ipswich
1994/95,19,3,Blackburn Rovers,1,21,15,4,2,45,16,29,49,9,8,0,1,27,9,18,24,12,7,4,1,18,7,11,25,Q,EU_CL,Ewood Park,Blackburn
1994/95,19,12,Manchester United,2,22,14,4,4,42,19,23,46,11,9,1,1,23,3,20,28,11,5,3,3,19,16,3,18,Q,EU_UC,Old Trafford,Manchester
1994/95,19,10,Liverpool,3,22,12,6,4,40,19,21,42,10,7,3,0,20,5,15,24,12,5,3,4,20,14,6,18,Q,EU_UC,Anfield,Liverpool
1994/95,19,23,Newcastle United,4,21,11,6,4,40,24,16,39,9,6,3,0,23,9,14,21,12,5,3,4,17,15,2,18,Q,EU_UC,St. James' Park,Newcastle
1994/95,19,15,Nottingham Forest,5,22,11,6,5,35,23,12,39,11,6,3,2,19,11,8,21,11,5,3,3,16,12,4,18,Q,EU_UC,City Ground,Nottingham
1994/95,19,21,Tottenham Hotspur,6,22,9,6,7,38,34,4,33,11,4,3,4,18,17,1,15,11,5,3,3,20,17,3,18,,,White Hart Lane,London
1994/95,19,14,Norwich City,7,22,9,6,7,21,19,2,33,11,7,3,1,16,8,8,24,11,2,3,6,5,11,-6,9,,,Carrow Road,Norwich
1994/95,19,9,Leeds United,8,21,9,5,7,29,27,2,32,11,6,3,2,16,11,5,21,10,3,2,5,13,16,-3,11,,,Elland Road,Leeds
1994/95,19,19,Sheffield Wednesday,9,22,8,6,8,29,30,-1,30,11,4,4,3,14,11,3,16,11,4,2,5,15,19,-4,14,,,Hillsborough,Sheffield
1994/95,19,4,Chelsea,10,22,8,5,9,29,30,-1,29,11,4,3,4,18,11,7,15,11,4,2,5,11,19,-8,14,,,Stamford Bridge,London
1994/95,19,11,Manchester City,11,22,8,5,9,33,38,-5,29,11,5,4,2,27,16,11,19,11,3,1,7,6,22,-16,10,,,Maine Road,Manchester
1994/95,19,22,Wimbledon,12,22,8,5,9,26,36,-10,29,11,6,1,4,16,16,0,19,11,2,4,5,10,20,-10,10,,,Selhurst Park,London
1994/95,19,1,Arsenal,13,22,7,7,8,26,25,1,28,11,3,4,4,13,13,0,13,11,4,3,4,13,12,1,15,,,Highbury,London
1994/95,19,17,Queens Park Rangers,14,22,7,6,9,34,38,-4,27,11,5,2,4,20,18,2,17,11,2,4,5,14,20,-6,10,,,Loftus Road,London
1994/95,19,20,Southampton,15,22,6,8,8,33,38,-5,26,12,4,4,4,16,16,0,16,10,2,4,4,17,22,-5,10,,,The Dell,Southampton
1994/95,19,25,West Ham United,16,22,7,4,11,19,24,-5,25,11,6,2,3,13,8,5,20,11,1,2,8,6,16,-10,5,,,Boleyn Ground,London
1994/95,19,5,Coventry City,17,22,6,7,9,21,38,-17,25,12,4,4,4,10,15,-5,16,10,2,3,5,11,23,-12,9,,,Highfield Road,Coventry
1994/95,19,6,Crystal Palace,18,22,5,8,9,15,21,-6,23,11,2,3,6,6,12,-6,9,11,3,5,3,9,9,0,14,,,Selhurst Park,London
1994/95,19,7,Everton,19,21,5,7,9,20,29,-9,22,12,4,5,3,18,15,3,17,9,1,2,6,2,14,-12,5,"R,Q","EN_D1,EU_CWC",Goodison Park,Liverpool
1994/95,19,2,Aston Villa,20,22,4,9,9,27,33,-6,21,10,2,5,3,10,10,0,11,12,2,4,6,17,23,-6,10,R,EN_D1,Villa Park,Birmingham
1994/95,19,26,Leicester City,21,22,3,6,13,21,37,-16,15,12,3,4,5,15,17,-2,13,10,0,2,8,6,20,-14,2,R,EN_D1,Filbert Street,Leicester
1994/95,19,8,Ipswich Town,22,22,3,4,15,21,46,-25,13,11,2,1,8,13,22,-9,7,11,1,3,7,8,24,-16,6,R,EN_D1,Portman Road,Ipswich
1994/95,20,3,Blackburn Rovers,1,22,16,4,2,49,18,31,52,10,9,0,1,31,11,20,27,12,7,4,1,18,7,11,25,Q,EU_CL,Ewood Park,Blackburn
1994/95,20,12,Manchester United,2,23,15,4,4,44,19,25,49,12,10,1,1,25,3,22,31,11,5,3,3,19,16,3,18,Q,EU_UC,Old Trafford,Manchester
1994/95,20,10,Liverpool,3,23,13,6,4,44,19,25,45,11,8,3,0,24,5,19,27,12,5,3,4,20,14,6,18,Q,EU_UC,Anfield,Liverpool
1994/95,20,15,Nottingham Forest,4,23,12,6,5,36,23,13,42,12,7,3,2,20,11,9,24,11,5,3,3,16,12,4,18,Q,EU_UC,City Ground,Nottingham
1994/95,20,23,Newcastle United,5,22,11,7,4,40,24,16,40,10,6,4,0,23,9,14,22,12,5,3,4,17,15,2,18,Q,EU_UC,St. James' Park,Newcastle
1994/95,20,21,Tottenham Hotspur,6,23,10,6,7,39,34,5,36,12,5,3,4,19,17,2,18,11,5,3,3,20,17,3,18,,,White Hart Lane,London
1994/95,20,9,Leeds United,7,22,9,6,7,29,27,2,33,11,6,3,2,16,11,5,21,11,3,3,5,13,16,-3,12,,,Elland Road,Leeds
1994/95,20,14,Norwich City,8,23,9,6,8,21,23,-2,33,11,7,3,1,16,8,8,24,12,2,3,7,5,15,-10,9,,,Carrow Road,Norwich
1994/95,20,22,Wimbledon,9,23,9,5,9,28,37,-9,32,12,7,1,4,18,17,1,22,11,2,4,5,10,20,-10,10,,,Selhurst Park,London
1994/95,20,19,Sheffield Wednesday,10,23,8,7,8,30,31,-1,31,12,4,5,3,15,12,3,17,11,4,2,5,15,19,-4,14,,,Hillsborough,Sheffield
1994/95,20,11,Manchester City,11,23,8,6,9,33,38,-5,30,11,5,4,2,27,16,11,19,12,3,2,7,6,22,-16,11,,,Maine Road,Manchester
1994/95,20,4,Chelsea,12,22,8,5,9,29,30,-1,29,11,4,3,4,18,11,7,15,11,4,2,5,11,19,-8,14,,,Stamford Bridge,London
1994/95,20,1,Arsenal,13,23,7,7,9,26,26,0,28,11,3,4,4,13,13,0,13,12,4,3,5,13,13,0,15,,,Highbury,London
1994/95,20,17,Queens Park Rangers,14,22,7,6,9,34,38,-4,27,11,5,2,4,20,18,2,17,11,2,4,5,14,20,-6,10,,,Loftus Road,London
1994/95,20,20,Southampton,15,23,6,9,8,34,39,-5,27,12,4,4,4,16,16,0,16,11,2,5,4,18,23,-5,11,,,The Dell,Southampton
1994/95,20,25,West Ham United,16,23,7,4,12,21,28,-7,25,11,6,2,3,13,8,5,20,12,1,2,9,8,20,-12,5,,,Boleyn Ground,London
1994/95,20,5,Coventry City,17,23,6,7,10,21,40,-19,25,12,4,4,4,10,15,-5,16,11,2,3,6,11,25,-14,9,,,Highfield Road,Coventry
1994/95,20,6,Crystal Palace,18,23,5,8,10,15,22,-7,23,11,2,3,6,6,12,-6,9,12,3,5,4,9,10,-1,14,,,Selhurst Park,London
1994/95,20,2,Aston Villa,19,23,4,10,9,27,33,-6,22,11,2,6,3,10,10,0,12,12,2,4,6,17,23,-6,10,R,EN_D1,Villa Park,Birmingham
1994/95,20,7,Everton,20,22,5,7,10,21,31,-10,22,12,4,5,3,18,15,3,17,10,1,2,7,3,16,-13,5,"R,Q","EN_D1,EU_CWC",Goodison Park,Liverpool
1994/95,20,8,Ipswich Town,21,23,4,4,15,25,47,-22,16,12,3,1,8,17,23,-6,10,11,1,3,7,8,24,-16,6,R,EN_D1,Portman Road,Ipswich
1994/95,20,26,Leicester City,22,23,3,6,14,22,41,-19,15,12,3,4,5,15,17,-2,13,11,0,2,9,7,24,-17,2,R,EN_D1,Filbert Street,Leicester
1994/95,21,3,Blackburn Rovers,1,23,17,4,2,52,18,34,55,11,10,0,1,34,11,23,30,12,7,4,1,18,7,11,25,Q,EU_CL,Ewood Park,Blackburn
1994/95,21,12,Manchester United,2,24,15,5,4,45,20,25,50,12,10,1,1,25,3,22,31,12,5,4,3,20,17,3,19,Q,EU_UC,Old Trafford,Manchester
1994/95,21,10,Liverpool,3,24,13,6,5,44,20,24,45,12,8,3,1,24,6,18,27,12,5,3,4,20,14,6,18,Q,EU_UC,Anfield,Liverpool
1994/95,21,15,Nottingham Forest,4,24,12,6,6,36,26,10,42,12,7,3,2,20,11,9,24,12,5,3,4,16,15,1,18,Q,EU_UC,City Ground,Nottingham
1994/95,21,23,Newcastle United,5,23,11,8,4,41,25,16,41,11,6,5,0,24,10,14,23,12,5,3,4,17,15,2,18,Q,EU_UC,St. James' Park,Newcastle
1994/95,21,21,Tottenham Hotspur,6,24,11,6,7,41,35,6,39,12,5,3,4,19,17,2,18,12,6,3,3,22,18,4,21,,,White Hart Lane,London
1994/95,21,22,Wimbledon,7,24,10,5,9,30,38,-8,35,12,7,1,4,18,17,1,22,12,3,4,5,12,21,-9,13,,,Selhurst Park,London
1994/95,21,9,Leeds United,8,23,9,7,7,29,27,2,34,12,6,4,2,16,11,5,22,11,3,3,5,13,16,-3,12,,,Elland Road,Leeds
1994/95,21,14,Norwich City,9,24,9,6,9,22,25,-3,33,12,7,3,2,17,10,7,24,12,2,3,7,5,15,-10,9,,,Carrow Road,Norwich
1994/95,21,19,Sheffield Wednesday,10,24,8,8,8,31,32,-1,32,12,4,5,3,15,12,3,17,12,4,3,5,16,20,-4,15,,,Hillsborough,Sheffield
1994/95,21,11,Manchester City,11,24,8,7,9,33,38,-5,31,12,5,5,2,27,16,11,20,12,3,2,7,6,22,-16,11,,,Maine Road,Manchester
1994/95,21,4,Chelsea,12,23,8,6,9,30,31,-1,30,12,4,4,4,19,12,7,16,11,4,2,5,11,19,-8,14,,,Stamford Bridge,London
1994/95,21,1,Arsenal,13,24,7,8,9,27,27,0,29,12,3,5,4,14,14,0,14,12,4,3,5,13,13,0,15,,,Highbury,London
1994/95,21,20,Southampton,14,24,6,10,8,34,39,-5,28,12,4,4,4,16,16,0,16,12,2,6,4,18,23,-5,12,,,The Dell,Southampton
1994/95,21,17,Queens Park Rangers,15,23,7,6,10,35,40,-5,27,11,5,2,4,20,18,2,17,12,2,4,6,15,22,-7,10,,,Loftus Road,London
1994/95,21,6,Crystal Palace,16,24,6,8,10,17,22,-5,26,12,3,3,6,8,12,-4,12,12,3,5,4,9,10,-1,14,,,Selhurst Park,London
1994/95,21,5,Coventry City,17,24,6,8,10,21,40,-19,26,12,4,4,4,10,15,-5,16,12,2,4,6,11,25,-14,10,,,Highfield Road,Coventry
1994/95,21,2,Aston Villa,18,24,5,10,9,29,34,-5,25,12,3,6,3,12,11,1,15,12,2,4,6,17,23,-6,10,,,Villa Park,Birmingham
1994/95,21,25,West Ham United,19,24,7,4,13,22,30,-8,25,12,6,2,4,14,10,4,20,12,1,2,9,8,20,-12,5,R,EN_D1,Boleyn Ground,London
1994/95,21,7,Everton,20,23,5,8,10,22,32,-10,23,12,4,5,3,18,15,3,17,11,1,3,7,4,17,-13,6,"R,Q","EN_D1,EU_CWC",Goodison Park,Liverpool
1994/95,21,8,Ipswich Town,21,24,5,4,15,26,47,-21,19,12,3,1,8,17,23,-6,10,12,2,3,7,9,24,-15,9,R,EN_D1,Portman Road,Ipswich
1994/95,21,26,Leicester City,22,24,3,6,15,22,43,-21,15,12,3,4,5,15,17,-2,13,12,0,2,10,7,26,-19,2,R,EN_D1,Filbert Street,Leicester
1994/95,22,3,Blackburn Rovers,1,26,18,5,3,57,21,36,59,13,11,1,1,39,13,26,34,13,7,4,2,18,8,10,25,Q,EU_CL,Ewood Park,Blackburn
1994/95,22,12,Manchester United,2,26,16,6,4,47,21,26,54,13,11,1,1,26,3,23,34,13,5,5,3,21,18,3,20,Q,EU_UC,Old Trafford,Manchester
1994/95,22,23,Newcastle United,3,26,13,9,4,45,26,19,48,13,8,5,0,28,11,17,29,13,5,4,4,17,15,2,19,Q,EU_UC,St. James' Park,Newcastle
1994/95,22,10,Liverpool,4,25,13,7,5,44,20,24,46,13,8,4,1,24,6,18,28,12,5,3,4,20,14,6,18,Q,EU_UC,Anfield,Liverpool
1994/95,22,15,Nottingham Forest,5,26,13,6,7,39,28,11,45,13,7,3,3,21,13,8,24,13,6,3,4,18,15,3,21,Q,EU_UC,City Ground,Nottingham
1994/95,22,21,Tottenham Hotspur,6,25,11,6,8,41,36,5,39,12,5,3,4,19,17,2,18,13,6,3,4,22,19,3,21,,,White Hart Lane,London
1994/95,22,9,Leeds United,7,25,10,8,7,34,28,6,38,13,7,4,2,20,11,9,25,12,3,4,5,14,17,-3,13,,,Elland Road,Leeds
1994/95,22,19,Sheffield Wednesday,8,26,9,9,8,33,32,1,36,13,4,6,3,15,12,3,18,13,5,3,5,18,20,-2,18,,,Hillsborough,Sheffield
1994/95,22,22,Wimbledon,9,25,10,5,10,31,40,-9,35,12,7,1,4,18,17,1,22,13,3,4,6,13,23,-10,13,,,Selhurst Park,London
1994/95,22,14,Norwich City,10,25,9,7,9,24,27,-3,34,13,7,4,2,19,12,7,25,12,2,3,7,5,15,-10,9,,,Carrow Road,Norwich
1994/95,22,1,Arsenal,11,26,8,9,9,29,28,1,33,13,3,6,4,15,15,0,15,13,5,3,5,14,13,1,18,,,Highbury,London
1994/95,22,2,Aston Villa,12,26,7,10,9,32,35,-3,31,13,4,6,3,13,11,2,18,13,3,4,6,19,24,-5,13,,,Villa Park,Birmingham
1994/95,22,4,Chelsea,13,25,8,7,10,32,35,-3,31,13,4,4,5,19,14,5,16,12,4,3,5,13,21,-8,15,,,Stamford Bridge,London
1994/95,22,11,Manchester City,14,25,8,7,10,33,39,-6,31,13,5,5,3,27,17,10,20,12,3,2,7,6,22,-16,11,,,Maine Road,Manchester
1994/95,22,20,Southampton,15,25,6,11,8,35,40,-5,29,12,4,4,4,16,16,0,16,13,2,7,4,19,24,-5,13,,,The Dell,Southampton
1994/95,22,6,Crystal Palace,16,26,6,9,11,19,26,-7,27,13,3,4,6,9,13,-4,13,13,3,5,5,10,13,-3,14,,,Selhurst Park,London
1994/95,22,17,Queens Park Rangers,17,24,7,6,11,35,44,-9,27,11,5,2,4,20,18,2,17,13,2,4,7,15,26,-11,10,,,Loftus Road,London
1994/95,22,7,Everton,18,26,6,9,11,25,35,-10,27,13,5,5,3,21,16,5,20,13,1,4,8,4,19,-15,7,Q,EU_CWC,Goodison Park,Liverpool
1994/95,22,5,Coventry City,19,26,6,9,11,23,43,-20,27,13,4,4,5,10,16,-6,16,13,2,5,6,13,27,-14,11,R,EN_D1,Highfield Road,Coventry
1994/95,22,25,West Ham United,20,25,7,4,14,22,32,-10,25,13,6,2,5,14,12,2,20,12,1,2,9,8,20,-12,5,R,EN_D1,Boleyn Ground,London
1994/95,22,8,Ipswich Town,21,26,5,5,16,29,53,-24,20,13,3,2,8,19,25,-6,11,13,2,3,8,10,28,-18,9,R,EN_D1,Portman Road,Ipswich
1994/95,22,26,Leicester City,22,25,4,6,15,23,43,-20,18,12,3,4,5,15,17,-2,13,13,1,2,10,8,26,-18,5,R,EN_D1,Filbert Street,Leicester
1994/95,23,3,Blackburn Rovers,1,27,18,5,4,58,24,34,59,13,11,1,1,39,13,26,34,14,7,4,3,19,11,8,25,Q,EU_CL,Ewood Park,Blackburn
1994/95,23,12,Manchester United,2,27,17,6,4,48,21,27,57,14,12,1,1,27,3,24,37,13,5,5,3,21,18,3,20,Q,EU_UC,Old Trafford,Manchester
1994/95,23,23,Newcastle United,3,27,13,9,5,45,29,16,48,13,8,5,0,28,11,17,29,14,5,4,5,17,18,-1,19,Q,EU_UC,St. James' Park,Newcastle
1994/95,23,10,Liverpool,4,26,13,8,5,45,21,24,47,13,8,4,1,24,6,18,28,13,5,4,4,21,15,6,19,Q,EU_UC,Anfield,Liverpool
1994/95,23,15,Nottingham Forest,5,27,13,7,7,40,29,11,46,14,7,4,3,22,14,8,25,13,6,3,4,18,15,3,21,Q,EU_UC,City Ground,Nottingham
1994/95,23,21,Tottenham Hotspur,6,26,12,6,8,44,37,7,42,13,6,3,4,22,18,4,21,13,6,3,4,22,19,3,21,,,White Hart Lane,London
1994/95,23,9,Leeds United,7,26,10,9,7,34,28,6,39,13,7,4,2,20,11,9,25,13,3,5,5,14,17,-3,14,,,Elland Road,Leeds
1994/95,23,19,Sheffield Wednesday,8,27,10,9,8,36,33,3,39,14,5,6,3,18,13,5,21,13,5,3,5,18,20,-2,18,,,Hillsborough,Sheffield
1994/95,23,22,Wimbledon,9,26,10,6,10,31,40,-9,36,13,7,2,4,18,17,1,23,13,3,4,6,13,23,-10,13,,,Selhurst Park,London
1994/95,23,14,Norwich City,10,26,9,7,10,25,29,-4,34,13,7,4,2,19,12,7,25,13,2,3,8,6,17,-11,9,,,Carrow Road,Norwich
1994/95,23,1,Arsenal,11,27,8,9,10,30,31,-1,33,13,3,6,4,15,15,0,15,14,5,3,6,15,16,-1,18,,,Highbury,London
1994/95,23,4,Chelsea,12,26,8,8,10,34,37,-3,32,13,4,4,5,19,14,5,16,13,4,4,5,15,23,-8,16,,,Stamford Bridge,London
1994/95,23,11,Manchester City,13,26,8,8,10,35,41,-6,32,13,5,5,3,27,17,10,20,13,3,3,7,8,24,-16,12,,,Maine Road,Manchester
1994/95,23,2,Aston Villa,14,27,7,10,10,32,36,-4,31,13,4,6,3,13,11,2,18,14,3,4,7,19,25,-6,13,,,Villa Park,Birmingham
1994/95,23,20,Southampton,15,26,6,12,8,37,42,-5,30,13,4,5,4,18,18,0,17,13,2,7,4,19,24,-5,13,,,The Dell,Southampton
1994/95,23,6,Crystal Palace,16,27,7,9,11,21,26,-5,30,13,3,4,6,9,13,-4,13,14,4,5,5,12,13,-1,17,,,Selhurst Park,London
1994/95,23,17,Queens Park Rangers,17,25,8,6,11,38,44,-6,30,12,6,2,4,23,18,5,20,13,2,4,7,15,26,-11,10,,,Loftus Road,London
1994/95,23,7,Everton,18,27,7,9,11,27,36,-9,30,14,6,5,3,23,17,6,23,13,1,4,8,4,19,-15,7,Q,EU_CWC,Goodison Park,Liverpool
1994/95,23,25,West Ham United,19,26,8,4,14,24,33,-9,28,13,6,2,5,14,12,2,20,13,2,2,9,10,21,-11,8,R,EN_D1,Boleyn Ground,London
1994/95,23,5,Coventry City,20,27,6,10,11,25,45,-20,28,14,4,5,5,12,18,-6,17,13,2,5,6,13,27,-14,11,R,EN_D1,Highfield Road,Coventry
1994/95,23,8,Ipswich Town,21,27,5,5,17,29,55,-26,20,14,3,2,9,19,27,-8,11,13,2,3,8,10,28,-18,9,R,EN_D1,Portman Road,Ipswich
1994/95,23,26,Leicester City,22,26,4,6,16,24,45,-21,18,13,3,4,6,16,19,-3,13,13,1,2,10,8,26,-18,5,R,EN_D1,Filbert Street,Leicester
1994/95,24,3,Blackburn Rovers,1,28,19,5,4,61,25,36,62,14,12,1,1,42,14,28,37,14,7,4,3,19,11,8,25,Q,EU_CL,Ewood Park,Blackburn
1994/95,24,12,Manchester United,2,28,18,6,4,51,21,30,60,14,12,1,1,27,3,24,37,14,6,5,3,24,18,6,23,Q,EU_UC,Old Trafford,Manchester
1994/95,24,23,Newcastle United,3,28,14,9,5,47,30,17,51,14,9,5,0,30,12,18,32,14,5,4,5,17,18,-1,19,Q,EU_UC,St. James' Park,Newcastle
1994/95,24,10,Liverpool,4,27,13,9,5,46,22,24,48,14,8,5,1,25,7,18,29,13,5,4,4,21,15,6,19,Q,EU_UC,Anfield,Liverpool
1994/95,24,15,Nottingham Forest,5,28,13,7,8,41,31,10,46,14,7,4,3,22,14,8,25,14,6,3,5,19,17,2,21,Q,EU_UC,City Ground,Nottingham
1994/95,24,21,Tottenham Hotspur,6,27,12,7,8,45,38,7,43,13,6,3,4,22,18,4,21,14,6,4,4,23,20,3,22,,,White Hart Lane,London
1994/95,24,9,Leeds United,7,26,10,9,7,34,28,6,39,13,7,4,2,20,11,9,25,13,3,5,5,14,17,-3,14,,,Elland Road,Leeds
1994/95,24,19,Sheffield Wednesday,8,29,10,9,10,38,38,0,39,15,5,6,4,19,15,4,21,14,5,3,6,19,23,-4,18,,,Hillsborough,Sheffield
1994/95,24,2,Aston Villa,9,29,9,10,10,41,38,3,37,14,5,6,3,20,12,8,21,15,4,4,7,21,26,-5,16,,,Villa Park,Birmingham
1994/95,24,22,Wimbledon,10,27,10,6,11,32,47,-15,36,13,7,2,4,18,17,1,23,14,3,4,7,14,30,-16,13,,,Selhurst Park,London
1994/95,24,14,Norwich City,11,27,9,8,10,27,31,-4,35,14,7,5,2,21,14,7,26,13,2,3,8,6,17,-11,9,,,Carrow Road,Norwich
1994/95,24,1,Arsenal,12,28,8,10,10,31,32,-1,34,14,3,7,4,16,16,0,16,14,5,3,6,15,16,-1,18,,,Highbury,London
1994/95,24,5,Coventry City,13,29,8,10,11,29,45,-16,34,15,5,5,5,14,18,-4,20,14,3,5,6,15,27,-12,14,,,Highfield Road,Coventry
1994/95,24,4,Chelsea,14,27,8,9,10,35,38,-3,33,14,4,5,5,20,15,5,17,13,4,4,5,15,23,-8,16,,,Stamford Bridge,London
1994/95,24,11,Manchester City,15,27,8,8,11,35,44,-9,32,14,5,5,4,27,20,7,20,13,3,3,7,8,24,-16,12,,,Maine Road,Manchester
1994/95,24,20,Southampton,16,27,6,13,8,39,44,-5,31,13,4,5,4,18,18,0,17,14,2,8,4,21,26,-5,14,,,The Dell,Southampton
1994/95,24,17,Queens Park Rangers,17,26,8,7,11,39,45,-6,31,12,6,2,4,23,18,5,20,14,2,5,7,16,27,-11,11,,,Loftus Road,London
1994/95,24,7,Everton,18,28,7,10,11,29,38,-9,31,14,6,5,3,23,17,6,23,14,1,5,8,6,21,-15,8,Q,EU_CWC,Goodison Park,Liverpool
1994/95,24,6,Crystal Palace,19,28,7,9,12,21,28,-7,30,14,3,4,7,9,15,-6,13,14,4,5,5,12,13,-1,17,R,EN_D1,Selhurst Park,London
1994/95,24,25,West Ham United,20,28,8,5,15,26,37,-11,29,14,6,3,5,16,14,2,21,14,2,2,10,10,23,-13,8,R,EN_D1,Boleyn Ground,London
1994/95,24,8,Ipswich Town,21,27,5,5,17,29,55,-26,20,14,3,2,9,19,27,-8,11,13,2,3,8,10,28,-18,9,R,EN_D1,Portman Road,Ipswich
1994/95,24,26,Leicester City,22,27,4,7,16,25,46,-21,19,13,3,4,6,16,19,-3,13,14,1,3,10,9,27,-18,6,R,EN_D1,Filbert Street,Leicester
1994/95,25,3,Blackburn Rovers,1,29,20,5,4,63,26,37,65,15,13,1,1,44,15,29,40,14,7,4,3,19,11,8,25,Q,EU_CL,Ewood Park,Blackburn
1994/95,25,12,Manchester United,2,29,19,6,4,53,21,32,63,14,12,1,1,27,3,24,37,15,7,5,3,26,18,8,26,Q,EU_UC,Old Trafford,Manchester
1994/95,25,23,Newcastle United,3,28,14,9,5,47,30,17,51,14,9,5,0,30,12,18,32,14,5,4,5,17,18,-1,19,Q,EU_UC,St. James' Park,Newcastle
1994/95,25,10,Liverpool,4,27,13,9,5,46,22,24,48,14,8,5,1,25,7,18,29,13,5,4,4,21,15,6,19,Q,EU_UC,Anfield,Liverpool
1994/95,25,15,Nottingham Forest,5,29,13,7,9,41,32,9,46,14,7,4,3,22,14,8,25,15,6,3,6,19,18,1,21,Q,EU_UC,City Ground,Nottingham
1994/95,25,21,Tottenham Hotspur,6,27,12,7,8,45,38,7,43,13,6,3,4,22,18,4,21,14,6,4,4,23,20,3,22,,,White Hart Lane,London
1994/95,25,9,Leeds United,7,27,11,9,7,35,28,7,42,14,8,4,2,21,11,10,28,13,3,5,5,14,17,-3,14,,,Elland Road,Leeds
1994/95,25,19,Sheffield Wednesday,8,29,10,9,10,38,38,0,39,15,5,6,4,19,15,4,21,14,5,3,6,19,23,-4,18,,,Hillsborough,Sheffield
1994/95,25,2,Aston Villa,9,30,9,11,10,45,42,3,38,15,5,7,3,24,16,8,22,15,4,4,7,21,26,-5,16,,,Villa Park,Birmingham
1994/95,25,1,Arsenal,10,29,9,10,10,32,32,0,37,15,4,7,4,17,16,1,19,14,5,3,6,15,16,-1,18,,,Highbury,London
1994/95,25,22,Wimbledon,11,28,10,6,12,33,49,-16,36,13,7,2,4,18,17,1,23,15,3,4,8,15,32,-17,13,,,Selhurst Park,London
1994/95,25,14,Norwich City,12,28,9,8,11,27,33,-6,35,15,7,5,3,21,16,5,26,13,2,3,8,6,17,-11,9,,,Carrow Road,Norwich
1994/95,25,11,Manchester City,13,28,9,8,11,37,44,-7,35,15,6,5,4,29,20,9,23,13,3,3,7,8,24,-16,12,,,Maine Road,Manchester
1994/95,25,5,Coventry City,14,29,8,10,11,29,45,-16,34,15,5,5,5,14,18,-4,20,14,3,5,6,15,27,-12,14,,,Highfield Road,Coventry
1994/95,25,4,Chelsea,15,27,8,9,10,35,38,-3,33,14,4,5,5,20,15,5,17,13,4,4,5,15,23,-8,16,,,Stamford Bridge,London
1994/95,25,20,Southampton,16,27,6,13,8,39,44,-5,31,13,4,5,4,18,18,0,17,14,2,8,4,21,26,-5,14,,,The Dell,Southampton
1994/95,25,17,Queens Park Rangers,17,26,8,7,11,39,45,-6,31,12,6,2,4,23,18,5,20,14,2,5,7,16,27,-11,11,,,Loftus Road,London
1994/95,25,7,Everton,18,29,7,10,12,29,39,-10,31,14,6,5,3,23,17,6,23,15,1,5,9,6,22,-16,8,Q,EU_CWC,Goodison Park,Liverpool
1994/95,25,6,Crystal Palace,19,28,7,9,12,21,28,-7,30,14,3,4,7,9,15,-6,13,14,4,5,5,12,13,-1,17,R,EN_D1,Selhurst Park,London
1994/95,25,25,West Ham United,20,28,8,5,15,26,37,-11,29,14,6,3,5,16,14,2,21,14,2,2,10,10,23,-13,8,R,EN_D1,Boleyn Ground,London
1994/95,25,26,Leicester City,21,28,4,8,16,29,50,-21,20,13,3,4,6,16,19,-3,13,15,1,4,10,13,31,-18,7,R,EN_D1,Filbert Street,Leicester
1994/95,25,8,Ipswich Town,22,28,5,5,18,29,57,-28,20,14,3,2,9,19,27,-8,11,14,2,3,9,10,30,-20,9,R,EN_D1,Portman Road,Ipswich
1994/95,26,3,Blackburn Rovers,1,30,20,6,4,63,26,37,66,16,13,2,1,44,15,29,41,14,7,4,3,19,11,8,25,Q,EU_CL,Ewood Park,Blackburn
1994/95,26,12,Manchester United,2,30,19,6,5,53,22,31,63,14,12,1,1,27,3,24,37,16,7,5,4,26,19,7,26,Q,EU_UC,Old Trafford,Manchester
1994/95,26,23,Newcastle United,3,30,16,9,5,52,31,21,57,15,10,5,0,33,13,20,35,15,6,4,5,19,18,1,22,Q,EU_UC,St. James' Park,Newcastle
1994/95,26,10,Liverpool,4,28,14,9,5,48,23,25,51,14,8,5,1,25,7,18,29,14,6,4,4,23,16,7,22,Q,EU_UC,Anfield,Liverpool
1994/95,26,15,Nottingham Forest,5,30,13,8,9,42,33,9,47,14,7,4,3,22,14,8,25,16,6,4,6,20,19,1,22,Q,EU_UC,City Ground,Nottingham
1994/95,26,9,Leeds United,6,28,11,10,7,35,28,7,43,14,8,4,2,21,11,10,28,14,3,6,5,14,17,-3,15,,,Elland Road,Leeds
1994/95,26,21,Tottenham Hotspur,7,28,12,7,9,46,40,6,43,14,6,3,5,23,20,3,21,14,6,4,4,23,20,3,22,,,White Hart Lane,London
1994/95,26,1,Arsenal,8,30,10,10,10,35,32,3,40,15,4,7,4,17,16,1,19,15,6,3,6,18,16,2,21,,,Highbury,London
1994/95,26,19,Sheffield Wednesday,9,30,10,9,11,39,40,-1,39,16,5,6,5,20,17,3,21,14,5,3,6,19,23,-4,18,,,Hillsborough,Sheffield
1994/95,26,22,Wimbledon,10,29,11,6,12,35,50,-15,39,13,7,2,4,18,17,1,23,16,4,4,8,17,33,-16,16,,,Selhurst Park,London
1994/95,26,2,Aston Villa,11,31,9,11,11,46,45,1,38,15,5,7,3,24,16,8,22,16,4,4,8,22,29,-7,16,,,Villa Park,Birmingham
1994/95,26,5,Coventry City,12,30,9,10,11,33,47,-14,37,16,6,5,5,18,20,-2,23,14,3,5,6,15,27,-12,14,,,Highfield Road,Coventry
1994/95,26,4,Chelsea,13,28,9,9,10,37,39,-2,36,14,4,5,5,20,15,5,17,14,5,4,5,17,24,-7,19,,,Stamford Bridge,London
1994/95,26,14,Norwich City,14,29,9,9,11,27,33,-6,36,15,7,5,3,21,16,5,26,14,2,4,8,6,17,-11,10,,,Carrow Road,Norwich
1994/95,26,11,Manchester City,15,29,9,9,11,37,44,-7,36,16,6,6,4,29,20,9,24,13,3,3,7,8,24,-16,12,,,Maine Road,Manchester
1994/95,26,7,Everton,16,30,8,10,12,30,39,-9,34,15,7,5,3,24,17,7,26,15,1,5,9,6,22,-16,8,Q,EU_CWC,Goodison Park,Liverpool
1994/95,26,17,Queens Park Rangers,17,27,8,8,11,40,46,-6,32,13,6,3,4,24,19,5,21,14,2,5,7,16,27,-11,11,,,Loftus Road,London
1994/95,26,20,Southampton,18,28,6,13,9,40,46,-6,31,13,4,5,4,18,18,0,17,15,2,8,5,22,28,-6,14,,,The Dell,Southampton
1994/95,26,6,Crystal Palace,19,29,7,9,13,21,31,-10,30,15,3,4,8,9,18,-9,13,14,4,5,5,12,13,-1,17,R,EN_D1,Selhurst Park,London
1994/95,26,25,West Ham United,20,29,8,5,16,27,39,-12,29,15,6,3,6,17,16,1,21,14,2,2,10,10,23,-13,8,R,EN_D1,Boleyn Ground,London
1994/95,26,8,Ipswich Town,21,30,6,5,19,31,60,-29,23,16,4,2,10,21,30,-9,14,14,2,3,9,10,30,-20,9,R,EN_D1,Portman Road,Ipswich
1994/95,26,26,Leicester City,22,29,4,8,17,31,54,-23,20,13,3,4,6,16,19,-3,13,16,1,4,11,15,35,-20,7,R,EN_D1,Filbert Street,Leicester
1994/95,27,3,Blackburn Rovers,1,32,22,6,4,67,27,40,72,17,14,2,1,47,16,31,44,15,8,4,3,20,11,9,28,Q,EU_CL,Ewood Park,Blackburn
1994/95,27,12,Manchester United,2,32,21,6,5,63,22,41,69,15,13,1,1,36,3,33,40,17,8,5,4,27,19,8,29,Q,EU_UC,Old Trafford,Manchester
1994/95,27,23,Newcastle United,3,32,17,9,6,54,33,21,60,16,11,5,0,35,13,22,38,16,6,4,6,19,20,-1,22,Q,EU_UC,St. James' Park,Newcastle
1994/95,27,10,Liverpool,4,29,15,9,5,50,23,27,54,15,9,5,1,27,7,20,32,14,6,4,4,23,16,7,22,Q,EU_UC,Anfield,Liverpool
1994/95,27,15,Nottingham Forest,5,32,14,9,9,46,36,10,51,16,8,5,3,26,17,9,29,16,6,4,6,20,19,1,22,Q,EU_UC,City Ground,Nottingham
1994/95,27,21,Tottenham Hotspur,6,30,13,8,9,51,42,9,47,15,7,3,5,26,20,6,24,15,6,5,4,25,22,3,23,,,White Hart Lane,London
1994/95,27,9,Leeds United,7,29,11,10,8,35,29,6,43,15,8,4,3,21,12,9,28,14,3,6,5,14,17,-3,15,,,Elland Road,Leeds
1994/95,27,19,Sheffield Wednesday,8,32,11,10,11,40,40,0,43,16,5,6,5,20,17,3,21,16,6,4,6,20,23,-3,22,,,Hillsborough,Sheffield
1994/95,27,1,Arsenal,9,32,10,10,12,36,36,0,40,16,4,7,5,17,17,0,19,16,6,3,7,19,19,0,21,,,Highbury,London
1994/95,27,4,Chelsea,10,30,10,10,10,39,40,-1,40,15,4,6,5,20,15,5,18,15,6,4,5,19,25,-6,22,,,Stamford Bridge,London
1994/95,27,2,Aston Villa,11,33,9,12,12,46,46,0,39,17,5,8,4,24,17,7,23,16,4,4,8,22,29,-7,16,,,Villa Park,Birmingham
1994/95,27,5,Coventry City,12,32,9,12,11,33,47,-14,39,16,6,5,5,18,20,-2,23,16,3,7,6,15,27,-12,16,,,Highfield Road,Coventry
1994/95,27,22,Wimbledon,13,31,11,6,14,36,54,-18,39,15,7,2,6,19,21,-2,23,16,4,4,8,17,33,-16,16,,,Selhurst Park,London
1994/95,27,17,Queens Park Rangers,14,29,10,8,11,45,47,-2,38,14,7,3,4,26,19,7,24,15,3,5,7,19,28,-9,14,,,Loftus Road,London
1994/95,27,14,Norwich City,15,31,9,11,11,28,34,-6,38,17,7,7,3,22,17,5,28,14,2,4,8,6,17,-11,10,,,Carrow Road,Norwich
1994/95,27,11,Manchester City,16,31,9,10,12,39,47,-8,37,17,6,6,5,30,22,8,24,14,3,4,7,9,25,-16,13,,,Maine Road,Manchester
1994/95,27,7,Everton,17,32,8,11,13,33,43,-10,35,15,7,5,3,24,17,7,26,17,1,6,10,9,26,-17,9,Q,EU_CWC,Goodison Park,Liverpool
1994/95,27,20,Southampton,18,29,6,14,9,40,46,-6,32,14,4,6,4,18,18,0,18,15,2,8,5,22,28,-6,14,,,The Dell,Southampton
1994/95,27,25,West Ham United,19,31,9,5,17,28,41,-13,32,15,6,3,6,17,16,1,21,16,3,2,11,11,25,-14,11,R,EN_D1,Boleyn Ground,London
1994/95,27,6,Crystal Palace,20,30,7,10,13,21,31,-10,31,15,3,4,8,9,18,-9,13,15,4,6,5,12,13,-1,18,R,EN_D1,Selhurst Park,London
1994/95,27,8,Ipswich Town,21,32,6,5,21,31,72,-41,23,16,4,2,10,21,30,-9,14,16,2,3,11,10,42,-32,9,R,EN_D1,Portman Road,Ipswich
1994/95,27,26,Leicester City,22,31,4,9,18,33,58,-25,21,14,3,5,6,18,21,-3,14,17,1,4,12,15,37,-22,7,R,EN_D1,Filbert Street,Leicester
1994/95,28,3,Blackburn Rovers,1,33,22,7,4,68,28,40,73,17,14,2,1,47,16,31,44,16,8,5,3,21,12,9,29,Q,EU_CL,Ewood Park,Blackburn
1994/95,28,12,Manchester United,2,32,21,6,5,63,22,41,69,15,13,1,1,36,3,33,40,17,8,5,4,27,19,8,29,Q,EU_UC,Old Trafford,Manchester
1994/95,28,23,Newcastle United,3,32,17,9,6,54,33,21,60,16,11,5,0,35,13,22,38,16,6,4,6,19,20,-1,22,Q,EU_UC,St. James' Park,Newcastle
1994/95,28,10,Liverpool,4,29,15,9,5,50,23,27,54,15,9,5,1,27,7,20,32,14,6,4,4,23,16,7,22,Q,EU_UC,Anfield,Liverpool
1994/95,28,15,Nottingham Forest,5,33,15,9,9,50,38,12,54,16,8,5,3,26,17,9,29,17,7,4,6,24,21,3,25,Q,EU_UC,City Ground,Nottingham
1994/95,28,21,Tottenham Hotspur,6,30,13,8,9,51,42,9,47,15,7,3,5,26,20,6,24,15,6,5,4,25,22,3,23,,,White Hart Lane,London
1994/95,28,9,Leeds United,7,30,12,10,8,38,29,9,46,15,8,4,3,21,12,9,28,15,4,6,5,17,17,0,18,,,Elland Road,Leeds
1994/95,28,19,Sheffield Wednesday,8,33,11,10,12,40,41,-1,43,17,5,6,6,20,18,2,21,16,6,4,6,20,23,-3,22,,,Hillsborough,Sheffield
1994/95,28,22,Wimbledon,9,32,12,6,14,37,54,-17,42,15,7,2,6,19,21,-2,23,17,5,4,8,18,33,-15,19,,,Selhurst Park,London
1994/95,28,1,Arsenal,10,32,10,10,12,36,36,0,40,16,4,7,5,17,17,0,19,16,6,3,7,19,19,0,21,,,Highbury,London
1994/95,28,4,Chelsea,11,31,10,10,11,39,43,-4,40,16,4,6,6,20,18,2,18,15,6,4,5,19,25,-6,22,,,Stamford Bridge,London
1994/95,28,5,Coventry City,12,33,9,13,11,34,48,-14,40,17,6,6,5,19,21,-2,24,16,3,7,6,15,27,-12,16,,,Highfield Road,Coventry
1994/95,28,2,Aston Villa,13,33,9,12,12,46,46,0,39,17,5,8,4,24,17,7,23,16,4,4,8,22,29,-7,16,,,Villa Park,Birmingham
1994/95,28,14,Norwich City,14,32,9,12,11,30,36,-6,39,17,7,7,3,22,17,5,28,15,2,5,8,8,19,-11,11,,,Carrow Road,Norwich
1994/95,28,17,Queens Park Rangers,15,29,10,8,11,45,47,-2,38,14,7,3,4,26,19,7,24,15,3,5,7,19,28,-9,14,,,Loftus Road,London
1994/95,28,11,Manchester City,16,31,9,10,12,39,47,-8,37,17,6,6,5,30,22,8,24,14,3,4,7,9,25,-16,13,,,Maine Road,Manchester
1994/95,28,7,Everton,17,32,8,11,13,33,43,-10,35,15,7,5,3,24,17,7,26,17,1,6,10,9,26,-17,9,Q,EU_CWC,Goodison Park,Liverpool
1994/95,28,25,West Ham United,18,32,9,6,17,30,43,-13,33,16,6,4,6,19,18,1,22,16,3,2,11,11,25,-14,11,,,Boleyn Ground,London
1994/95,28,20,Southampton,19,29,6,14,9,40,46,-6,32,14,4,6,4,18,18,0,18,15,2,8,5,22,28,-6,14,R,EN_D1,The Dell,Southampton
1994/95,28,6,Crystal Palace,20,30,7,10,13,21,31,-10,31,15,3,4,8,9,18,-9,13,15,4,6,5,12,13,-1,18,R,EN_D1,Selhurst Park,London
1994/95,28,8,Ipswich Town,21,32,6,5,21,31,72,-41,23,16,4,2,10,21,30,-9,14,16,2,3,11,10,42,-32,9,R,EN_D1,Portman Road,Ipswich
1994/95,28,26,Leicester City,22,32,4,9,19,35,62,-27,21,15,3,5,7,20,25,-5,14,17,1,4,12,15,37,-22,7,R,EN_D1,Filbert Street,Leicester
1994/95,29,3,Blackburn Rovers,1,33,22,7,4,68,28,40,73,17,14,2,1,47,16,31,44,16,8,5,3,21,12,9,29,Q,EU_CL,Ewood Park,Blackburn
1994/95,29,12,Manchester United,2,33,21,7,5,63,22,41,70,16,13,2,1,36,3,33,41,17,8,5,4,27,19,8,29,Q,EU_UC,Old Trafford,Manchester
1994/95,29,23,Newcastle United,3,32,17,9,6,54,33,21,60,16,11,5,0,35,13,22,38,16,6,4,6,19,20,-1,22,Q,EU_UC,St. James' Park,Newcastle
1994/95,29,10,Liverpool,4,30,15,9,6,52,26,26,54,16,9,5,2,29,10,19,32,14,6,4,4,23,16,7,22,Q,EU_UC,Anfield,Liverpool
1994/95,29,15,Nottingham Forest,5,33,15,9,9,50,38,12,54,16,8,5,3,26,17,9,29,17,7,4,6,24,21,3,25,Q,EU_UC,City Ground,Nottingham
1994/95,29,9,Leeds United,6,31,13,10,8,41,30,11,49,15,8,4,3,21,12,9,28,16,5,6,5,20,18,2,21,,,Elland Road,Leeds
1994/95,29,21,Tottenham Hotspur,7,31,13,9,9,51,42,9,48,15,7,3,5,26,20,6,24,16,6,6,4,25,22,3,24,,,White Hart Lane,London
1994/95,29,19,Sheffield Wednesday,8,34,11,10,13,41,43,-2,43,17,5,6,6,20,18,2,21,17,6,4,7,21,25,-4,22,,,Hillsborough,Sheffield
1994/95,29,5,Coventry City,9,34,10,13,11,37,50,-13,43,17,6,6,5,19,21,-2,24,17,4,7,6,18,29,-11,19,,,Highfield Road,Coventry
1994/95,29,22,Wimbledon,10,32,12,6,14,37,54,-17,42,15,7,2,6,19,21,-2,23,17,5,4,8,18,33,-15,19,,,Selhurst Park,London
1994/95,29,17,Queens Park Rangers,11,30,11,8,11,47,47,0,41,15,8,3,4,28,19,9,27,15,3,5,7,19,28,-9,14,,,Loftus Road,London
1994/95,29,1,Arsenal,12,32,10,10,12,36,36,0,40,16,4,7,5,17,17,0,19,16,6,3,7,19,19,0,21,,,Highbury,London
1994/95,29,4,Chelsea,13,31,10,10,11,39,43,-4,40,16,4,6,6,20,18,2,18,15,6,4,5,19,25,-6,22,,,Stamford Bridge,London
1994/95,29,2,Aston Villa,14,33,9,12,12,46,46,0,39,17,5,8,4,24,17,7,23,16,4,4,8,22,29,-7,16,,,Villa Park,Birmingham
1994/95,29,14,Norwich City,15,33,9,12,12,30,38,-8,39,17,7,7,3,22,17,5,28,16,2,5,9,8,21,-13,11,,,Carrow Road,Norwich
1994/95,29,11,Manchester City,16,32,9,11,12,40,48,-8,38,17,6,6,5,30,22,8,24,15,3,5,7,10,26,-16,14,,,Maine Road,Manchester
1994/95,29,7,Everton,17,33,8,12,13,34,44,-10,36,16,7,6,3,25,18,7,27,17,1,6,10,9,26,-17,9,Q,EU_CWC,Goodison Park,Liverpool
1994/95,29,6,Crystal Palace,18,31,8,10,13,23,32,-9,34,16,4,4,8,11,19,-8,16,15,4,6,5,12,13,-1,18,,,Selhurst Park,London
1994/95,29,25,West Ham United,19,33,9,7,17,31,44,-13,34,16,6,4,6,19,18,1,22,17,3,3,11,12,26,-14,12,R,EN_D1,Boleyn Ground,London
1994/95,29,20,Southampton,20,30,6,15,9,41,47,-6,33,15,4,7,4,19,19,0,19,15,2,8,5,22,28,-6,14,R,EN_D1,The Dell,Southampton
1994/95,29,8,Ipswich Town,21,32,6,5,21,31,72,-41,23,16,4,2,10,21,30,-9,14,16,2,3,11,10,42,-32,9,R,EN_D1,Portman Road,Ipswich
1994/95,29,26,Leicester City,22,33,4,9,20,36,65,-29,21,16,3,5,8,21,28,-7,14,17,1,4,12,15,37,-22,7,R,EN_D1,Filbert Street,Leicester
1994/95,30,3,Blackburn Rovers,1,34,23,7,4,70,29,41,76,18,15,2,1,49,17,32,47,16,8,5,3,21,12,9,29,Q,EU_CL,Ewood Park,Blackburn
1994/95,30,12,Manchester United,2,35,22,7,6,66,24,42,73,17,14,2,1,39,3,36,44,18,8,5,5,27,21,6,29,Q,EU_UC,Old Trafford,Manchester
1994/95,30,23,Newcastle United,3,34,18,9,7,56,36,20,63,17,12,5,0,36,13,23,41,17,6,4,7,20,23,-3,22,Q,EU_UC,St. James' Park,Newcastle
1994/95,30,15,Nottingham Forest,4,35,17,9,9,56,38,18,60,18,10,5,3,32,17,15,35,17,7,4,6,24,21,3,25,Q,EU_UC,City Ground,Nottingham
1994/95,30,10,Liverpool,5,32,16,10,6,54,26,28,58,17,10,5,2,31,10,21,35,15,6,5,4,23,16,7,23,Q,EU_UC,Anfield,Liverpool
1994/95,30,9,Leeds United,6,33,14,10,9,44,33,11,52,16,9,4,3,24,12,12,31,17,5,6,6,20,21,-1,21,,,Elland Road,Leeds
1994/95,30,21,Tottenham Hotspur,7,33,14,10,9,52,42,10,52,17,8,4,5,27,20,7,28,16,6,6,4,25,22,3,24,,,White Hart Lane,London
1994/95,30,22,Wimbledon,8,34,14,6,14,41,54,-13,48,17,9,2,6,23,21,2,29,17,5,4,8,18,33,-15,19,,,Selhurst Park,London
1994/95,30,17,Queens Park Rangers,9,32,12,8,12,50,50,0,44,17,9,3,5,31,22,9,30,15,3,5,7,19,28,-9,14,,,Loftus Road,London
1994/95,30,19,Sheffield Wednesday,10,35,11,10,14,43,46,-3,43,17,5,6,6,20,18,2,21,18,6,4,8,23,28,-5,22,,,Hillsborough,Sheffield
1994/95,30,5,Coventry City,11,35,10,13,12,37,53,-16,43,17,6,6,5,19,21,-2,24,18,4,7,7,18,32,-14,19,,,Highfield Road,Coventry
1994/95,30,14,Norwich City,12,34,10,12,12,33,38,-5,42,18,8,7,3,25,17,8,31,16,2,5,9,8,21,-13,11,,,Carrow Road,Norwich
1994/95,30,11,Manchester City,13,34,10,11,13,43,52,-9,41,18,7,6,5,33,24,9,27,16,3,5,8,10,28,-18,14,,,Maine Road,Manchester
1994/95,30,1,Arsenal,14,34,10,10,14,36,40,-4,40,16,4,7,5,17,17,0,19,18,6,3,9,19,23,-4,21,,,Highbury,London
1994/95,30,4,Chelsea,15,33,10,10,13,40,46,-6,40,16,4,6,6,20,18,2,18,17,6,4,7,20,28,-8,22,,,Stamford Bridge,London
1994/95,30,2,Aston Villa,16,34,9,12,13,46,48,-2,39,18,5,8,5,24,19,5,23,16,4,4,8,22,29,-7,16,,,Villa Park,Birmingham
1994/95,30,7,Everton,17,34,9,12,13,37,46,-9,39,16,7,6,3,25,18,7,27,18,2,6,10,12,28,-16,12,Q,EU_CWC,Goodison Park,Liverpool
1994/95,30,25,West Ham United,18,34,10,7,17,33,44,-11,37,16,6,4,6,19,18,1,22,18,4,3,11,14,26,-12,15,,,Boleyn Ground,London
1994/95,30,20,Southampton,19,32,7,15,10,44,51,-7,36,16,5,7,4,22,20,2,22,16,2,8,6,22,31,-9,14,R,EN_D1,The Dell,Southampton
1994/95,30,6,Crystal Palace,20,32,8,10,14,23,34,-11,34,16,4,4,8,11,19,-8,16,16,4,6,6,12,15,-3,18,R,EN_D1,Selhurst Park,London
1994/95,30,8,Ipswich Town,21,33,6,5,22,31,75,-44,23,16,4,2,10,21,30,-9,14,17,2,3,12,10,45,-35,9,R,EN_D1,Portman Road,Ipswich
1994/95,30,26,Leicester City,22,34,4,9,21,36,66,-30,21,16,3,5,8,21,28,-7,14,18,1,4,13,15,38,-23,7,R,EN_D1,Filbert Street,Leicester
1994/95,31,3,Blackburn Rovers,1,35,24,7,4,72,30,42,79,18,15,2,1,49,17,32,47,17,9,5,3,23,13,10,32,Q,EU_CL,Ewood Park,Blackburn
1994/95,31,12,Manchester United,2,36,22,8,6,66,24,42,74,18,14,3,1,39,3,36,45,18,8,5,5,27,21,6,29,Q,EU_UC,Old Trafford,Manchester
1994/95,31,23,Newcastle United,3,35,18,10,7,57,37,20,64,17,12,5,0,36,13,23,41,18,6,5,7,21,24,-3,23,Q,EU_UC,St. James' Park,Newcastle
1994/95,31,15,Nottingham Forest,4,36,18,9,9,63,39,24,63,18,10,5,3,32,17,15,35,18,8,4,6,31,22,9,28,Q,EU_UC,City Ground,Nottingham
1994/95,31,10,Liverpool,5,32,16,10,6,54,26,28,58,17,10,5,2,31,10,21,35,15,6,5,4,23,16,7,23,Q,EU_UC,Anfield,Liverpool
1994/95,31,9,Leeds United,6,34,14,11,9,44,33,11,53,16,9,4,3,24,12,12,31,18,5,7,6,20,21,-1,22,,,Elland Road,Leeds
1994/95,31,21,Tottenham Hotspur,7,34,14,10,10,55,46,9,52,17,8,4,5,27,20,7,28,17,6,6,5,28,26,2,24,,,White Hart Lane,London
1994/95,31,22,Wimbledon,8,35,15,6,14,45,57,-12,51,17,9,2,6,23,21,2,29,18,6,4,8,22,36,-14,22,,,Selhurst Park,London
1994/95,31,17,Queens Park Rangers,9,33,13,8,12,51,50,1,47,17,9,3,5,31,22,9,30,16,4,5,7,20,28,-8,17,,,Loftus Road,London
1994/95,31,1,Arsenal,10,35,11,10,14,41,41,0,43,17,5,7,5,22,18,4,22,18,6,3,9,19,23,-4,21,,,Highbury,London
1994/95,31,19,Sheffield Wednesday,11,36,11,10,15,44,53,-9,43,18,5,6,7,21,25,-4,21,18,6,4,8,23,28,-5,22,,,Hillsborough,Sheffield
1994/95,31,5,Coventry City,12,36,10,13,13,37,54,-17,43,18,6,6,6,19,22,-3,24,18,4,7,7,18,32,-14,19,,,Highfield Road,Coventry
1994/95,31,2,Aston Villa,13,35,10,12,13,47,48,-1,42,18,5,8,5,24,19,5,23,17,5,4,8,23,29,-6,19,,,Villa Park,Birmingham
1994/95,31,14,Norwich City,14,35,10,12,13,34,43,-9,42,18,8,7,3,25,17,8,31,17,2,5,10,9,26,-17,11,,,Carrow Road,Norwich
1994/95,31,4,Chelsea,15,34,10,11,13,41,47,-6,41,17,4,7,6,21,19,2,19,17,6,4,7,20,28,-8,22,,,Stamford Bridge,London
1994/95,31,11,Manchester City,16,35,10,11,14,44,54,-10,41,18,7,6,5,33,24,9,27,17,3,5,9,11,30,-19,14,,,Maine Road,Manchester
1994/95,31,20,Southampton,17,33,8,15,10,48,54,-6,39,17,6,7,4,26,23,3,25,16,2,8,6,22,31,-9,14,,,The Dell,Southampton
1994/95,31,7,Everton,18,35,9,12,14,38,48,-10,39,17,7,6,4,26,20,6,27,18,2,6,10,12,28,-16,12,Q,EU_CWC,Goodison Park,Liverpool
1994/95,31,6,Crystal Palace,19,33,9,10,14,25,35,-10,37,17,5,4,8,13,20,-7,19,16,4,6,6,12,15,-3,18,R,EN_D1,Selhurst Park,London
1994/95,31,25,West Ham United,20,34,10,7,17,33,44,-11,37,16,6,4,6,19,18,1,22,18,4,3,11,14,26,-12,15,R,EN_D1,Boleyn Ground,London
1994/95,31,8,Ipswich Town,21,34,6,5,23,31,76,-45,23,17,4,2,11,21,31,-10,14,17,2,3,12,10,45,-35,9,R,EN_D1,Portman Road,Ipswich
1994/95,31,26,Leicester City,22,35,4,9,22,39,70,-31,21,17,3,5,9,24,32,-8,14,18,1,4,13,15,38,-23,7,R,EN_D1,Filbert Street,Leicester
1994/95,32,3,Blackburn Rovers,1,36,25,7,4,73,30,43,82,18,15,2,1,49,17,32,47,18,10,5,3,24,13,11,35,Q,EU_CL,Ewood Park,Blackburn
1994/95,32,12,Manchester United,2,36,22,8,6,66,24,42,74,18,14,3,1,39,3,36,45,18,8,5,5,27,21,6,29,Q,EU_UC,Old Trafford,Manchester
1994/95,32,23,Newcastle United,3,35,18,10,7,57,37,20,64,17,12,5,0,36,13,23,41,18,6,5,7,21,24,-3,23,Q,EU_UC,St. James' Park,Newcastle
1994/95,32,15,Nottingham Forest,4,36,18,9,9,63,39,24,63,18,10,5,3,32,17,15,35,18,8,4,6,31,22,9,28,Q,EU_UC,City Ground,Nottingham
1994/95,32,10,Liverpool,5,33,17,10,6,57,27,30,61,18,11,5,2,34,11,23,38,15,6,5,4,23,16,7,23,Q,EU_UC,Anfield,Liverpool
1994/95,32,9,Leeds United,6,35,15,11,9,48,33,15,56,17,10,4,3,28,12,16,34,18,5,7,6,20,21,-1,22,,,Elland Road,Leeds
1994/95,32,21,Tottenham Hotspur,7,34,14,10,10,55,46,9,52,17,8,4,5,27,20,7,28,17,6,6,5,28,26,2,24,,,White Hart Lane,London
1994/95,32,22,Wimbledon,8,35,15,6,14,45,57,-12,51,17,9,2,6,23,21,2,29,18,6,4,8,22,36,-14,22,,,Selhurst Park,London
1994/95,32,17,Queens Park Rangers,9,34,13,8,13,51,51,0,47,18,9,3,6,31,23,8,30,16,4,5,7,20,28,-8,17,,,Loftus Road,London
1994/95,32,1,Arsenal,10,35,11,10,14,41,41,0,43,17,5,7,5,22,18,4,22,18,6,3,9,19,23,-4,21,,,Highbury,London
1994/95,32,2,Aston Villa,11,36,10,13,13,47,48,-1,43,18,5,8,5,24,19,5,23,18,5,5,8,23,29,-6,20,,,Villa Park,Birmingham
1994/95,32,19,Sheffield Wednesday,12,36,11,10,15,44,53,-9,43,18,5,6,7,21,25,-4,21,18,6,4,8,23,28,-5,22,,,Hillsborough,Sheffield
1994/95,32,5,Coventry City,13,36,10,13,13,37,54,-17,43,18,6,6,6,19,22,-3,24,18,4,7,7,18,32,-14,19,,,Highfield Road,Coventry
1994/95,32,14,Norwich City,14,36,10,12,14,34,44,-10,42,18,8,7,3,25,17,8,31,18,2,5,11,9,27,-18,11,,,Carrow Road,Norwich
1994/95,32,4,Chelsea,15,34,10,11,13,41,47,-6,41,17,4,7,6,21,19,2,19,17,6,4,7,20,28,-8,22,,,Stamford Bridge,London
1994/95,32,11,Manchester City,16,35,10,11,14,44,54,-10,41,18,7,6,5,33,24,9,27,17,3,5,9,11,30,-19,14,,,Maine Road,Manchester
1994/95,32,20,Southampton,17,34,8,15,11,49,57,-8,39,17,6,7,4,26,23,3,25,17,2,8,7,23,34,-11,14,,,The Dell,Southampton
1994/95,32,7,Everton,18,35,9,12,14,38,48,-10,39,17,7,6,4,26,20,6,27,18,2,6,10,12,28,-16,12,Q,EU_CWC,Goodison Park,Liverpool
1994/95,32,6,Crystal Palace,19,34,9,11,14,25,35,-10,38,18,5,5,8,13,20,-7,20,16,4,6,6,12,15,-3,18,R,EN_D1,Selhurst Park,London
1994/95,32,25,West Ham United,20,34,10,7,17,33,44,-11,37,16,6,4,6,19,18,1,22,18,4,3,11,14,26,-12,15,R,EN_D1,Boleyn Ground,London
1994/95,32,26,Leicester City,21,36,5,9,22,40,70,-30,24,18,4,5,9,25,32,-7,17,18,1,4,13,15,38,-23,7,R,EN_D1,Filbert Street,Leicester
1994/95,32,8,Ipswich Town,22,35,6,5,24,31,80,-49,23,17,4,2,11,21,31,-10,14,18,2,3,13,10,49,-39,9,R,EN_D1,Portman Road,Ipswich
1994/95,33,3,Blackburn Rovers,1,37,25,8,4,74,31,43,83,18,15,2,1,49,17,32,47,19,10,6,3,25,14,11,36,Q,EU_CL,Ewood Park,Blackburn
1994/95,33,12,Manchester United,2,37,23,8,6,70,24,46,77,18,14,3,1,39,3,36,45,19,9,5,5,31,21,10,32,Q,EU_UC,Old Trafford,Manchester
1994/95,33,15,Nottingham Forest,3,38,19,10,9,65,40,25,67,19,10,6,3,33,18,15,36,19,9,4,6,32,22,10,31,Q,EU_UC,City Ground,Nottingham
1994/95,33,23,Newcastle United,4,37,19,10,8,60,39,21,67,18,13,5,0,39,13,26,44,19,6,5,8,21,26,-5,23,Q,EU_UC,St. James' Park,Newcastle
1994/95,33,10,Liverpool,5,36,18,10,8,59,30,29,64,19,11,5,3,34,12,22,38,17,7,5,5,25,18,7,26,Q,EU_UC,Anfield,Liverpool
1994/95,33,9,Leeds United,6,37,16,12,9,50,34,16,60,18,10,5,3,29,13,16,35,19,6,7,6,21,21,0,25,,,Elland Road,Leeds
1994/95,33,21,Tottenham Hotspur,7,36,15,11,10,58,48,10,56,18,9,4,5,29,21,8,31,18,6,7,5,29,27,2,25,,,White Hart Lane,London
1994/95,33,17,Queens Park Rangers,8,37,15,8,14,56,54,2,53,19,10,3,6,34,24,10,33,18,5,5,8,22,30,-8,20,,,Loftus Road,London
1994/95,33,22,Wimbledon,9,37,15,7,15,46,61,-15,52,18,9,3,6,24,22,2,30,19,6,4,9,22,39,-17,22,,,Selhurst Park,London
1994/95,33,1,Arsenal,10,38,12,10,16,46,46,0,46,19,6,7,6,26,20,6,25,19,6,3,10,20,26,-6,21,,,Highbury,London
1994/95,33,19,Sheffield Wednesday,11,38,12,10,16,45,55,-10,46,19,6,6,7,22,25,-3,24,19,6,4,9,23,30,-7,22,,,Hillsborough,Sheffield
1994/95,33,5,Coventry City,12,37,11,13,13,39,54,-15,46,19,7,6,6,21,22,-1,27,18,4,7,7,18,32,-14,19,,,Highfield Road,Coventry
1994/95,33,20,Southampton,13,36,10,15,11,53,58,-5,45,18,7,7,4,28,24,4,28,18,3,8,7,25,34,-9,17,,,The Dell,Southampton
1994/95,33,4,Chelsea,14,37,11,12,14,43,50,-7,45,19,5,7,7,22,21,1,22,18,6,5,7,21,29,-8,23,,,Stamford Bridge,London
1994/95,33,11,Manchester City,15,37,11,11,15,47,57,-10,44,19,8,6,5,35,25,10,30,18,3,5,10,12,32,-20,14,,,Maine Road,Manchester
1994/95,33,2,Aston Villa,16,37,10,13,14,47,49,-2,43,18,5,8,5,24,19,5,23,19,5,5,9,23,30,-7,20,,,Villa Park,Birmingham
1994/95,33,7,Everton,17,36,10,12,14,40,48,-8,42,18,8,6,4,28,20,8,30,18,2,6,10,12,28,-16,12,Q,EU_CWC,Goodison Park,Liverpool
1994/95,33,14,Norwich City,18,38,10,12,16,34,48,-14,42,19,8,7,4,25,18,7,31,19,2,5,12,9,30,-21,11,,,Carrow Road,Norwich
1994/95,33,25,West Ham United,19,36,11,8,17,37,45,-8,41,17,7,4,6,22,18,4,25,19,4,4,11,15,27,-12,16,R,EN_D1,Boleyn Ground,London
1994/95,33,6,Crystal Palace,20,35,9,12,14,26,36,-10,39,19,5,6,8,14,21,-7,21,16,4,6,6,12,15,-3,18,R,EN_D1,Selhurst Park,London
1994/95,33,26,Leicester City,21,38,5,9,24,40,75,-35,24,19,4,5,10,25,36,-11,17,19,1,4,14,15,39,-24,7,R,EN_D1,Filbert Street,Leicester
1994/95,33,8,Ipswich Town,22,37,6,5,26,32,85,-53,23,18,4,2,12,21,32,-11,14,19,2,3,14,11,53,-42,9,R,EN_D1,Portman Road,Ipswich
1994/95,34,3,Blackburn Rovers,1,39,26,8,5,78,35,43,86,20,16,2,2,53,21,32,50,19,10,6,3,25,14,11,36,Q,EU_CL,Ewood Park,Blackburn
1994/95,34,12,Manchester United,2,38,23,9,6,70,24,46,78,19,14,4,1,39,3,36,46,19,9,5,5,31,21,10,32,Q,EU_UC,Old Trafford,Manchester
1994/95,34,15,Nottingham Forest,3,39,20,10,9,67,40,27,70,20,11,6,3,35,18,17,39,19,9,4,6,32,22,10,31,Q,EU_UC,City Ground,Nottingham
1994/95,34,10,Liverpool,4,37,19,10,8,61,30,31,67,20,12,5,3,36,12,24,41,17,7,5,5,25,18,7,26,Q,EU_UC,Anfield,Liverpool
1994/95,34,23,Newcastle United,5,38,19,10,9,61,41,20,67,19,13,5,1,40,15,25,44,19,6,5,8,21,26,-5,23,Q,EU_UC,St. James' Park,Newcastle
1994/95,34,9,Leeds United,6,38,17,12,9,52,35,17,63,18,10,5,3,29,13,16,35,20,7,7,6,23,22,1,28,,,Elland Road,Leeds
1994/95,34,21,Tottenham Hotspur,7,37,16,11,10,59,48,11,59,19,10,4,5,30,21,9,34,18,6,7,5,29,27,2,25,,,White Hart Lane,London
1994/95,34,17,Queens Park Rangers,8,38,15,8,15,56,55,1,53,20,10,3,7,34,25,9,33,18,5,5,8,22,30,-8,20,,,Loftus Road,London
1994/95,34,22,Wimbledon,9,38,15,7,16,46,63,-17,52,19,9,3,7,24,24,0,30,19,6,4,9,22,39,-17,22,,,Selhurst Park,London
1994/95,34,1,Arsenal,10,39,13,10,16,50,46,4,49,19,6,7,6,26,20,6,25,20,7,3,10,24,26,-2,24,,,Highbury,London
1994/95,34,20,Southampton,11,37,11,15,11,55,58,-3,48,18,7,7,4,28,24,4,28,19,4,8,7,27,34,-7,20,,,The Dell,Southampton
1994/95,34,11,Manchester City,12,38,12,11,15,50,59,-9,47,19,8,6,5,35,25,10,30,19,4,5,10,15,34,-19,17,,,Maine Road,Manchester
1994/95,34,19,Sheffield Wednesday,13,39,12,11,16,45,55,-10,47,20,6,7,7,22,25,-3,25,19,6,4,9,23,30,-7,22,,,Hillsborough,Sheffield
1994/95,34,4,Chelsea,14,38,11,13,14,43,50,-7,46,19,5,7,7,22,21,1,22,19,6,6,7,21,29,-8,24,,,Stamford Bridge,London
1994/95,34,5,Coventry City,15,38,11,13,14,39,56,-17,46,19,7,6,6,21,22,-1,27,19,4,7,8,18,34,-16,19,,,Highfield Road,Coventry
1994/95,34,2,Aston Villa,16,38,10,13,15,47,53,-6,43,19,5,8,6,24,23,1,23,19,5,5,9,23,30,-7,20,,,Villa Park,Birmingham
1994/95,34,7,Everton,17,37,10,13,14,40,48,-8,43,18,8,6,4,28,20,8,30,19,2,7,10,12,28,-16,13,Q,EU_CWC,Goodison Park,Liverpool
1994/95,34,25,West Ham United,18,37,11,9,17,38,46,-8,42,17,7,4,6,22,18,4,25,20,4,5,11,16,28,-12,17,,,Boleyn Ground,London
1994/95,34,6,Crystal Palace,19,37,10,12,15,28,38,-10,42,19,5,6,8,14,21,-7,21,18,5,6,7,14,17,-3,21,R,EN_D1,Selhurst Park,London
1994/95,34,14,Norwich City,20,39,10,12,17,34,49,-15,42,19,8,7,4,25,18,7,31,20,2,5,13,9,31,-22,11,R,EN_D1,Carrow Road,Norwich
1994/95,34,26,Leicester City,21,39,5,9,25,40,77,-37,24,19,4,5,10,25,36,-11,17,20,1,4,15,15,41,-26,7,R,EN_D1,Filbert Street,Leicester
1994/95,34,8,Ipswich Town,22,38,6,6,26,33,86,-53,24,19,4,3,12,22,33,-11,15,19,2,3,14,11,53,-42,9,R,EN_D1,Portman Road,Ipswich
1994/95,35,3,Blackburn Rovers,1,40,26,8,6,78,37,41,86,20,16,2,2,53,21,32,50,20,10,6,4,25,16,9,36,Q,EU_CL,Ewood Park,Blackburn
1994/95,35,12,Manchester United,2,39,24,9,6,73,26,47,81,19,14,4,1,39,3,36,46,20,10,5,5,34,23,11,35,Q,EU_UC,Old Trafford,Manchester
1994/95,35,15,Nottingham Forest,3,40,21,10,9,69,41,28,73,20,11,6,3,35,18,17,39,20,10,4,6,34,23,11,34,Q,EU_UC,City Ground,Nottingham
1994/95,35,10,Liverpool,4,39,20,11,8,63,31,32,71,20,12,5,3,36,12,24,41,19,8,6,5,27,19,8,30,Q,EU_UC,Anfield,Liverpool
1994/95,35,23,Newcastle United,5,40,19,12,9,64,44,20,69,20,13,6,1,43,18,25,45,20,6,6,8,21,26,-5,24,Q,EU_UC,St. James' Park,Newcastle
1994/95,35,9,Leeds United,6,39,18,12,9,53,35,18,66,19,11,5,3,30,13,17,38,20,7,7,6,23,22,1,28,,,Elland Road,Leeds
1994/95,35,21,Tottenham Hotspur,7,39,16,13,10,63,52,11,61,19,10,4,5,30,21,9,34,20,6,9,5,33,31,2,27,,,White Hart Lane,London
1994/95,35,22,Wimbledon,8,41,15,10,16,46,63,-17,55,20,9,4,7,24,24,0,31,21,6,6,9,22,39,-17,24,,,Selhurst Park,London
1994/95,35,17,Queens Park Rangers,9,40,15,9,16,56,56,0,54,20,10,3,7,34,25,9,33,20,5,6,9,22,31,-9,21,,,Loftus Road,London
1994/95,35,20,Southampton,10,39,12,16,11,58,59,-1,52,20,8,8,4,31,25,6,32,19,4,8,7,27,34,-7,20,,,The Dell,Southampton
1994/95,35,1,Arsenal,11,41,13,12,16,51,47,4,51,21,6,9,6,27,21,6,27,20,7,3,10,24,26,-2,24,,,Highbury,London
1994/95,35,4,Chelsea,12,40,12,14,14,47,53,-6,50,20,6,7,7,23,21,2,25,20,6,7,7,24,32,-8,25,,,Stamford Bridge,London
1994/95,35,11,Manchester City,13,40,12,13,15,51,60,-9,49,20,8,7,5,35,25,10,31,20,4,6,10,16,35,-19,18,,,Maine Road,Manchester
1994/95,35,19,Sheffield Wednesday,14,40,12,12,16,45,55,-10,48,20,6,7,7,22,25,-3,25,20,6,5,9,23,30,-7,23,,,Hillsborough,Sheffield
1994/95,35,25,West Ham United,15,39,12,10,17,40,46,-6,46,19,8,5,6,24,18,6,29,20,4,5,11,16,28,-12,17,,,Boleyn Ground,London
1994/95,35,5,Coventry City,16,39,11,13,15,41,59,-18,46,20,7,6,7,23,25,-2,27,19,4,7,8,18,34,-16,19,,,Highfield Road,Coventry
1994/95,35,7,Everton,17,39,10,15,14,43,51,-8,45,20,8,8,4,31,23,8,32,19,2,7,10,12,28,-16,13,Q,EU_CWC,Goodison Park,Liverpool
1994/95,35,2,Aston Villa,18,40,10,14,16,48,55,-7,44,20,5,9,6,25,24,1,24,20,5,5,10,23,31,-8,20,,,Villa Park,Birmingham
1994/95,35,6,Crystal Palace,19,39,10,12,17,30,43,-13,42,20,5,6,9,15,23,-8,21,19,5,6,8,15,20,-5,21,R,EN_D1,Selhurst Park,London
1994/95,35,14,Norwich City,20,40,10,12,18,35,51,-16,42,20,8,7,5,26,20,6,31,20,2,5,13,9,31,-22,11,R,EN_D1,Carrow Road,Norwich
1994/95,35,26,Leicester City,21,40,6,9,25,42,77,-35,27,20,5,5,10,27,36,-9,20,20,1,4,15,15,41,-26,7,R,EN_D1,Filbert Street,Leicester
1994/95,35,8,Ipswich Town,22,39,6,6,27,33,88,-55,24,19,4,3,12,22,33,-11,15,20,2,3,15,11,55,-44,9,R,EN_D1,Portman Road,Ipswich
1994/95,36,3,Blackburn Rovers,1,41,27,8,6,79,37,42,89,21,17,2,2,54,21,33,53,20,10,6,4,25,16,9,36,Q,EU_CL,Ewood Park,Blackburn
1994/95,36,12,Manchester United,2,41,26,9,6,76,27,49,87,21,16,4,1,42,4,38,52,20,10,5,5,34,23,11,35,Q,EU_UC,Old Trafford,Manchester
1994/95,36,15,Nottingham Forest,3,41,22,10,9,70,41,29,76,21,12,6,3,36,18,18,42,20,10,4,6,34,23,11,34,Q,EU_UC,City Ground,Nottingham
1994/95,36,9,Leeds United,4,41,20,12,9,58,37,21,72,21,13,5,3,35,15,20,44,20,7,7,6,23,22,1,28,Q,EU_UC,Elland Road,Leeds
1994/95,36,10,Liverpool,5,41,20,11,10,63,36,27,71,20,12,5,3,36,12,24,41,21,8,6,7,27,24,3,30,Q,EU_UC,Anfield,Liverpool
1994/95,36,23,Newcastle United,6,41,19,12,10,64,45,19,69,20,13,6,1,43,18,25,45,21,6,6,9,21,27,-6,24,,,St. James' Park,Newcastle
1994/95,36,21,Tottenham Hotspur,7,41,16,13,12,65,57,8,61,20,10,4,6,31,24,7,34,21,6,9,6,34,33,1,27,,,White Hart Lane,London
1994/95,36,17,Queens Park Rangers,8,41,16,9,16,58,57,1,57,21,11,3,7,36,26,10,36,20,5,6,9,22,31,-9,21,,,Loftus Road,London
1994/95,36,22,Wimbledon,9,41,15,10,16,46,63,-17,55,20,9,4,7,24,24,0,31,21,6,6,9,22,39,-17,24,,,Selhurst Park,London
1994/95,36,20,Southampton,10,41,12,17,12,59,61,-2,53,20,8,8,4,31,25,6,32,21,4,9,8,28,36,-8,21,,,The Dell,Southampton
1994/95,36,1,Arsenal,11,41,13,12,16,51,47,4,51,21,6,9,6,27,21,6,27,20,7,3,10,24,26,-2,24,,,Highbury,London
1994/95,36,4,Chelsea,12,41,12,15,14,48,54,-6,51,20,6,7,7,23,21,2,25,21,6,8,7,25,33,-8,26,,,Stamford Bridge,London
1994/95,36,25,West Ham United,13,41,13,10,18,43,47,-4,49,20,9,5,6,27,18,9,32,21,4,5,12,16,29,-13,17,,,Boleyn Ground,London
1994/95,36,7,Everton,14,41,11,16,14,44,51,-7,49,21,8,9,4,31,23,8,33,20,3,7,10,13,28,-15,16,Q,EU_CWC,Goodison Park,Liverpool
1994/95,36,11,Manchester City,15,41,12,13,16,51,61,-10,49,20,8,7,5,35,25,10,31,21,4,6,11,16,36,-20,18,,,Maine Road,Manchester
1994/95,36,5,Coventry City,16,41,12,13,16,44,62,-18,49,20,7,6,7,23,25,-2,27,21,5,7,9,21,37,-16,22,,,Highfield Road,Coventry
1994/95,36,19,Sheffield Wednesday,17,41,12,12,17,45,56,-11,48,20,6,7,7,22,25,-3,25,21,6,5,10,23,31,-8,23,,,Hillsborough,Sheffield
1994/95,36,2,Aston Villa,18,41,11,14,16,50,55,-5,47,21,6,9,6,27,24,3,27,20,5,5,10,23,31,-8,20,,,Villa Park,Birmingham
1994/95,36,6,Crystal Palace,19,41,11,12,18,32,46,-14,45,21,6,6,9,16,23,-7,24,20,5,6,9,16,23,-7,21,R,EN_D1,Selhurst Park,London
1994/95,36,14,Norwich City,20,41,10,12,19,36,53,-17,42,20,8,7,5,26,20,6,31,21,2,5,14,10,33,-23,11,R,EN_D1,Carrow Road,Norwich
1994/95,36,26,Leicester City,21,41,6,10,25,43,78,-35,28,21,5,6,10,28,37,-9,21,20,1,4,15,15,41,-26,7,R,EN_D1,Filbert Street,Leicester
1994/95,36,8,Ipswich Town,22,41,7,6,28,35,89,-54,27,21,5,3,13,24,34,-10,18,20,2,3,15,11,55,-44,9,R,EN_D1,Portman Road,Ipswich
1994/95,37,3,Blackburn Rovers,1,42,27,8,7,80,39,41,89,21,17,2,2,54,21,33,53,21,10,6,5,26,18,8,36,Q,EU_CL,Ewood Park,Blackburn
1994/95,37,12,Manchester United,2,42,26,10,6,77,28,49,88,21,16,4,1,42,4,38,52,21,10,6,5,35,24,11,36,Q,EU_UC,Old Trafford,Manchester
1994/95,37,15,Nottingham Forest,3,42,22,11,9,72,43,29,77,21,12,6,3,36,18,18,42,21,10,5,6,36,25,11,35,Q,EU_UC,City Ground,Nottingham
1994/95,37,10,Liverpool,4,42,21,11,10,65,37,28,74,21,13,5,3,38,13,25,44,21,8,6,7,27,24,3,30,Q,EU_UC,Anfield,Liverpool
1994/95,37,9,Leeds United,5,42,20,13,9,59,38,21,73,21,13,5,3,35,15,20,44,21,7,8,6,24,23,1,29,Q,EU_UC,Elland Road,Leeds
1994/95,37,23,Newcastle United,6,42,20,12,10,67,47,20,72,21,14,6,1,46,20,26,48,21,6,6,9,21,27,-6,24,,,St. James' Park,Newcastle
1994/95,37,21,Tottenham Hotspur,7,42,16,14,12,66,58,8,62,21,10,5,6,32,25,7,35,21,6,9,6,34,33,1,27,,,White Hart Lane,London
1994/95,37,17,Queens Park Rangers,8,42,17,9,16,61,59,2,60,21,11,3,7,36,26,10,36,21,6,6,9,25,33,-8,24,,,Loftus Road,London
1994/95,37,22,Wimbledon,9,42,15,11,16,48,65,-17,56,21,9,5,7,26,26,0,32,21,6,6,9,22,39,-17,24,,,Selhurst Park,London
1994/95,37,20,Southampton,10,42,12,18,12,61,63,-2,54,21,8,9,4,33,27,6,33,21,4,9,8,28,36,-8,21,,,The Dell,Southampton
1994/95,37,4,Chelsea,11,42,13,15,14,50,55,-5,54,21,7,7,7,25,22,3,28,21,6,8,7,25,33,-8,26,,,Stamford Bridge,London
1994/95,37,1,Arsenal,12,42,13,12,17,52,49,3,51,21,6,9,6,27,21,6,27,21,7,3,11,25,28,-3,24,,,Highbury,London
1994/95,37,19,Sheffield Wednesday,13,42,13,12,17,49,57,-8,51,21,7,7,7,26,26,0,28,21,6,5,10,23,31,-8,23,,,Hillsborough,Sheffield
1994/95,37,25,West Ham United,14,42,13,11,18,44,48,-4,50,21,9,6,6,28,19,9,33,21,4,5,12,16,29,-13,17,,,Boleyn Ground,London
1994/95,37,7,Everton,15,42,11,17,14,44,51,-7,50,21,8,9,4,31,23,8,33,21,3,8,10,13,28,-15,17,Q,EU_CWC,Goodison Park,Liverpool
1994/95,37,5,Coventry City,16,42,12,14,16,44,62,-18,50,21,7,7,7,23,25,-2,28,21,5,7,9,21,37,-16,22,,,Highfield Road,Coventry
1994/95,37,11,Manchester City,17,42,12,13,17,53,64,-11,49,21,8,7,6,37,28,9,31,21,4,6,11,16,36,-20,18,,,Maine Road,Manchester
1994/95,37,2,Aston Villa,18,42,11,15,16,51,56,-5,48,21,6,9,6,27,24,3,27,21,5,6,10,24,32,-8,21,,,Villa Park,Birmingham
1994/95,37,6,Crystal Palace,19,42,11,12,19,34,49,-15,45,21,6,6,9,16,23,-7,24,21,5,6,10,18,26,-8,21,R,EN_D1,Selhurst Park,London
1994/95,37,14,Norwich City,20,42,10,13,19,37,54,-17,43,21,8,8,5,27,21,6,32,21,2,5,14,10,33,-23,11,R,EN_D1,Carrow Road,Norwich
1994/95,37,26,Leicester City,21,42,6,11,25,45,80,-35,29,21,5,6,10,28,37,-9,21,21,1,5,15,17,43,-26,8,R,EN_D1,Filbert Street,Leicester
1994/95,37,8,Ipswich Town,22,42,7,6,29,36,93,-57,27,21,5,3,13,24,34,-10,18,21,2,3,16,12,59,-47,9,R,EN_D1,Portman Road,Ipswich
1994/95,38,3,Blackburn Rovers,1,42,27,8,7,80,39,41,89,21,17,2,2,54,21,33,53,21,10,6,5,26,18,8,36,Q,EU_CL,Ewood Park,Blackburn
1994/95,38,12,Manchester United,2,42,26,10,6,77,28,49,88,21,16,4,1,42,4,38,52,21,10,6,5,35,24,11,36,Q,EU_UC,Old Trafford,Manchester
1994/95,38,15,Nottingham Forest,3,42,22,11,9,72,43,29,77,21,12,6,3,36,18,18,42,21,10,5,6,36,25,11,35,Q,EU_UC,City Ground,Nottingham
1994/95,38,10,Liverpool,4,42,21,11,10,65,37,28,74,21,13,5,3,38,13,25,44,21,8,6,7,27,24,3,30,Q,EU_UC,Anfield,Liverpool
1994/95,38,9,Leeds United,5,42,20,13,9,59,38,21,73,21,13,5,3,35,15,20,44,21,7,8,6,24,23,1,29,Q,EU_UC,Elland Road,Leeds
1994/95,38,23,Newcastle United,6,42,20,12,10,67,47,20,72,21,14,6,1,46,20,26,48,21,6,6,9,21,27,-6,24,,,St. James' Park,Newcastle
1994/95,38,21,Tottenham Hotspur,7,42,16,14,12,66,58,8,62,21,10,5,6,32,25,7,35,21,6,9,6,34,33,1,27,,,White Hart Lane,London
1994/95,38,17,Queens Park Rangers,8,42,17,9,16,61,59,2,60,21,11,3,7,36,26,10,36,21,6,6,9,25,33,-8,24,,,Loftus Road,London
1994/95,38,22,Wimbledon,9,42,15,11,16,48,65,-17,56,21,9,5,7,26,26,0,32,21,6,6,9,22,39,-17,24,,,Selhurst Park,London
1994/95,38,20,Southampton,10,42,12,18,12,61,63,-2,54,21,8,9,4,33,27,6,33,21,4,9,8,28,36,-8,21,,,The Dell,Southampton
1994/95,38,4,Chelsea,11,42,13,15,14,50,55,-5,54,21,7,7,7,25,22,3,28,21,6,8,7,25,33,-8,26,,,Stamford Bridge,London
1994/95,38,1,Arsenal,12,42,13,12,17,52,49,3,51,21,6,9,6,27,21,6,27,21,7,3,11,25,28,-3,24,,,Highbury,London
1994/95,38,19,Sheffield Wednesday,13,42,13,12,17,49,57,-8,51,21,7,7,7,26,26,0,28,21,6,5,10,23,31,-8,23,,,Hillsborough,Sheffield
1994/95,38,25,West Ham United,14,42,13,11,18,44,48,-4,50,21,9,6,6,28,19,9,33,21,4,5,12,16,29,-13,17,,,Boleyn Ground,London
1994/95,38,7,Everton,15,42,11,17,14,44,51,-7,50,21,8,9,4,31,23,8,33,21,3,8,10,13,28,-15,17,Q,EU_CWC,Goodison Park,Liverpool
1994/95,38,5,Coventry City,16,42,12,14,16,44,62,-18,50,21,7,7,7,23,25,-2,28,21,5,7,9,21,37,-16,22,,,Highfield Road,Coventry
1994/95,38,11,Manchester City,17,42,12,13,17,53,64,-11,49,21,8,7,6,37,28,9,31,21,4,6,11,16,36,-20,18,,,Maine Road,Manchester
1994/95,38,2,Aston Villa,18,42,11,15,16,51,56,-5,48,21,6,9,6,27,24,3,27,21,5,6,10,24,32,-8,21,,,Villa Park,Birmingham
1994/95,38,6,Crystal Palace,19,42,11,12,19,34,49,-15,45,21,6,6,9,16,23,-7,24,21,5,6,10,18,26,-8,21,R,EN_D1,Selhurst Park,London
1994/95,38,14,Norwich City,20,42,10,13,19,37,54,-17,43,21,8,8,5,27,21,6,32,21,2,5,14,10,33,-23,11,R,EN_D1,Carrow Road,Norwich
1994/95,38,26,Leicester City,21,42,6,11,25,45,80,-35,29,21,5,6,10,28,37,-9,21,21,1,5,15,17,43,-26,8,R,EN_D1,Filbert Street,Leicester
1994/95,38,8,Ipswich Town,22,42,7,6,29,36,93,-57,27,21,5,3,13,24,34,-10,18,21,2,3,16,12,59,-47,9,R,EN_D1,Portman Road,Ipswich
