season,match_week,team_id,team_name,position,played,won,drawn,lost,goals_for,goals_against,goal_difference,points,home_played,home_won,home_drawn,home_lost,home_goals_for,home_goals_against,home_goal_difference,home_points,away_played,away_won,away_drawn,away_lost,away_goals_for,away_goals_against,away_goal_difference,away_points,annotation_types,annotation_destinations,stadium_name,stadium_city
1995/96,1,23,Newcastle United,1,2,2,0,0,6,1,5,6,1,1,0,0,3,0,3,3,1,1,0,0,3,1,2,3,Q,EU_CL,St. James' Park,Newcastle
1995/96,1,22,Wimbledon,2,2,2,0,0,6,2,4,6,1,1,0,0,3,2,1,3,1,1,0,0,3,0,3,3,Q,EU_UC,Selhurst Park,London
1995/96,1,2,Aston Villa,3,2,2,0,0,4,1,3,6,1,1,0,0,3,1,2,3,1,1,0,0,1,0,1,3,,,Villa Park,Birmingham
1995/96,1,9,Leeds United,4,2,2,0,0,3,1,2,6,1,1,0,0,1,0,1,3,1,1,0,0,2,1,1,3,Q,EU_UC,Elland Road,Leeds
1995/96,1,1,Arsenal,5,2,1,1,0,3,1,2,4,1,0,1,0,1,1,0,1,1,1,0,0,2,0,2,3,Q,EU_UC,Highbury,London
1995/96,1,15,Nottingham Forest,6,2,1,1,0,4,3,1,4,1,0,1,0,0,0,0,1,1,1,0,0,4,3,1,3,,,City Ground,Nottingham
1995/96,1,3,Blackburn Rovers,7,2,1,0,1,2,2,0,3,1,1,0,0,1,0,1,3,1,0,0,1,1,2,-1,0,,,Ewood Park,Blackburn
1995/96,1,19,Sheffield Wednesday,8,2,1,0,1,2,2,0,3,1,1,0,0,2,1,1,3,1,0,0,1,0,1,-1,0,,,Hillsborough,Sheffield
1995/96,1,10,Liverpool,9,2,1,0,1,1,1,0,3,1,1,0,0,1,0,1,3,1,0,0,1,0,1,-1,0,Q,EU_CWC,Anfield,Liverpool
1995/96,1,12,Manchester United,10,2,1,0,1,3,4,-1,3,1,1,0,0,2,1,1,3,1,0,0,1,1,3,-2,0,,,Old Trafford,Manchester
1995/96,1,5,Coventry City,11,2,1,0,1,2,4,-2,3,1,1,0,0,2,1,1,3,1,0,0,1,0,3,-3,0,,,Highfield Road,Coventry
1995/96,1,4,Chelsea,12,2,0,2,0,0,0,0,2,1,0,1,0,0,0,0,1,1,0,1,0,0,0,0,1,,,Stamford Bridge,London
1995/96,1,13,Middlesbrough,13,1,0,1,0,1,1,0,1,0,0,0,0,0,0,0,0,1,0,1,0,1,1,0,1,,,Riverside Stadium,Middlesbrough
1995/96,1,11,Manchester City,14,2,0,1,1,2,3,-1,1,1,0,1,0,1,1,0,1,1,0,0,1,1,2,-1,0,,,Maine Road,Manchester
1995/96,1,21,Tottenham Hotspur,15,2,0,1,1,1,2,-1,1,1,0,0,1,0,1,-1,0,1,0,1,0,1,1,0,1,,,White Hart Lane,London
1995/96,1,7,Everton,16,2,0,1,1,0,2,-2,1,1,0,0,1,0,2,-2,0,1,0,1,0,0,0,0,1,,,Goodison Park,Liverpool
1995/96,1,20,Southampton,17,1,0,0,1,3,4,-1,0,1,0,0,1,3,4,-1,0,0,0,0,0,0,0,0,0,,,The Dell,Southampton
1995/96,1,25,West Ham United,18,2,0,0,2,2,4,-2,0,1,0,0,1,1,2,-1,0,1,0,0,1,1,2,-1,0,R,EN_D1,Boleyn Ground,London
1995/96,1,27,Bolton Wanderers,19,2,0,0,2,3,6,-3,0,1,0,0,1,1,3,-2,0,1,0,0,1,2,3,-1,0,R,EN_D1,Burnden Park,Bolton
1995/96,1,17,Queens Park Rangers,20,2,0,0,2,0,4,-4,0,1,0,0,1,0,3,-3,0,1,0,0,1,0,1,-1,0,R,EN_D1,Loftus Road,London
1995/96,2,23,Newcastle United,1,4,4,0,0,9,1,8,12,2,2,0,0,4,0,4,6,2,2,0,0,5,1,4,6,Q,EU_CL,St. James' Park,Newcastle
1995/96,2,9,Leeds United,2,4,3,1,0,6,2,4,10,2,2,0,0,3,0,3,6,2,1,1,0,3,2,1,4,Q,EU_UC,Elland Road,Leeds
1995/96,2,10,Liverpool,3,4,3,0,1,5,2,3,9,2,2,0,0,2,0,2,6,2,1,0,1,3,2,1,3,Q,EU_CWC,Anfield,Liverpool
1995/96,2,12,Manchester United,4,4,3,0,1,8,6,2,9,2,2,0,0,5,2,3,6,2,1,0,1,3,4,-1,3,Q,EU_UC,Old Trafford,Manchester
1995/96,2,2,Aston Villa,5,4,3,0,1,5,3,2,9,2,2,0,0,4,1,3,6,2,1,0,1,1,2,-1,3,Q,EU_UC,Villa Park,Birmingham
1995/96,2,22,Wimbledon,6,4,2,1,1,9,7,2,7,2,1,1,0,5,4,1,4,2,1,0,1,4,3,1,3,,,Selhurst Park,London
1995/96,2,7,Everton,7,4,2,1,1,4,2,2,7,2,1,0,1,2,2,0,3,2,1,1,0,2,0,2,4,,,Goodison Park,Liverpool
1995/96,2,1,Arsenal,8,4,1,3,0,4,2,2,6,2,0,2,0,2,2,0,2,2,1,1,0,2,0,2,4,,,Highbury,London
1995/96,2,15,Nottingham Forest,9,4,1,3,0,6,5,1,6,2,0,2,0,1,1,0,2,2,1,1,0,5,4,1,4,,,City Ground,Nottingham
1995/96,2,5,Coventry City,10,4,1,2,1,4,6,-2,5,2,1,1,0,2,1,1,4,2,0,1,1,2,5,-3,1,,,Highfield Road,Coventry
1995/96,2,13,Middlesbrough,11,3,1,1,1,3,2,1,4,1,1,0,0,2,0,2,3,2,0,1,1,1,2,-1,1,,,Riverside Stadium,Middlesbrough
1995/96,2,19,Sheffield Wednesday,12,4,1,1,2,4,6,-2,4,2,1,0,1,2,3,-1,3,2,0,1,1,2,3,-1,1,,,Hillsborough,Sheffield
1995/96,2,3,Blackburn Rovers,13,4,1,0,3,4,6,-2,3,2,1,0,1,2,2,0,3,2,0,0,2,2,4,-2,0,,,Ewood Park,Blackburn
1995/96,2,4,Chelsea,14,4,0,3,1,2,4,-2,3,2,0,2,0,2,2,0,2,2,0,1,1,0,2,-2,1,,,Stamford Bridge,London
1995/96,2,27,Bolton Wanderers,15,4,1,0,3,5,8,-3,3,2,1,0,1,3,4,-1,3,2,0,0,2,2,4,-2,0,,,Burnden Park,Bolton
1995/96,2,17,Queens Park Rangers,16,4,1,0,3,1,5,-4,3,2,1,0,1,1,3,-2,3,2,0,0,2,0,2,-2,0,,,Loftus Road,London
1995/96,2,25,West Ham United,17,4,0,2,2,4,6,-2,2,2,0,1,1,2,3,-1,1,2,0,1,1,2,3,-1,1,,,Boleyn Ground,London
1995/96,2,21,Tottenham Hotspur,18,4,0,2,2,3,6,-3,2,2,0,0,2,1,4,-3,0,2,0,2,0,2,2,0,2,R,EN_D1,White Hart Lane,London
1995/96,2,20,Southampton,19,3,0,1,2,4,7,-3,1,2,0,1,1,4,5,-1,1,1,0,0,1,0,2,-2,0,R,EN_D1,The Dell,Southampton
1995/96,2,11,Manchester City,20,4,0,1,3,2,6,-4,1,2,0,1,1,1,3,-2,1,2,0,0,2,1,3,-2,0,R,EN_D1,Maine Road,Manchester
1995/96,3,23,Newcastle United,1,5,4,0,1,9,2,7,12,2,2,0,0,4,0,4,6,3,2,0,1,5,2,3,6,Q,EU_CL,St. James' Park,Newcastle
1995/96,3,12,Manchester United,2,5,4,0,1,11,8,3,12,2,2,0,0,5,2,3,6,3,2,0,1,6,6,0,6,Q,EU_UC,Old Trafford,Manchester
1995/96,3,22,Wimbledon,3,5,3,1,1,10,7,3,10,3,2,1,0,6,4,2,7,2,1,0,1,4,3,1,3,,,Selhurst Park,London
1995/96,3,9,Leeds United,4,5,3,1,1,7,4,3,10,2,2,0,0,3,0,3,6,3,1,1,1,4,4,0,4,Q,EU_UC,Elland Road,Leeds
1995/96,3,2,Aston Villa,5,5,3,1,1,6,4,2,10,2,2,0,0,4,1,3,6,3,1,1,1,2,3,-1,4,Q,EU_UC,Villa Park,Birmingham
1995/96,3,1,Arsenal,6,5,2,3,0,5,2,3,9,2,0,2,0,2,2,0,2,3,2,1,0,3,0,3,7,,,Highbury,London
1995/96,3,10,Liverpool,7,5,3,0,2,5,3,2,9,2,2,0,0,2,0,2,6,3,1,0,2,3,3,0,3,Q,EU_CWC,Anfield,Liverpool
1995/96,3,15,Nottingham Forest,8,5,1,4,0,7,6,1,7,2,0,2,0,1,1,0,2,3,1,2,0,6,5,1,5,,,City Ground,Nottingham
1995/96,3,19,Sheffield Wednesday,9,5,2,1,2,7,6,1,7,2,1,0,1,2,3,-1,3,3,1,1,1,5,3,2,4,,,Hillsborough,Sheffield
1995/96,3,7,Everton,10,5,2,1,2,6,5,1,7,3,1,0,2,4,5,-1,3,2,1,1,0,2,0,2,4,,,Goodison Park,Liverpool
1995/96,3,13,Middlesbrough,11,5,1,3,1,4,3,1,6,2,1,1,0,2,0,2,4,3,0,2,1,2,3,-1,2,,,Riverside Stadium,Middlesbrough
1995/96,3,4,Chelsea,12,5,1,3,1,5,5,0,6,2,0,2,0,2,2,0,2,3,1,1,1,3,3,0,4,,,Stamford Bridge,London
1995/96,3,5,Coventry City,13,5,1,3,1,5,7,-2,6,3,1,2,0,3,2,1,5,2,0,1,1,2,5,-3,1,,,Highfield Road,Coventry
1995/96,3,20,Southampton,14,5,1,2,2,5,7,-2,5,3,1,1,1,5,5,0,4,2,0,1,1,0,2,-2,1,,,The Dell,Southampton
1995/96,3,21,Tottenham Hotspur,15,5,1,2,2,5,7,-2,5,3,1,0,2,3,5,-2,3,2,0,2,0,2,2,0,2,,,White Hart Lane,London
1995/96,3,3,Blackburn Rovers,16,5,1,1,3,5,7,-2,4,3,1,1,1,3,3,0,4,2,0,0,2,2,4,-2,0,,,Ewood Park,Blackburn
1995/96,3,27,Bolton Wanderers,17,5,1,1,3,6,9,-3,4,3,1,1,1,4,5,-1,4,2,0,0,2,2,4,-2,0,,,Burnden Park,Bolton
1995/96,3,17,Queens Park Rangers,18,5,1,0,4,1,8,-7,3,3,1,0,2,1,6,-5,3,2,0,0,2,0,2,-2,0,R,EN_D1,Loftus Road,London
1995/96,3,25,West Ham United,19,5,0,2,3,5,9,-4,2,3,0,1,2,3,6,-3,1,2,0,1,1,2,3,-1,1,R,EN_D1,Boleyn Ground,London
1995/96,3,11,Manchester City,20,5,0,1,4,2,7,-5,1,3,0,1,2,1,4,-3,1,2,0,0,2,1,3,-2,0,R,EN_D1,Maine Road,Manchester
1995/96,4,23,Newcastle United,1,6,5,0,1,12,3,9,15,3,3,0,0,7,1,6,9,3,2,0,1,5,2,3,6,Q,EU_CL,St. James' Park,Newcastle
1995/96,4,12,Manchester United,2,6,5,0,1,14,8,6,15,3,3,0,0,8,2,6,9,3,2,0,1,6,6,0,6,Q,EU_UC,Old Trafford,Manchester
1995/96,4,2,Aston Villa,3,6,4,1,1,8,4,4,13,3,3,0,0,6,1,5,9,3,1,1,1,2,3,-1,4,,,Villa Park,Birmingham
1995/96,4,10,Liverpool,4,6,4,0,2,8,3,5,12,3,3,0,0,5,0,5,9,3,1,0,2,3,3,0,3,"Q,Q","EU_CWC,EU_UC",Anfield,Liverpool
1995/96,4,1,Arsenal,5,6,3,3,0,6,2,4,12,3,1,2,0,3,2,1,5,3,2,1,0,3,0,3,7,Q,EU_UC,Highbury,London
1995/96,4,15,Nottingham Forest,6,6,2,4,0,10,8,2,10,3,1,2,0,4,3,1,5,3,1,2,0,6,5,1,5,,,City Ground,Nottingham
1995/96,4,22,Wimbledon,7,6,3,1,2,10,9,1,10,3,2,1,0,6,4,2,7,3,1,0,2,4,5,-1,3,,,Selhurst Park,London
1995/96,4,9,Leeds United,8,6,3,1,2,8,7,1,10,3,2,0,1,4,3,1,6,3,1,1,1,4,4,0,4,,,Elland Road,Leeds
1995/96,4,4,Chelsea,9,6,2,3,1,8,5,3,9,3,1,2,0,5,2,3,5,3,1,1,1,3,3,0,4,,,Stamford Bridge,London
1995/96,4,13,Middlesbrough,10,6,2,3,1,6,4,2,9,3,2,1,0,4,1,3,7,3,0,2,1,2,3,-1,2,,,Riverside Stadium,Middlesbrough
1995/96,4,21,Tottenham Hotspur,11,6,2,2,2,8,8,0,8,3,1,0,2,3,5,-2,3,3,1,2,0,5,3,2,5,,,White Hart Lane,London
1995/96,4,7,Everton,12,6,2,1,3,8,8,0,7,3,1,0,2,4,5,-1,3,3,1,1,1,4,3,1,4,,,Goodison Park,Liverpool
1995/96,4,19,Sheffield Wednesday,13,6,2,1,3,8,9,-1,7,3,1,0,2,3,6,-3,3,3,1,1,1,5,3,2,4,,,Hillsborough,Sheffield
1995/96,4,5,Coventry City,14,6,1,3,2,6,9,-3,6,3,1,2,0,3,2,1,5,3,0,1,2,3,7,-4,1,,,Highfield Road,Coventry
1995/96,4,17,Queens Park Rangers,15,6,2,0,4,4,9,-5,6,3,1,0,2,1,6,-5,3,3,1,0,2,3,3,0,3,,,Loftus Road,London
1995/96,4,20,Southampton,16,6,1,2,3,5,10,-5,5,3,1,1,1,5,5,0,4,3,0,1,2,0,5,-5,1,,,The Dell,Southampton
1995/96,4,3,Blackburn Rovers,17,6,1,1,4,5,10,-5,4,3,1,1,1,3,3,0,4,3,0,0,3,2,7,-5,0,,,Ewood Park,Blackburn
1995/96,4,27,Bolton Wanderers,18,6,1,1,4,6,12,-6,4,3,1,1,1,4,5,-1,4,3,0,0,3,2,7,-5,0,R,EN_D1,Burnden Park,Bolton
1995/96,4,25,West Ham United,19,6,0,2,4,5,10,-5,2,3,0,1,2,3,6,-3,1,3,0,1,2,2,4,-2,1,R,EN_D1,Boleyn Ground,London
1995/96,4,11,Manchester City,20,6,0,1,5,3,10,-7,1,3,0,1,2,1,4,-3,1,3,0,0,3,2,6,-4,0,R,EN_D1,Maine Road,Manchester
1995/96,5,23,Newcastle United,1,7,6,0,1,14,3,11,18,4,4,0,0,9,1,8,12,3,2,0,1,5,2,3,6,Q,EU_CL,St. James' Park,Newcastle
1995/96,5,12,Manchester United,2,7,5,1,1,14,8,6,16,3,3,0,0,8,2,6,9,4,2,1,1,6,6,0,7,Q,EU_UC,Old Trafford,Manchester
1995/96,5,10,Liverpool,3,7,5,0,2,13,5,8,15,4,4,0,0,10,2,8,12,3,1,0,2,3,3,0,3,Q,EU_CWC,Anfield,Liverpool
1995/96,5,1,Arsenal,4,7,4,3,0,10,4,6,15,4,2,2,0,7,4,3,8,3,2,1,0,3,0,3,7,Q,EU_UC,Highbury,London
1995/96,5,2,Aston Villa,5,7,4,2,1,9,5,4,14,4,3,1,0,7,2,5,10,3,1,1,1,2,3,-1,4,Q,EU_UC,Villa Park,Birmingham
1995/96,5,9,Leeds United,6,7,4,1,2,12,9,3,13,3,2,0,1,4,3,1,6,4,2,1,1,8,6,2,7,,,Elland Road,Leeds
1995/96,5,13,Middlesbrough,7,7,3,3,1,7,4,3,12,3,2,1,0,4,1,3,7,4,1,2,1,3,3,0,5,,,Riverside Stadium,Middlesbrough
1995/96,5,15,Nottingham Forest,8,7,2,5,0,11,9,2,11,3,1,2,0,4,3,1,5,4,1,3,0,7,6,1,6,,,City Ground,Nottingham
1995/96,5,21,Tottenham Hotspur,9,7,3,2,2,11,10,1,11,3,1,0,2,3,5,-2,3,4,2,2,0,8,5,3,8,,,White Hart Lane,London
1995/96,5,22,Wimbledon,10,7,3,1,3,12,13,-1,10,4,2,1,1,8,8,0,7,3,1,0,2,4,5,-1,3,,,Selhurst Park,London
1995/96,5,4,Chelsea,11,7,2,3,2,8,7,1,9,3,1,2,0,5,2,3,5,4,1,1,2,3,5,-2,4,,,Stamford Bridge,London
1995/96,5,19,Sheffield Wednesday,12,7,2,2,3,8,9,-1,8,4,1,1,2,3,6,-3,4,3,1,1,1,5,3,2,4,,,Hillsborough,Sheffield
1995/96,5,3,Blackburn Rovers,13,7,2,1,4,10,11,-1,7,4,2,1,1,8,4,4,7,3,0,0,3,2,7,-5,0,,,Ewood Park,Blackburn
1995/96,5,7,Everton,14,7,2,1,4,9,10,-1,7,3,1,0,2,4,5,-1,3,4,1,1,2,5,5,0,4,,,Goodison Park,Liverpool
1995/96,5,17,Queens Park Rangers,15,7,2,0,5,6,12,-6,6,4,1,0,3,3,9,-6,3,3,1,0,2,3,3,0,3,,,Loftus Road,London
1995/96,5,5,Coventry City,16,7,1,3,3,7,14,-7,6,3,1,2,0,3,2,1,5,4,0,1,3,4,12,-8,1,,,Highfield Road,Coventry
1995/96,5,25,West Ham United,17,7,1,2,4,7,11,-4,5,4,1,1,2,5,7,-2,4,3,0,1,2,2,4,-2,1,,,Boleyn Ground,London
1995/96,5,20,Southampton,18,7,1,2,4,7,14,-7,5,3,1,1,1,5,5,0,4,4,0,1,3,2,9,-7,1,R,EN_D1,The Dell,Southampton
1995/96,5,27,Bolton Wanderers,19,7,1,1,5,8,17,-9,4,3,1,1,1,4,5,-1,4,4,0,0,4,4,12,-8,0,R,EN_D1,Burnden Park,Bolton
1995/96,5,11,Manchester City,20,7,0,1,6,3,11,-8,1,4,0,1,3,1,5,-4,1,3,0,0,3,2,6,-4,0,R,EN_D1,Maine Road,Manchester
1995/96,6,23,Newcastle United,1,8,7,0,1,17,4,13,21,4,4,0,0,9,1,8,12,4,3,0,1,8,3,5,9,Q,EU_CL,St. James' Park,Newcastle
1995/96,6,2,Aston Villa,2,8,5,2,1,12,5,7,17,4,3,1,0,7,2,5,10,4,2,1,1,5,3,2,7,Q,EU_UC,Villa Park,Birmingham
1995/96,6,12,Manchester United,3,8,5,2,1,16,10,6,17,4,3,1,0,10,4,6,10,4,2,1,1,6,6,0,7,,,Old Trafford,Manchester
1995/96,6,10,Liverpool,4,8,5,1,2,15,7,8,16,4,4,0,0,10,2,8,12,4,1,1,2,5,5,0,4,"Q,Q","EU_CWC,EU_UC",Anfield,Liverpool
1995/96,6,9,Leeds United,5,8,5,1,2,14,9,5,16,4,3,0,1,6,3,3,9,4,2,1,1,8,6,2,7,Q,EU_UC,Elland Road,Leeds
1995/96,6,1,Arsenal,6,8,4,3,1,10,5,5,15,4,2,2,0,7,4,3,8,4,2,1,1,3,1,2,7,,,Highbury,London
1995/96,6,13,Middlesbrough,7,8,4,3,1,9,4,5,15,4,3,1,0,6,1,5,10,4,1,2,1,3,3,0,5,,,Riverside Stadium,Middlesbrough
1995/96,6,15,Nottingham Forest,8,8,3,5,0,14,9,5,14,4,2,2,0,7,3,4,8,4,1,3,0,7,6,1,6,,,City Ground,Nottingham
1995/96,6,21,Tottenham Hotspur,9,8,4,2,2,14,11,3,14,4,2,0,2,6,6,0,6,4,2,2,0,8,5,3,8,,,White Hart Lane,London
1995/96,6,4,Chelsea,10,8,3,3,2,9,7,2,12,4,2,2,0,6,2,4,8,4,1,1,2,3,5,-2,4,,,Stamford Bridge,London
1995/96,6,22,Wimbledon,11,8,3,1,4,13,16,-3,10,4,2,1,1,8,8,0,7,4,1,0,3,5,8,-3,3,,,Selhurst Park,London
1995/96,6,17,Queens Park Rangers,12,8,3,0,5,7,12,-5,9,4,1,0,3,3,9,-6,3,4,2,0,2,4,3,1,6,,,Loftus Road,London
1995/96,6,19,Sheffield Wednesday,13,8,2,2,4,8,11,-3,8,4,1,1,2,3,6,-3,4,4,1,1,2,5,5,0,4,,,Hillsborough,Sheffield
1995/96,6,3,Blackburn Rovers,14,8,2,1,5,10,13,-3,7,4,2,1,1,8,4,4,7,4,0,0,4,2,9,-7,0,,,Ewood Park,Blackburn
1995/96,6,7,Everton,15,8,2,1,5,10,13,-3,7,4,1,0,3,5,8,-3,3,4,1,1,2,5,5,0,4,,,Goodison Park,Liverpool
1995/96,6,25,West Ham United,16,8,1,3,4,7,11,-4,6,4,1,1,2,5,7,-2,4,4,0,2,2,2,4,-2,2,,,Boleyn Ground,London
1995/96,6,20,Southampton,17,8,1,3,4,7,14,-7,6,4,1,2,1,5,5,0,5,4,0,1,3,2,9,-7,1,,,The Dell,Southampton
1995/96,6,5,Coventry City,18,8,1,3,4,7,17,-10,6,4,1,2,1,3,5,-2,5,4,0,1,3,4,12,-8,1,R,EN_D1,Highfield Road,Coventry
1995/96,6,27,Bolton Wanderers,19,8,1,1,6,8,18,-10,4,4,1,1,2,4,6,-2,4,4,0,0,4,4,12,-8,0,R,EN_D1,Burnden Park,Bolton
1995/96,6,11,Manchester City,20,8,0,1,7,3,14,-11,1,4,0,1,3,1,5,-4,1,4,0,0,4,2,9,-7,0,R,EN_D1,Maine Road,Manchester
1995/96,7,23,Newcastle United,1,9,8,0,1,20,6,14,24,4,4,0,0,9,1,8,12,5,4,0,1,11,5,6,12,Q,EU_CL,St. James' Park,Newcastle
1995/96,7,12,Manchester United,2,9,6,2,1,17,10,7,20,5,4,1,0,11,4,7,13,4,2,1,1,6,6,0,7,Q,EU_UC,Old Trafford,Manchester
1995/96,7,1,Arsenal,3,9,5,3,1,13,5,8,18,4,2,2,0,7,4,3,8,5,3,1,1,6,1,5,10,,,Highbury,London
1995/96,7,13,Middlesbrough,4,9,5,3,1,10,4,6,18,4,3,1,0,6,1,5,10,5,2,2,1,4,3,1,8,Q,EU_UC,Riverside Stadium,Middlesbrough
1995/96,7,10,Liverpool,5,9,5,2,2,15,7,8,17,5,4,1,0,10,2,8,13,4,1,1,2,5,5,0,4,"Q,Q","EU_CWC,EU_UC",Anfield,Liverpool
1995/96,7,15,Nottingham Forest,6,9,4,5,0,15,9,6,17,4,2,2,0,7,3,4,8,5,2,3,0,8,6,2,9,,,City Ground,Nottingham
1995/96,7,2,Aston Villa,7,9,5,2,2,12,6,6,17,5,3,1,1,7,3,4,10,4,2,1,1,5,3,2,7,,,Villa Park,Birmingham
1995/96,7,9,Leeds United,8,9,5,1,3,14,12,2,16,5,3,0,2,6,6,0,9,4,2,1,1,8,6,2,7,,,Elland Road,Leeds
1995/96,7,4,Chelsea,9,9,4,3,2,10,7,3,15,4,2,2,0,6,2,4,8,5,2,1,2,4,5,-1,7,,,Stamford Bridge,London
1995/96,7,21,Tottenham Hotspur,10,9,4,2,3,14,12,2,14,5,2,0,3,6,7,-1,6,4,2,2,0,8,5,3,8,,,White Hart Lane,London
1995/96,7,3,Blackburn Rovers,11,9,3,1,5,12,14,-2,10,5,3,1,1,10,5,5,10,4,0,0,4,2,9,-7,0,,,Ewood Park,Blackburn
1995/96,7,22,Wimbledon,12,9,3,1,5,13,17,-4,10,5,2,1,2,8,9,-1,7,4,1,0,3,5,8,-3,3,,,Selhurst Park,London
1995/96,7,25,West Ham United,13,9,2,3,4,8,11,-3,9,4,1,1,2,5,7,-2,4,5,1,2,2,3,4,-1,5,,,Boleyn Ground,London
1995/96,7,17,Queens Park Rangers,14,9,3,0,6,9,15,-6,9,5,1,0,4,5,12,-7,3,4,2,0,2,4,3,1,6,,,Loftus Road,London
1995/96,7,7,Everton,15,9,2,2,5,11,14,-3,8,4,1,0,3,5,8,-3,3,5,1,2,2,6,6,0,5,,,Goodison Park,Liverpool
1995/96,7,19,Sheffield Wednesday,16,9,2,2,5,8,12,-4,8,5,1,1,3,3,7,-4,4,4,1,1,2,5,5,0,4,,,Hillsborough,Sheffield
1995/96,7,5,Coventry City,17,9,1,4,4,7,17,-10,7,4,1,2,1,3,5,-2,5,5,0,2,3,4,12,-8,2,,,Highfield Road,Coventry
1995/96,7,20,Southampton,18,9,1,3,5,8,16,-8,6,4,1,2,1,5,5,0,5,5,0,1,4,3,11,-8,1,R,EN_D1,The Dell,Southampton
1995/96,7,27,Bolton Wanderers,19,9,1,2,6,9,19,-10,5,5,1,2,2,5,7,-2,5,4,0,0,4,4,12,-8,0,R,EN_D1,Burnden Park,Bolton
1995/96,7,11,Manchester City,20,9,0,1,8,3,15,-12,1,4,0,1,3,1,5,-4,1,5,0,0,5,2,10,-8,0,R,EN_D1,Maine Road,Manchester
1995/96,8,23,Newcastle United,1,10,9,0,1,26,7,19,27,5,5,0,0,15,2,13,15,5,4,0,1,11,5,6,12,Q,EU_CL,St. James' Park,Newcastle
1995/96,8,12,Manchester United,2,10,7,2,1,21,11,10,23,5,4,1,0,11,4,7,13,5,3,1,1,10,7,3,10,Q,EU_UC,Old Trafford,Manchester
1995/96,8,1,Arsenal,3,10,6,3,1,15,5,10,21,5,3,2,0,9,4,5,11,5,3,1,1,6,1,5,10,,,Highbury,London
1995/96,8,13,Middlesbrough,4,10,6,3,1,11,4,7,21,5,4,1,0,7,1,6,13,5,2,2,1,4,3,1,8,Q,EU_UC,Riverside Stadium,Middlesbrough
1995/96,8,10,Liverpool,5,10,6,2,2,18,8,10,20,5,4,1,0,10,2,8,13,5,2,1,2,8,6,2,7,"Q,Q","EU_CWC,EU_UC",Anfield,Liverpool
1995/96,8,15,Nottingham Forest,6,10,5,5,0,18,11,7,20,5,3,2,0,10,5,5,11,5,2,3,0,8,6,2,9,,,City Ground,Nottingham
1995/96,8,2,Aston Villa,7,10,5,2,3,12,8,4,17,5,3,1,1,7,3,4,10,5,2,1,2,5,5,0,7,,,Villa Park,Birmingham
1995/96,8,9,Leeds United,8,10,5,2,3,14,12,2,17,5,3,0,2,6,6,0,9,5,2,2,1,8,6,2,8,,,Elland Road,Leeds
1995/96,8,21,Tottenham Hotspur,9,10,4,3,3,15,13,2,15,5,2,0,3,6,7,-1,6,5,2,3,0,9,6,3,9,,,White Hart Lane,London
1995/96,8,4,Chelsea,10,10,4,3,3,11,11,0,15,5,2,2,1,7,6,1,8,5,2,1,2,4,5,-1,7,,,Stamford Bridge,London
1995/96,8,3,Blackburn Rovers,11,10,3,2,5,13,15,-2,11,5,3,1,1,10,5,5,10,5,0,1,4,3,10,-7,1,,,Ewood Park,Blackburn
1995/96,8,19,Sheffield Wednesday,12,10,3,2,5,9,12,-3,11,5,1,1,3,3,7,-4,4,5,2,1,2,6,5,1,7,,,Hillsborough,Sheffield
1995/96,8,25,West Ham United,13,10,2,4,4,9,12,-3,10,5,1,2,2,6,8,-2,5,5,1,2,2,3,4,-1,5,,,Boleyn Ground,London
1995/96,8,22,Wimbledon,14,10,3,1,6,14,23,-9,10,5,2,1,2,8,9,-1,7,5,1,0,4,6,14,-8,3,,,Selhurst Park,London
1995/96,8,7,Everton,15,10,2,3,5,12,15,-3,9,5,1,1,3,6,9,-3,4,5,1,2,2,6,6,0,5,,,Goodison Park,Liverpool
1995/96,8,17,Queens Park Rangers,16,10,3,0,7,9,16,-7,9,5,1,0,4,5,12,-7,3,5,2,0,3,4,4,0,6,,,Loftus Road,London
1995/96,8,5,Coventry City,17,10,1,4,5,7,18,-11,7,5,1,2,2,3,6,-3,5,5,0,2,3,4,12,-8,2,,,Highfield Road,Coventry
1995/96,8,20,Southampton,18,10,1,3,6,9,19,-10,6,5,1,2,2,6,8,-2,5,5,0,1,4,3,11,-8,1,R,EN_D1,The Dell,Southampton
1995/96,8,27,Bolton Wanderers,19,10,1,2,7,11,22,-11,5,5,1,2,2,5,7,-2,5,5,0,0,5,6,15,-9,0,R,EN_D1,Burnden Park,Bolton
1995/96,8,11,Manchester City,20,10,0,2,8,3,15,-12,2,5,0,2,3,1,5,-4,2,5,0,0,5,2,10,-8,0,R,EN_D1,Maine Road,Manchester
1995/96,9,23,Newcastle United,1,11,9,1,1,27,8,19,28,5,5,0,0,15,2,13,15,6,4,1,1,12,6,6,13,Q,EU_CL,St. James' Park,Newcastle
1995/96,9,12,Manchester United,2,11,8,2,1,23,11,12,26,6,5,1,0,13,4,9,16,5,3,1,1,10,7,3,10,Q,EU_UC,Old Trafford,Manchester
1995/96,9,10,Liverpool,3,11,7,2,2,24,8,16,23,6,5,1,0,16,2,14,16,5,2,1,2,8,6,2,7,Q,EU_CWC,Anfield,Liverpool
1995/96,9,1,Arsenal,4,11,6,3,2,15,6,9,21,5,3,2,0,9,4,5,11,6,3,1,2,6,2,4,10,Q,EU_UC,Highbury,London
1995/96,9,15,Nottingham Forest,5,11,5,6,0,19,12,7,21,5,3,2,0,10,5,5,11,6,2,4,0,9,7,2,10,Q,EU_UC,City Ground,Nottingham
1995/96,9,13,Middlesbrough,6,11,6,3,2,11,6,5,21,5,4,1,0,7,1,6,13,6,2,2,2,4,5,-1,8,,,Riverside Stadium,Middlesbrough
1995/96,9,2,Aston Villa,7,11,6,2,3,13,8,5,20,6,4,1,1,8,3,5,13,5,2,1,2,5,5,0,7,,,Villa Park,Birmingham
1995/96,9,9,Leeds United,8,11,6,2,3,17,13,4,20,6,4,0,2,9,7,2,12,5,2,2,1,8,6,2,8,,,Elland Road,Leeds
1995/96,9,21,Tottenham Hotspur,9,11,4,4,3,16,14,2,16,6,2,1,3,7,8,-1,7,5,2,3,0,9,6,3,9,,,White Hart Lane,London
1995/96,9,4,Chelsea,10,11,4,3,4,11,14,-3,15,5,2,2,1,7,6,1,8,6,2,1,3,4,8,-4,7,,,Stamford Bridge,London
1995/96,9,3,Blackburn Rovers,11,11,4,2,5,16,15,1,14,6,4,1,1,13,5,8,13,5,0,1,4,3,10,-7,1,,,Ewood Park,Blackburn
1995/96,9,25,West Ham United,12,11,3,4,4,10,12,-2,13,5,1,2,2,6,8,-2,5,6,2,2,2,4,4,0,8,,,Boleyn Ground,London
1995/96,9,19,Sheffield Wednesday,13,11,3,2,6,9,13,-4,11,6,1,1,4,3,8,-5,4,5,2,1,2,6,5,1,7,,,Hillsborough,Sheffield
1995/96,9,17,Queens Park Rangers,14,11,3,1,7,10,17,-7,10,6,1,1,4,6,13,-7,4,5,2,0,3,4,4,0,6,,,Loftus Road,London
1995/96,9,22,Wimbledon,15,11,3,1,7,15,25,-10,10,6,2,1,3,9,11,-2,7,5,1,0,4,6,14,-8,3,,,Selhurst Park,London
1995/96,9,7,Everton,16,11,2,3,6,12,16,-4,9,5,1,1,3,6,9,-3,4,6,1,2,3,6,7,-1,5,,,Goodison Park,Liverpool
1995/96,9,20,Southampton,17,11,2,3,6,11,20,-9,9,5,1,2,2,6,8,-2,5,6,1,1,4,5,12,-7,4,,,The Dell,Southampton
1995/96,9,27,Bolton Wanderers,18,11,2,2,7,12,22,-10,8,6,2,2,2,6,7,-1,8,5,0,0,5,6,15,-9,0,R,EN_D1,Burnden Park,Bolton
1995/96,9,5,Coventry City,19,11,1,4,6,8,21,-13,7,5,1,2,2,3,6,-3,5,6,0,2,4,5,15,-10,2,R,EN_D1,Highfield Road,Coventry
1995/96,9,11,Manchester City,20,11,0,2,9,3,21,-18,2,5,0,2,3,1,5,-4,2,6,0,0,6,2,16,-14,0,R,EN_D1,Maine Road,Manchester
1995/96,10,23,Newcastle United,1,13,11,1,1,30,9,21,34,7,7,0,0,18,3,15,21,6,4,1,1,12,6,6,13,Q,EU_CL,St. James' Park,Newcastle
1995/96,10,12,Manchester United,2,12,8,2,2,23,12,11,26,6,5,1,0,13,4,9,16,6,3,1,2,10,8,2,10,Q,EU_UC,Old Trafford,Manchester
1995/96,10,15,Nottingham Forest,3,12,6,6,0,23,13,10,24,6,4,2,0,14,6,8,14,6,2,4,0,9,7,2,10,,,City Ground,Nottingham
1995/96,10,1,Arsenal,4,12,7,3,2,16,6,10,24,6,4,2,0,10,4,6,14,6,3,1,2,6,2,4,10,Q,EU_UC,Highbury,London
1995/96,10,10,Liverpool,5,12,7,2,3,25,10,15,23,6,5,1,0,16,2,14,16,6,2,1,3,9,8,1,7,"Q,Q","EU_CWC,EU_UC",Anfield,Liverpool
1995/96,10,2,Aston Villa,6,12,7,2,3,17,9,8,23,6,4,1,1,8,3,5,13,6,3,1,2,9,6,3,10,,,Villa Park,Birmingham
1995/96,10,13,Middlesbrough,7,12,6,4,2,12,7,5,22,6,4,2,0,8,2,6,14,6,2,2,2,4,5,-1,8,,,Riverside Stadium,Middlesbrough
1995/96,10,9,Leeds United,8,12,6,3,3,18,14,4,21,6,4,0,2,9,7,2,12,6,2,3,1,9,7,2,9,,,Elland Road,Leeds
1995/96,10,21,Tottenham Hotspur,9,12,5,4,3,19,16,3,19,6,2,1,3,7,8,-1,7,6,3,3,0,12,8,4,12,,,White Hart Lane,London
1995/96,10,4,Chelsea,10,12,4,4,4,11,14,-3,16,6,2,3,1,7,6,1,9,6,2,1,3,4,8,-4,7,,,Stamford Bridge,London
1995/96,10,3,Blackburn Rovers,11,13,4,2,7,16,17,-1,14,6,4,1,1,13,5,8,13,7,0,1,6,3,12,-9,1,,,Ewood Park,Blackburn
1995/96,10,25,West Ham United,12,12,3,4,5,11,16,-5,13,6,1,2,3,7,12,-5,5,6,2,2,2,4,4,0,8,,,Boleyn Ground,London
1995/96,10,7,Everton,13,12,3,3,6,13,16,-3,12,6,2,1,3,7,9,-2,7,6,1,2,3,6,7,-1,5,,,Goodison Park,Liverpool
1995/96,10,19,Sheffield Wednesday,14,12,3,3,6,9,13,-4,12,6,1,1,4,3,8,-5,4,6,2,2,2,6,5,1,8,,,Hillsborough,Sheffield
1995/96,10,20,Southampton,15,12,3,3,6,13,20,-7,12,6,2,2,2,8,8,0,8,6,1,1,4,5,12,-7,4,,,The Dell,Southampton
1995/96,10,17,Queens Park Rangers,16,12,3,1,8,10,19,-9,10,6,1,1,4,6,13,-7,4,6,2,0,4,4,6,-2,6,,,Loftus Road,London
1995/96,10,22,Wimbledon,17,12,3,1,8,16,29,-13,10,6,2,1,3,9,11,-2,7,6,1,0,5,7,18,-11,3,,,Selhurst Park,London
1995/96,10,27,Bolton Wanderers,18,12,2,2,8,12,23,-11,8,6,2,2,2,6,7,-1,8,6,0,0,6,6,16,-10,0,R,EN_D1,Burnden Park,Bolton
1995/96,10,5,Coventry City,19,12,1,4,7,10,24,-14,7,6,1,2,3,5,9,-4,5,6,0,2,4,5,15,-10,2,R,EN_D1,Highfield Road,Coventry
1995/96,10,11,Manchester City,20,12,1,2,9,4,21,-17,5,6,1,2,3,2,5,-3,5,6,0,0,6,2,16,-14,0,R,EN_D1,Maine Road,Manchester
1995/96,11,23,Newcastle United,1,14,11,2,1,31,10,21,35,7,7,0,0,18,3,15,21,7,4,2,1,13,7,6,14,Q,EU_CL,St. James' Park,Newcastle
1995/96,11,12,Manchester United,2,14,10,2,2,31,13,18,32,7,6,1,0,17,5,12,19,7,4,1,2,14,8,6,13,Q,EU_UC,Old Trafford,Manchester
1995/96,11,1,Arsenal,3,14,8,3,3,21,10,11,27,7,5,2,0,14,6,8,17,7,3,1,3,7,4,3,10,,,Highbury,London
1995/96,11,2,Aston Villa,4,14,8,3,3,19,10,9,27,7,4,2,1,9,4,5,14,7,4,1,2,10,6,4,13,Q,EU_UC,Villa Park,Birmingham
1995/96,11,21,Tottenham Hotspur,5,14,7,4,3,22,17,5,25,7,3,1,3,9,9,0,10,7,4,3,0,13,8,5,15,Q,EU_UC,White Hart Lane,London
1995/96,11,10,Liverpool,6,14,7,3,4,26,12,14,24,7,5,1,1,17,4,13,16,7,2,2,3,9,8,1,8,Q,EU_CWC,Anfield,Liverpool
1995/96,11,9,Leeds United,7,13,7,3,3,19,14,5,24,7,5,0,2,10,7,3,15,6,2,3,1,9,7,2,9,,,Elland Road,Leeds
1995/96,11,15,Nottingham Forest,8,13,6,6,1,23,20,3,24,6,4,2,0,14,6,8,14,7,2,4,1,9,14,-5,10,,,City Ground,Nottingham
1995/96,11,13,Middlesbrough,9,14,6,5,3,12,8,4,23,7,4,2,1,8,3,5,14,7,2,3,2,4,5,-1,9,,,Riverside Stadium,Middlesbrough
1995/96,11,4,Chelsea,10,14,5,4,5,14,17,-3,19,7,3,3,1,10,8,2,12,7,2,1,4,4,9,-5,7,,,Stamford Bridge,London
1995/96,11,7,Everton,11,14,5,3,6,17,17,0,18,7,3,1,3,9,9,0,10,7,2,2,3,8,8,0,8,,,Goodison Park,Liverpool
1995/96,11,3,Blackburn Rovers,12,14,5,2,7,23,17,6,17,7,5,1,1,20,5,15,16,7,0,1,6,3,12,-9,1,,,Ewood Park,Blackburn
1995/96,11,25,West Ham United,13,14,4,5,5,14,16,-2,17,7,1,3,3,7,12,-5,6,7,3,2,2,7,4,3,11,,,Boleyn Ground,London
1995/96,11,19,Sheffield Wednesday,14,14,3,4,7,12,18,-6,13,7,1,2,4,4,9,-5,5,7,2,2,3,8,9,-1,8,,,Hillsborough,Sheffield
1995/96,11,20,Southampton,15,14,3,3,8,14,25,-11,12,7,2,2,3,8,9,-1,8,7,1,1,5,6,16,-10,4,,,The Dell,Southampton
1995/96,11,17,Queens Park Rangers,16,14,3,2,9,11,22,-11,11,7,1,2,4,7,14,-7,5,7,2,0,5,4,8,-4,6,,,Loftus Road,London
1995/96,11,22,Wimbledon,17,14,3,2,9,16,30,-14,11,7,2,2,3,9,11,-2,8,7,1,0,6,7,19,-12,3,,,Selhurst Park,London
1995/96,11,11,Manchester City,18,14,2,3,9,6,22,-16,9,7,2,2,3,3,5,-2,8,7,0,1,6,3,17,-14,1,R,EN_D1,Maine Road,Manchester
1995/96,11,27,Bolton Wanderers,19,14,2,2,10,14,29,-15,8,7,2,2,3,6,10,-4,8,7,0,0,7,8,19,-11,0,R,EN_D1,Burnden Park,Bolton
1995/96,11,5,Coventry City,20,14,1,5,8,11,29,-18,8,7,1,2,4,5,13,-8,5,7,0,3,4,6,16,-10,3,R,EN_D1,Highfield Road,Coventry
1995/96,12,23,Newcastle United,1,15,12,2,1,33,11,22,38,8,8,0,0,20,4,16,24,7,4,2,1,13,7,6,14,Q,EU_CL,St. James' Park,Newcastle
1995/96,12,12,Manchester United,2,15,10,3,2,32,14,18,33,7,6,1,0,17,5,12,19,8,4,2,2,15,9,6,14,Q,EU_UC,Old Trafford,Manchester
1995/96,12,1,Arsenal,3,15,8,4,3,21,10,11,28,8,5,3,0,14,6,8,18,7,3,1,3,7,4,3,10,,,Highbury,London
1995/96,12,2,Aston Villa,4,15,8,3,4,19,11,8,27,7,4,2,1,9,4,5,14,8,4,1,3,10,7,3,13,Q,EU_UC,Villa Park,Birmingham
1995/96,12,21,Tottenham Hotspur,5,15,7,5,3,22,17,5,26,7,3,1,3,9,9,0,10,8,4,4,0,13,8,5,16,Q,EU_UC,White Hart Lane,London
1995/96,12,13,Middlesbrough,6,15,7,5,3,14,9,5,26,8,5,2,1,10,4,6,17,7,2,3,2,4,5,-1,9,,,Riverside Stadium,Middlesbrough
1995/96,12,15,Nottingham Forest,7,14,6,7,1,24,21,3,25,7,4,3,0,15,7,8,15,7,2,4,1,9,14,-5,10,,,City Ground,Nottingham
1995/96,12,10,Liverpool,8,15,7,3,5,27,14,13,24,7,5,1,1,17,4,13,16,8,2,2,4,10,10,0,8,Q,EU_CWC,Anfield,Liverpool
1995/96,12,9,Leeds United,9,14,7,3,4,20,16,4,24,7,5,0,2,10,7,3,15,7,2,3,2,10,9,1,9,,,Elland Road,Leeds
1995/96,12,25,West Ham United,10,15,5,5,5,15,16,-1,20,8,2,3,3,8,12,-4,9,7,3,2,2,7,4,3,11,,,Boleyn Ground,London
1995/96,12,4,Chelsea,11,15,5,5,5,14,17,-3,20,8,3,4,1,10,8,2,13,7,2,1,4,4,9,-5,7,,,Stamford Bridge,London
1995/96,12,7,Everton,12,15,5,4,6,19,19,0,19,8,3,2,3,11,11,0,11,7,2,2,3,8,8,0,8,,,Goodison Park,Liverpool
1995/96,12,3,Blackburn Rovers,13,15,5,3,7,23,17,6,18,7,5,1,1,20,5,15,16,8,0,2,6,3,12,-9,2,,,Ewood Park,Blackburn
1995/96,12,20,Southampton,14,15,4,3,8,15,25,-10,15,8,3,2,3,9,9,0,11,7,1,1,5,6,16,-10,4,,,The Dell,Southampton
1995/96,12,19,Sheffield Wednesday,15,15,3,5,7,14,20,-6,14,7,1,2,4,4,9,-5,5,8,2,3,3,10,11,-1,9,,,Hillsborough,Sheffield
1995/96,12,22,Wimbledon,16,15,3,3,9,19,33,-14,12,7,2,2,3,9,11,-2,8,8,1,1,6,10,22,-12,4,,,Selhurst Park,London
1995/96,12,11,Manchester City,17,15,3,3,9,7,22,-15,12,8,3,2,3,4,5,-1,11,7,0,1,6,3,17,-14,1,,,Maine Road,Manchester
1995/96,12,17,Queens Park Rangers,18,15,3,2,10,11,23,-12,11,7,1,2,4,7,14,-7,5,8,2,0,6,4,9,-5,6,R,EN_D1,Loftus Road,London
1995/96,12,5,Coventry City,19,15,1,6,8,14,32,-18,9,8,1,3,4,8,16,-8,6,7,0,3,4,6,16,-10,3,R,EN_D1,Highfield Road,Coventry
1995/96,12,27,Bolton Wanderers,20,15,2,2,11,14,30,-16,8,7,2,2,3,6,10,-4,8,8,0,0,8,8,20,-12,0,R,EN_D1,Burnden Park,Bolton
1995/96,13,23,Newcastle United,1,16,12,3,1,36,14,22,39,8,8,0,0,20,4,16,24,8,4,3,1,16,10,6,15,Q,EU_CL,St. James' Park,Newcastle
1995/96,13,12,Manchester United,2,16,10,4,2,33,15,18,34,8,6,2,0,18,6,12,20,8,4,2,2,15,9,6,14,Q,EU_UC,Old Trafford,Manchester
1995/96,13,1,Arsenal,3,16,8,5,3,22,11,11,29,8,5,3,0,14,6,8,18,8,3,2,3,8,5,3,11,,,Highbury,London
1995/96,13,2,Aston Villa,4,16,8,4,4,20,12,8,28,8,4,3,1,10,5,5,15,8,4,1,3,10,7,3,13,Q,EU_UC,Villa Park,Birmingham
1995/96,13,21,Tottenham Hotspur,5,16,7,6,3,22,17,5,27,8,3,2,3,9,9,0,11,8,4,4,0,13,8,5,16,Q,EU_UC,White Hart Lane,London
1995/96,13,13,Middlesbrough,6,16,7,6,3,15,10,5,27,8,5,2,1,10,4,6,17,8,2,4,2,5,6,-1,10,,,Riverside Stadium,Middlesbrough
1995/96,13,15,Nottingham Forest,7,15,6,8,1,25,22,3,26,7,4,3,0,15,7,8,15,8,2,5,1,10,15,-5,11,,,City Ground,Nottingham
1995/96,13,10,Liverpool,8,16,7,4,5,28,15,13,25,8,5,2,1,18,5,13,17,8,2,2,4,10,10,0,8,Q,EU_CWC,Anfield,Liverpool
1995/96,13,9,Leeds United,9,15,7,3,5,20,17,3,24,8,5,0,3,10,8,2,15,7,2,3,2,10,9,1,9,,,Elland Road,Leeds
1995/96,13,3,Blackburn Rovers,10,16,6,3,7,27,19,8,21,8,6,1,1,24,7,17,19,8,0,2,6,3,12,-9,2,,,Ewood Park,Blackburn
1995/96,13,4,Chelsea,11,16,5,6,5,15,18,-3,21,8,3,4,1,10,8,2,13,8,2,2,4,5,10,-5,8,,,Stamford Bridge,London
1995/96,13,7,Everton,12,16,5,5,6,19,19,0,20,8,3,2,3,11,11,0,11,8,2,3,3,8,8,0,9,,,Goodison Park,Liverpool
1995/96,13,25,West Ham United,13,16,5,5,6,17,20,-3,20,8,2,3,3,8,12,-4,9,8,3,2,3,9,8,1,11,,,Boleyn Ground,London
1995/96,13,19,Sheffield Wednesday,14,16,4,5,7,18,23,-5,17,8,2,2,4,8,12,-4,8,8,2,3,3,10,11,-1,9,,,Hillsborough,Sheffield
1995/96,13,20,Southampton,15,16,4,4,8,16,26,-10,16,8,3,2,3,9,9,0,11,8,1,2,5,7,17,-10,5,,,The Dell,Southampton
1995/96,13,11,Manchester City,16,16,4,3,9,8,22,-14,15,8,3,2,3,4,5,-1,11,8,1,1,6,4,17,-13,4,,,Maine Road,Manchester
1995/96,13,22,Wimbledon,17,16,3,4,9,22,36,-14,13,8,2,3,3,12,14,-2,9,8,1,1,6,10,22,-12,4,,,Selhurst Park,London
1995/96,13,17,Queens Park Rangers,18,16,3,3,10,12,24,-12,12,8,1,3,4,8,15,-7,6,8,2,0,6,4,9,-5,6,R,EN_D1,Loftus Road,London
1995/96,13,27,Bolton Wanderers,19,16,2,3,11,15,31,-16,9,8,2,3,3,7,11,-4,9,8,0,0,8,8,20,-12,0,R,EN_D1,Burnden Park,Bolton
1995/96,13,5,Coventry City,20,16,1,6,9,17,36,-19,9,8,1,3,4,8,16,-8,6,8,0,3,5,9,20,-11,3,R,EN_D1,Highfield Road,Coventry
1995/96,14,23,Newcastle United,1,17,12,3,2,36,15,21,39,8,8,0,0,20,4,16,24,9,4,3,2,16,11,5,15,Q,EU_CL,St. James' Park,Newcastle
1995/96,14,12,Manchester United,2,17,10,5,2,35,17,18,35,9,6,3,0,20,8,12,21,8,4,2,2,15,9,6,14,Q,EU_UC,Old Trafford,Manchester
1995/96,14,1,Arsenal,3,17,8,6,3,22,11,11,30,8,5,3,0,14,6,8,18,9,3,3,3,8,5,3,12,,,Highbury,London
1995/96,14,13,Middlesbrough,4,17,8,6,3,19,11,8,30,9,6,2,1,14,5,9,20,8,2,4,2,5,6,-1,10,Q,EU_UC,Riverside Stadium,Middlesbrough
1995/96,14,21,Tottenham Hotspur,5,17,8,6,3,23,17,6,30,9,4,2,3,10,9,1,14,8,4,4,0,13,8,5,16,Q,EU_UC,White Hart Lane,London
1995/96,14,2,Aston Villa,6,17,8,5,4,21,13,8,29,8,4,3,1,10,5,5,15,9,4,2,3,11,8,3,14,,,Villa Park,Birmingham
1995/96,14,10,Liverpool,7,17,8,4,5,29,15,14,28,8,5,2,1,18,5,13,17,9,3,2,4,11,10,1,11,Q,EU_CWC,Anfield,Liverpool
1995/96,14,15,Nottingham Forest,8,16,6,9,1,26,23,3,27,8,4,4,0,16,8,8,16,8,2,5,1,10,15,-5,11,,,City Ground,Nottingham
1995/96,14,9,Leeds United,9,16,7,4,5,21,18,3,25,9,5,1,3,11,9,2,16,7,2,3,2,10,9,1,9,,,Elland Road,Leeds
1995/96,14,4,Chelsea,10,17,6,6,5,16,18,-2,24,9,4,4,1,11,8,3,16,8,2,2,4,5,10,-5,8,,,Stamford Bridge,London
1995/96,14,7,Everton,11,17,6,5,6,22,19,3,23,9,4,2,3,14,11,3,14,8,2,3,3,8,8,0,9,,,Goodison Park,Liverpool
1995/96,14,3,Blackburn Rovers,12,17,6,3,8,27,24,3,21,8,6,1,1,24,7,17,19,9,0,2,7,3,17,-14,2,,,Ewood Park,Blackburn
1995/96,14,25,West Ham United,13,17,5,5,7,17,23,-6,20,8,2,3,3,8,12,-4,9,9,3,2,4,9,11,-2,11,,,Boleyn Ground,London
1995/96,14,19,Sheffield Wednesday,14,17,4,6,7,20,25,-5,18,8,2,2,4,8,12,-4,8,9,2,4,3,12,13,-1,10,,,Hillsborough,Sheffield
1995/96,14,20,Southampton,15,17,4,5,8,16,26,-10,17,9,3,3,3,9,9,0,12,8,1,2,5,7,17,-10,5,,,The Dell,Southampton
1995/96,14,11,Manchester City,16,17,4,3,10,9,26,-17,15,8,3,2,3,4,5,-1,11,9,1,1,7,5,21,-16,4,,,Maine Road,Manchester
1995/96,14,22,Wimbledon,17,17,3,5,9,23,37,-14,14,8,2,3,3,12,14,-2,9,9,1,2,6,11,23,-12,5,,,Selhurst Park,London
1995/96,14,17,Queens Park Rangers,18,17,3,3,11,12,25,-13,12,8,1,3,4,8,15,-7,6,9,2,0,7,4,10,-6,6,R,EN_D1,Loftus Road,London
1995/96,14,5,Coventry City,19,17,2,6,9,22,36,-14,12,9,2,3,4,13,16,-3,9,8,0,3,5,9,20,-11,3,R,EN_D1,Highfield Road,Coventry
1995/96,14,27,Bolton Wanderers,20,17,2,3,12,15,32,-17,9,9,2,3,4,7,12,-5,9,8,0,0,8,8,20,-12,0,R,EN_D1,Burnden Park,Bolton
1995/96,15,23,Newcastle United,1,18,13,3,2,37,15,22,42,9,9,0,0,21,4,17,27,9,4,3,2,16,11,5,15,Q,EU_CL,St. James' Park,Newcastle
1995/96,15,12,Manchester United,2,18,10,5,3,35,19,16,35,9,6,3,0,20,8,12,21,9,4,2,3,15,11,4,14,Q,EU_UC,Old Trafford,Manchester
1995/96,15,21,Tottenham Hotspur,3,18,9,6,3,24,17,7,33,9,4,2,3,10,9,1,14,9,5,4,0,14,8,6,19,,,White Hart Lane,London
1995/96,15,2,Aston Villa,4,18,9,5,4,25,14,11,32,9,5,3,1,14,6,8,18,9,4,2,3,11,8,3,14,Q,EU_UC,Villa Park,Birmingham
1995/96,15,10,Liverpool,5,18,9,4,5,31,15,16,31,9,6,2,1,20,5,15,20,9,3,2,4,11,10,1,11,"Q,Q","EU_CWC,EU_UC",Anfield,Liverpool
1995/96,15,1,Arsenal,6,18,8,7,3,23,12,11,31,9,5,4,0,15,7,8,19,9,3,3,3,8,5,3,12,,,Highbury,London
1995/96,15,13,Middlesbrough,7,18,8,6,4,19,12,7,30,9,6,2,1,14,5,9,20,9,2,4,3,5,7,-2,10,,,Riverside Stadium,Middlesbrough
1995/96,15,15,Nottingham Forest,8,17,6,10,1,27,24,3,28,8,4,4,0,16,8,8,16,9,2,6,1,11,16,-5,12,,,City Ground,Nottingham
1995/96,15,9,Leeds United,9,17,7,4,6,23,24,-1,25,9,5,1,3,11,9,2,16,8,2,3,3,12,15,-3,9,,,Elland Road,Leeds
1995/96,15,4,Chelsea,10,18,6,7,5,17,19,-2,25,9,4,4,1,11,8,3,16,9,2,3,4,6,11,-5,9,,,Stamford Bridge,London
1995/96,15,3,Blackburn Rovers,11,18,7,3,8,28,24,4,24,9,7,1,1,25,7,18,22,9,0,2,7,3,17,-14,2,,,Ewood Park,Blackburn
1995/96,15,7,Everton,12,18,6,5,7,22,20,2,23,9,4,2,3,14,11,3,14,9,2,3,4,8,9,-1,9,,,Goodison Park,Liverpool
1995/96,15,25,West Ham United,13,18,6,5,7,19,24,-5,23,9,3,3,3,10,13,-3,12,9,3,2,4,9,11,-2,11,,,Boleyn Ground,London
1995/96,15,19,Sheffield Wednesday,14,18,5,6,7,26,27,-1,21,9,3,2,4,14,14,0,11,9,2,4,3,12,13,-1,10,,,Hillsborough,Sheffield
1995/96,15,20,Southampton,15,18,4,5,9,17,28,-11,17,9,3,3,3,9,9,0,12,9,1,2,6,8,19,-11,5,,,The Dell,Southampton
1995/96,15,11,Manchester City,16,18,4,4,10,10,27,-17,16,9,3,3,3,5,6,-1,12,9,1,1,7,5,21,-16,4,,,Maine Road,Manchester
1995/96,15,17,Queens Park Rangers,17,18,4,3,11,14,26,-12,15,9,2,3,4,10,16,-6,9,9,2,0,7,4,10,-6,6,,,Loftus Road,London
1995/96,15,22,Wimbledon,18,18,3,5,10,23,38,-15,14,9,2,3,4,12,15,-3,9,9,1,2,6,11,23,-12,5,R,EN_D1,Selhurst Park,London
1995/96,15,5,Coventry City,19,18,2,6,10,23,40,-17,12,9,2,3,4,13,16,-3,9,9,0,3,6,10,24,-14,3,R,EN_D1,Highfield Road,Coventry
1995/96,15,27,Bolton Wanderers,20,18,2,3,13,16,34,-18,9,9,2,3,4,7,12,-5,9,9,0,0,9,9,22,-13,0,R,EN_D1,Burnden Park,Bolton
1995/96,16,23,Newcastle United,1,19,14,3,2,40,16,24,45,10,10,0,0,24,5,19,30,9,4,3,2,16,11,5,15,Q,EU_CL,St. James' Park,Newcastle
1995/96,16,12,Manchester United,2,19,10,5,4,36,22,14,35,9,6,3,0,20,8,12,21,10,4,2,4,16,14,2,14,Q,EU_UC,Old Trafford,Manchester
1995/96,16,10,Liverpool,3,19,10,4,5,34,16,18,34,10,7,2,1,23,6,17,23,9,3,2,4,11,10,1,11,Q,EU_CWC,Anfield,Liverpool
1995/96,16,21,Tottenham Hotspur,4,19,9,7,3,26,19,7,34,10,4,3,3,12,11,1,15,9,5,4,0,14,8,6,19,Q,EU_UC,White Hart Lane,London
1995/96,16,13,Middlesbrough,5,19,9,6,4,23,14,9,33,10,7,2,1,18,7,11,23,9,2,4,3,5,7,-2,10,Q,EU_UC,Riverside Stadium,Middlesbrough
1995/96,16,2,Aston Villa,6,19,9,5,5,25,15,10,32,9,5,3,1,14,6,8,18,10,4,2,4,11,9,2,14,,,Villa Park,Birmingham
1995/96,16,1,Arsenal,7,19,8,7,4,24,15,9,31,9,5,4,0,15,7,8,19,10,3,3,4,9,8,1,12,,,Highbury,London
1995/96,16,15,Nottingham Forest,8,18,6,10,2,28,27,1,28,8,4,4,0,16,8,8,16,10,2,6,2,12,19,-7,12,,,City Ground,Nottingham
1995/96,16,9,Leeds United,9,18,8,4,6,26,25,1,28,10,6,1,3,14,10,4,19,8,2,3,3,12,15,-3,9,,,Elland Road,Leeds
1995/96,16,4,Chelsea,10,19,7,7,5,18,19,-1,28,9,4,4,1,11,8,3,16,10,3,3,4,7,11,-4,12,,,Stamford Bridge,London
1995/96,16,3,Blackburn Rovers,11,19,7,4,8,29,25,4,25,9,7,1,1,25,7,18,22,10,0,3,7,4,18,-14,3,,,Ewood Park,Blackburn
1995/96,16,7,Everton,12,19,6,5,8,23,22,1,23,9,4,2,3,14,11,3,14,10,2,3,5,9,11,-2,9,,,Goodison Park,Liverpool
1995/96,16,25,West Ham United,13,19,6,5,8,21,28,-7,23,9,3,3,3,10,13,-3,12,10,3,2,5,11,15,-4,11,,,Boleyn Ground,London
1995/96,16,19,Sheffield Wednesday,14,19,5,7,7,28,29,-1,22,10,3,3,4,16,16,0,12,9,2,4,3,12,13,-1,10,,,Hillsborough,Sheffield
1995/96,16,20,Southampton,15,19,4,6,9,19,30,-11,18,9,3,3,3,9,9,0,12,10,1,3,6,10,21,-11,6,,,The Dell,Southampton
1995/96,16,17,Queens Park Rangers,16,19,5,3,11,15,26,-11,18,10,3,3,4,11,16,-5,12,9,2,0,7,4,10,-6,6,,,Loftus Road,London
1995/96,16,11,Manchester City,17,19,4,4,11,10,28,-18,16,10,3,3,4,5,7,-2,12,9,1,1,7,5,21,-16,4,,,Maine Road,Manchester
1995/96,16,22,Wimbledon,18,19,3,6,10,24,39,-15,15,10,2,4,4,13,16,-3,10,9,1,2,6,11,23,-12,5,R,EN_D1,Selhurst Park,London
1995/96,16,5,Coventry City,19,19,3,6,10,25,41,-16,15,10,3,3,4,15,17,-2,12,9,0,3,6,10,24,-14,3,R,EN_D1,Highfield Road,Coventry
1995/96,16,27,Bolton Wanderers,20,19,2,4,13,18,36,-18,10,9,2,3,4,7,12,-5,9,10,0,1,9,11,24,-13,1,R,EN_D1,Burnden Park,Bolton
1995/96,17,23,Newcastle United,1,20,14,3,3,40,18,22,45,10,10,0,0,24,5,19,30,10,4,3,3,16,13,3,15,Q,EU_CL,St. James' Park,Newcastle
1995/96,17,12,Manchester United,2,20,11,5,4,38,22,16,38,10,7,3,0,22,8,14,24,10,4,2,4,16,14,2,14,Q,EU_UC,Old Trafford,Manchester
1995/96,17,21,Tottenham Hotspur,3,20,9,8,3,26,19,7,35,10,4,3,3,12,11,1,15,10,5,5,0,14,8,6,20,,,White Hart Lane,London
1995/96,17,10,Liverpool,4,19,10,4,5,34,16,18,34,10,7,2,1,23,6,17,23,9,3,2,4,11,10,1,11,"Q,Q","EU_CWC,EU_UC",Anfield,Liverpool
1995/96,17,1,Arsenal,5,20,9,7,4,27,15,12,34,10,6,4,0,18,7,11,22,10,3,3,4,9,8,1,12,Q,EU_UC,Highbury,London
1995/96,17,13,Middlesbrough,6,20,9,6,5,23,18,5,33,10,7,2,1,18,7,11,23,10,2,4,4,5,11,-6,10,,,Riverside Stadium,Middlesbrough
1995/96,17,2,Aston Villa,7,19,9,5,5,25,15,10,32,9,5,3,1,14,6,8,18,10,4,2,4,11,9,2,14,,,Villa Park,Birmingham
1995/96,17,9,Leeds United,8,19,9,4,6,28,25,3,31,10,6,1,3,14,10,4,19,9,3,3,3,14,15,-1,12,,,Elland Road,Leeds
1995/96,17,15,Nottingham Forest,9,19,7,10,2,29,27,2,31,9,5,4,0,17,8,9,19,10,2,6,2,12,19,-7,12,,,City Ground,Nottingham
1995/96,17,3,Blackburn Rovers,10,20,8,4,8,31,25,6,28,10,8,1,1,27,7,20,25,10,0,3,7,4,18,-14,3,,,Ewood Park,Blackburn
1995/96,17,4,Chelsea,11,20,7,7,6,19,21,-2,28,10,4,4,2,12,10,2,16,10,3,3,4,7,11,-4,12,,,Stamford Bridge,London
1995/96,17,7,Everton,12,20,7,5,8,27,22,5,26,10,5,2,3,18,11,7,17,10,2,3,5,9,11,-2,9,,,Goodison Park,Liverpool
1995/96,17,25,West Ham United,13,19,6,5,8,21,28,-7,23,9,3,3,3,10,13,-3,12,10,3,2,5,11,15,-4,11,,,Boleyn Ground,London
1995/96,17,19,Sheffield Wednesday,14,20,5,7,8,28,30,-2,22,10,3,3,4,16,16,0,12,10,2,4,4,12,14,-2,10,,,Hillsborough,Sheffield
1995/96,17,20,Southampton,15,20,4,7,9,19,30,-11,19,10,3,4,3,9,9,0,13,10,1,3,6,10,21,-11,6,,,The Dell,Southampton
1995/96,17,22,Wimbledon,16,20,4,6,10,26,40,-14,18,10,2,4,4,13,16,-3,10,10,2,2,6,13,24,-11,8,,,Selhurst Park,London
1995/96,17,17,Queens Park Rangers,17,20,5,3,12,15,29,-14,18,10,3,3,4,11,16,-5,12,10,2,0,8,4,13,-9,6,,,Loftus Road,London
1995/96,17,11,Manchester City,18,20,4,4,12,10,30,-20,16,10,3,3,4,5,7,-2,12,10,1,1,8,5,23,-18,4,R,EN_D1,Maine Road,Manchester
1995/96,17,5,Coventry City,19,19,3,6,10,25,41,-16,15,10,3,3,4,15,17,-2,12,9,0,3,6,10,24,-14,3,R,EN_D1,Highfield Road,Coventry
1995/96,17,27,Bolton Wanderers,20,20,2,4,14,18,38,-20,10,10,2,3,5,7,14,-7,9,10,0,1,9,11,24,-13,1,R,EN_D1,Burnden Park,Bolton
1995/96,18,23,Newcastle United,1,20,14,3,3,40,18,22,45,10,10,0,0,24,5,19,30,10,4,3,3,16,13,3,15,Q,EU_CL,St. James' Park,Newcastle
1995/96,18,12,Manchester United,2,21,12,5,4,40,23,17,41,11,8,3,0,24,9,15,27,10,4,2,4,16,14,2,14,Q,EU_UC,Old Trafford,Manchester
1995/96,18,10,Liverpool,3,20,10,5,5,36,18,18,35,10,7,2,1,23,6,17,23,10,3,3,4,13,12,1,12,Q,EU_CWC,Anfield,Liverpool
1995/96,18,21,Tottenham Hotspur,4,21,9,8,4,27,21,6,35,10,4,3,3,12,11,1,15,11,5,5,1,15,10,5,20,Q,EU_UC,White Hart Lane,London
1995/96,18,1,Arsenal,5,21,9,7,5,28,18,10,34,11,6,4,1,19,10,9,22,10,3,3,4,9,8,1,12,Q,EU_UC,Highbury,London
1995/96,18,15,Nottingham Forest,6,20,8,10,2,30,27,3,34,10,6,4,0,18,8,10,22,10,2,6,2,12,19,-7,12,,,City Ground,Nottingham
1995/96,18,13,Middlesbrough,7,21,9,6,6,23,19,4,33,10,7,2,1,18,7,11,23,11,2,4,5,5,12,-7,10,,,Riverside Stadium,Middlesbrough
1995/96,18,2,Aston Villa,8,19,9,5,5,25,15,10,32,9,5,3,1,14,6,8,18,10,4,2,4,11,9,2,14,,,Villa Park,Birmingham
1995/96,18,3,Blackburn Rovers,9,21,9,4,8,33,26,7,31,11,9,1,1,29,8,21,28,10,0,3,7,4,18,-14,3,,,Ewood Park,Blackburn
1995/96,18,9,Leeds United,10,20,9,4,7,28,27,1,31,10,6,1,3,14,10,4,19,10,3,3,4,14,17,-3,12,,,Elland Road,Leeds
1995/96,18,7,Everton,11,21,8,5,8,29,22,7,29,11,6,2,3,20,11,9,20,10,2,3,5,9,11,-2,9,,,Goodison Park,Liverpool
1995/96,18,4,Chelsea,12,21,7,8,6,21,23,-2,29,11,4,5,2,14,12,2,17,10,3,3,4,7,11,-4,12,,,Stamford Bridge,London
1995/96,18,25,West Ham United,13,19,6,5,8,21,28,-7,23,9,3,3,3,10,13,-3,12,10,3,2,5,11,15,-4,11,,,Boleyn Ground,London
1995/96,18,19,Sheffield Wednesday,14,20,5,7,8,28,30,-2,22,10,3,3,4,16,16,0,12,10,2,4,4,12,14,-2,10,,,Hillsborough,Sheffield
1995/96,18,22,Wimbledon,15,21,5,6,10,29,41,-12,21,10,2,4,4,13,16,-3,10,11,3,2,6,16,25,-9,11,,,Selhurst Park,London
1995/96,18,20,Southampton,16,20,4,7,9,19,30,-11,19,10,3,4,3,9,9,0,13,10,1,3,6,10,21,-11,6,,,The Dell,Southampton
1995/96,18,5,Coventry City,17,20,4,6,10,27,42,-15,18,10,3,3,4,15,17,-2,12,10,1,3,6,12,25,-13,6,,,Highfield Road,Coventry
1995/96,18,17,Queens Park Rangers,18,21,5,3,13,16,31,-15,18,10,3,3,4,11,16,-5,12,11,2,0,9,5,15,-10,6,R,EN_D1,Loftus Road,London
1995/96,18,11,Manchester City,19,20,4,4,12,10,30,-20,16,10,3,3,4,5,7,-2,12,10,1,1,8,5,23,-18,4,R,EN_D1,Maine Road,Manchester
1995/96,18,27,Bolton Wanderers,20,21,2,4,15,19,40,-21,10,11,2,3,6,8,16,-8,9,10,0,1,9,11,24,-13,1,R,EN_D1,Burnden Park,Bolton
1995/96,19,23,Newcastle United,1,21,15,3,3,42,18,24,48,11,11,0,0,26,5,21,33,10,4,3,3,16,13,3,15,Q,EU_CL,St. James' Park,Newcastle
1995/96,19,12,Manchester United,2,22,12,5,5,41,27,14,41,11,8,3,0,24,9,15,27,11,4,2,5,17,18,-1,14,Q,EU_UC,Old Trafford,Manchester
1995/96,19,10,Liverpool,3,21,11,5,5,40,20,20,38,11,8,2,1,27,8,19,26,10,3,3,4,13,12,1,12,Q,EU_CWC,Anfield,Liverpool
1995/96,19,21,Tottenham Hotspur,4,22,10,8,4,31,22,9,38,11,5,3,3,16,12,4,18,11,5,5,1,15,10,5,20,Q,EU_UC,White Hart Lane,London
1995/96,19,2,Aston Villa,5,20,10,5,5,27,15,12,35,9,5,3,1,14,6,8,18,11,5,2,4,13,9,4,17,Q,EU_UC,Villa Park,Birmingham
1995/96,19,1,Arsenal,6,22,9,7,6,28,20,8,34,11,6,4,1,19,10,9,22,11,3,3,5,9,10,-1,12,,,Highbury,London
1995/96,19,15,Nottingham Forest,7,21,8,10,3,32,31,1,34,10,6,4,0,18,8,10,22,11,2,6,3,14,23,-9,12,,,City Ground,Nottingham
1995/96,19,13,Middlesbrough,8,22,9,6,7,23,21,2,33,11,7,2,2,18,9,9,23,11,2,4,5,5,12,-7,10,,,Riverside Stadium,Middlesbrough
1995/96,19,7,Everton,9,22,9,5,8,32,24,8,32,11,6,2,3,20,11,9,20,11,3,3,5,12,13,-1,12,,,Goodison Park,Liverpool
1995/96,19,3,Blackburn Rovers,10,22,9,5,8,33,26,7,32,11,9,1,1,29,8,21,28,11,0,4,7,4,18,-14,4,,,Ewood Park,Blackburn
1995/96,19,9,Leeds United,11,21,9,5,7,28,27,1,32,11,6,2,3,14,10,4,20,10,3,3,4,14,17,-3,12,,,Elland Road,Leeds
1995/96,19,4,Chelsea,12,22,8,8,6,23,24,-1,32,11,4,5,2,14,12,2,17,11,4,3,4,9,12,-3,15,,,Stamford Bridge,London
1995/96,19,19,Sheffield Wednesday,13,21,6,7,8,32,32,0,25,11,4,3,4,20,18,2,15,10,2,4,4,12,14,-2,10,,,Hillsborough,Sheffield
1995/96,19,25,West Ham United,14,20,6,5,9,22,30,-8,23,9,3,3,3,10,13,-3,12,11,3,2,6,12,17,-5,11,,,Boleyn Ground,London
1995/96,19,22,Wimbledon,15,22,5,6,11,31,44,-13,21,11,2,4,5,15,19,-4,10,11,3,2,6,16,25,-9,11,,,Selhurst Park,London
1995/96,19,20,Southampton,16,21,4,8,9,20,31,-11,20,10,3,4,3,9,9,0,13,11,1,4,6,11,22,-11,7,,,The Dell,Southampton
1995/96,19,5,Coventry City,17,21,4,7,10,28,43,-15,19,11,3,4,4,16,18,-2,13,10,1,3,6,12,25,-13,6,,,Highfield Road,Coventry
1995/96,19,11,Manchester City,18,21,5,4,12,12,31,-19,19,11,4,3,4,7,8,-1,15,10,1,1,8,5,23,-18,4,R,EN_D1,Maine Road,Manchester
1995/96,19,17,Queens Park Rangers,19,22,5,3,14,17,33,-16,18,11,3,3,5,12,18,-6,12,11,2,0,9,5,15,-10,6,R,EN_D1,Loftus Road,London
1995/96,19,27,Bolton Wanderers,20,22,2,4,16,21,44,-23,10,11,2,3,6,8,16,-8,9,11,0,1,10,13,28,-15,1,R,EN_D1,Burnden Park,Bolton
1995/96,20,23,Newcastle United,1,22,16,3,3,43,18,25,51,11,11,0,0,26,5,21,33,11,5,3,3,17,13,4,18,Q,EU_CL,St. James' Park,Newcastle
1995/96,20,12,Manchester United,2,23,12,6,5,41,27,14,42,12,8,4,0,24,9,15,28,11,4,2,5,17,18,-1,14,Q,EU_UC,Old Trafford,Manchester
1995/96,20,21,Tottenham Hotspur,3,23,11,8,4,32,22,10,41,12,6,3,3,17,12,5,21,11,5,5,1,15,10,5,20,,,White Hart Lane,London
1995/96,20,10,Liverpool,4,22,11,6,5,41,21,20,39,11,8,2,1,27,8,19,26,11,3,4,4,14,13,1,13,"Q,Q","EU_CWC,EU_UC",Anfield,Liverpool
1995/96,20,1,Arsenal,5,23,10,7,6,31,22,9,37,11,6,4,1,19,10,9,22,12,4,3,5,12,12,0,15,Q,EU_UC,Highbury,London
1995/96,20,15,Nottingham Forest,6,22,9,10,3,33,31,2,37,11,7,4,0,19,8,11,25,11,2,6,3,14,23,-9,12,,,City Ground,Nottingham
1995/96,20,2,Aston Villa,7,21,10,6,5,27,15,12,36,9,5,3,1,14,6,8,18,12,5,3,4,13,9,4,18,,,Villa Park,Birmingham
1995/96,20,3,Blackburn Rovers,8,23,10,5,8,34,26,8,35,11,9,1,1,29,8,21,28,12,1,4,7,5,18,-13,7,,,Ewood Park,Blackburn
1995/96,20,9,Leeds United,9,22,10,5,7,30,27,3,35,12,7,2,3,16,10,6,23,10,3,3,4,14,17,-3,12,,,Elland Road,Leeds
1995/96,20,7,Everton,10,23,9,6,8,33,25,8,33,12,6,3,3,21,12,9,21,11,3,3,5,12,13,-1,12,,,Goodison Park,Liverpool
1995/96,20,13,Middlesbrough,11,23,9,6,8,25,24,1,33,12,7,2,3,20,12,8,23,11,2,4,5,5,12,-7,10,,,Riverside Stadium,Middlesbrough
1995/96,20,4,Chelsea,12,23,8,9,6,24,25,-1,33,11,4,5,2,14,12,2,17,12,4,4,4,10,13,-3,16,,,Stamford Bridge,London
1995/96,20,19,Sheffield Wednesday,13,22,6,8,8,33,33,0,26,12,4,4,4,21,19,2,16,10,2,4,4,12,14,-2,10,,,Hillsborough,Sheffield
1995/96,20,25,West Ham United,14,21,6,5,10,22,32,-10,23,9,3,3,3,10,13,-3,12,12,3,2,7,12,19,-7,11,,,Boleyn Ground,London
1995/96,20,22,Wimbledon,15,23,5,6,12,31,45,-14,21,11,2,4,5,15,19,-4,10,12,3,2,7,16,26,-10,11,,,Selhurst Park,London
1995/96,20,20,Southampton,16,22,4,8,10,20,32,-12,20,10,3,4,3,9,9,0,13,12,1,4,7,11,23,-12,7,,,The Dell,Southampton
1995/96,20,5,Coventry City,17,22,4,7,11,28,44,-16,19,12,3,4,5,16,19,-3,13,10,1,3,6,12,25,-13,6,,,Highfield Road,Coventry
1995/96,20,11,Manchester City,18,22,5,4,13,12,32,-20,19,11,4,3,4,7,8,-1,15,11,1,1,9,5,24,-19,4,R,EN_D1,Maine Road,Manchester
1995/96,20,17,Queens Park Rangers,19,23,5,3,15,17,34,-17,18,12,3,3,6,12,19,-7,12,11,2,0,9,5,15,-10,6,R,EN_D1,Loftus Road,London
1995/96,20,27,Bolton Wanderers,20,23,3,4,16,22,44,-22,13,12,3,3,6,9,16,-7,12,11,0,1,10,13,28,-15,1,R,EN_D1,Burnden Park,Bolton
1995/96,21,23,Newcastle United,1,23,17,3,3,45,19,26,54,12,12,0,0,28,6,22,36,11,5,3,3,17,13,4,18,Q,EU_CL,St. James' Park,Newcastle
1995/96,21,12,Manchester United,2,24,13,6,5,42,27,15,45,12,8,4,0,24,9,15,28,12,5,2,5,18,18,0,17,Q,EU_UC,Old Trafford,Manchester
1995/96,21,10,Liverpool,3,23,12,6,5,46,21,25,42,12,9,2,1,32,8,24,29,11,3,4,4,14,13,1,13,Q,EU_CWC,Anfield,Liverpool
1995/96,21,21,Tottenham Hotspur,4,24,11,8,5,33,24,9,41,12,6,3,3,17,12,5,21,12,5,5,2,16,12,4,20,Q,EU_UC,White Hart Lane,London
1995/96,21,2,Aston Villa,5,22,11,6,5,29,16,13,39,10,6,3,1,16,7,9,21,12,5,3,4,13,9,4,18,Q,EU_UC,Villa Park,Birmingham
1995/96,21,3,Blackburn Rovers,6,24,11,5,8,37,26,11,38,12,10,1,1,32,8,24,31,12,1,4,7,5,18,-13,7,,,Ewood Park,Blackburn
1995/96,21,1,Arsenal,7,24,10,7,7,32,24,8,37,12,6,4,2,20,12,8,22,12,4,3,5,12,12,0,15,,,Highbury,London
1995/96,21,15,Nottingham Forest,8,23,9,10,4,33,32,1,37,11,7,4,0,19,8,11,25,12,2,6,4,14,24,-10,12,,,City Ground,Nottingham
1995/96,21,7,Everton,9,24,10,6,8,35,26,9,36,12,6,3,3,21,12,9,21,12,4,3,5,14,14,0,15,,,Goodison Park,Liverpool
1995/96,21,4,Chelsea,10,24,9,9,6,25,25,0,36,12,5,5,2,15,12,3,20,12,4,4,4,10,13,-3,16,,,Stamford Bridge,London
1995/96,21,9,Leeds United,11,23,10,5,8,30,32,-2,35,12,7,2,3,16,10,6,23,11,3,3,5,14,22,-8,12,,,Elland Road,Leeds
1995/96,21,13,Middlesbrough,12,24,9,6,9,26,26,0,33,12,7,2,3,20,12,8,23,12,2,4,6,6,14,-8,10,,,Riverside Stadium,Middlesbrough
1995/96,21,19,Sheffield Wednesday,13,23,6,8,9,33,36,-3,26,12,4,4,4,21,19,2,16,11,2,4,5,12,17,-5,10,,,Hillsborough,Sheffield
1995/96,21,22,Wimbledon,14,24,6,6,12,33,46,-13,24,12,3,4,5,17,20,-3,13,12,3,2,7,16,26,-10,11,,,Selhurst Park,London
1995/96,21,20,Southampton,15,23,5,8,10,22,33,-11,23,11,4,4,3,11,10,1,16,12,1,4,7,11,23,-12,7,,,The Dell,Southampton
1995/96,21,25,West Ham United,16,22,6,5,11,22,33,-11,23,10,3,3,4,10,14,-4,12,12,3,2,7,12,19,-7,11,,,Boleyn Ground,London
1995/96,21,5,Coventry City,17,23,4,8,11,29,45,-16,20,12,3,4,5,16,19,-3,13,11,1,4,6,13,26,-13,7,,,Highfield Road,Coventry
1995/96,21,11,Manchester City,18,23,5,5,13,13,33,-20,20,12,4,4,4,8,9,-1,16,11,1,1,9,5,24,-19,4,R,EN_D1,Maine Road,Manchester
1995/96,21,17,Queens Park Rangers,19,24,5,3,16,18,36,-18,18,12,3,3,6,12,19,-7,12,12,2,0,10,6,17,-11,6,R,EN_D1,Loftus Road,London
1995/96,21,27,Bolton Wanderers,20,24,3,4,17,23,46,-23,13,12,3,3,6,9,16,-7,12,12,0,1,11,14,30,-16,1,R,EN_D1,Burnden Park,Bolton
1995/96,22,23,Newcastle United,1,23,17,3,3,45,19,26,54,12,12,0,0,28,6,22,36,11,5,3,3,17,13,4,18,Q,EU_CL,St. James' Park,Newcastle
1995/96,22,10,Liverpool,2,24,13,6,5,48,21,27,45,12,9,2,1,32,8,24,29,12,4,4,4,16,13,3,16,"Q,Q","EU_UC,EU_CWC",Anfield,Liverpool
1995/96,22,12,Manchester United,3,24,13,6,5,42,27,15,45,12,8,4,0,24,9,15,28,12,5,2,5,18,18,0,17,,,Old Trafford,Manchester
1995/96,22,21,Tottenham Hotspur,4,24,11,8,5,33,24,9,41,12,6,3,3,17,12,5,21,12,5,5,2,16,12,4,20,Q,EU_UC,White Hart Lane,London
1995/96,22,15,Nottingham Forest,5,24,10,10,4,35,33,2,40,12,8,4,0,21,9,12,28,12,2,6,4,14,24,-10,12,Q,EU_UC,City Ground,Nottingham
1995/96,22,2,Aston Villa,6,23,11,6,6,29,18,11,39,11,6,3,2,16,9,7,21,12,5,3,4,13,9,4,18,,,Villa Park,Birmingham
1995/96,22,3,Blackburn Rovers,7,24,11,5,8,37,26,11,38,12,10,1,1,32,8,24,31,12,1,4,7,5,18,-13,7,,,Ewood Park,Blackburn
1995/96,22,1,Arsenal,8,24,10,7,7,32,24,8,37,12,6,4,2,20,12,8,22,12,4,3,5,12,12,0,15,,,Highbury,London
1995/96,22,7,Everton,9,24,10,6,8,35,26,9,36,12,6,3,3,21,12,9,21,12,4,3,5,14,14,0,15,,,Goodison Park,Liverpool
1995/96,22,4,Chelsea,10,24,9,9,6,25,25,0,36,12,5,5,2,15,12,3,20,12,4,4,4,10,13,-3,16,,,Stamford Bridge,London
1995/96,22,9,Leeds United,11,24,10,5,9,31,34,-3,35,12,7,2,3,16,10,6,23,12,3,3,6,15,24,-9,12,,,Elland Road,Leeds
1995/96,22,13,Middlesbrough,12,24,9,6,9,26,26,0,33,12,7,2,3,20,12,8,23,12,2,4,6,6,14,-8,10,,,Riverside Stadium,Middlesbrough
1995/96,22,19,Sheffield Wednesday,13,23,6,8,9,33,36,-3,26,12,4,4,4,21,19,2,16,11,2,4,5,12,17,-5,10,,,Hillsborough,Sheffield
1995/96,22,25,West Ham United,14,23,7,5,11,25,35,-10,26,11,4,3,4,13,16,-3,15,12,3,2,7,12,19,-7,11,,,Boleyn Ground,London
1995/96,22,20,Southampton,15,24,5,9,10,23,34,-11,24,12,4,5,3,12,11,1,17,12,1,4,7,11,23,-12,7,,,The Dell,Southampton
1995/96,22,22,Wimbledon,16,24,6,6,12,33,46,-13,24,12,3,4,5,17,20,-3,13,12,3,2,7,16,26,-10,11,,,Selhurst Park,London
1995/96,22,11,Manchester City,17,24,5,6,13,14,34,-20,21,12,4,4,4,8,9,-1,16,12,1,2,9,6,25,-19,5,,,Maine Road,Manchester
1995/96,22,5,Coventry City,18,24,4,8,12,31,48,-17,20,12,3,4,5,16,19,-3,13,12,1,4,7,15,29,-14,7,R,EN_D1,Highfield Road,Coventry
1995/96,22,17,Queens Park Rangers,19,24,5,3,16,18,36,-18,18,12,3,3,6,12,19,-7,12,12,2,0,10,6,17,-11,6,R,EN_D1,Loftus Road,London
1995/96,22,27,Bolton Wanderers,20,24,3,4,17,23,46,-23,13,12,3,3,6,9,16,-7,12,12,0,1,11,14,30,-16,1,R,EN_D1,Burnden Park,Bolton
1995/96,23,23,Newcastle United,1,24,18,3,3,47,19,28,57,13,13,0,0,30,6,24,39,11,5,3,3,17,13,4,18,Q,EU_CL,St. James' Park,Newcastle
1995/96,23,12,Manchester United,2,25,14,6,5,46,29,17,48,12,8,4,0,24,9,15,28,13,6,2,5,22,20,2,20,Q,EU_UC,Old Trafford,Manchester
1995/96,23,10,Liverpool,3,25,13,7,5,48,21,27,46,13,9,3,1,32,8,24,30,12,4,4,4,16,13,3,16,Q,EU_CWC,Anfield,Liverpool
1995/96,23,2,Aston Villa,4,24,12,6,6,32,18,14,42,12,7,3,2,19,9,10,24,12,5,3,4,13,9,4,18,Q,EU_UC,Villa Park,Birmingham
1995/96,23,21,Tottenham Hotspur,5,25,11,9,5,33,24,9,42,12,6,3,3,17,12,5,21,13,5,6,2,16,12,4,21,Q,EU_UC,White Hart Lane,London
1995/96,23,3,Blackburn Rovers,6,25,12,5,8,40,27,13,41,13,11,1,1,35,9,26,34,12,1,4,7,5,18,-13,7,,,Ewood Park,Blackburn
1995/96,23,15,Nottingham Forest,7,25,10,10,5,35,34,1,40,12,8,4,0,21,9,12,28,13,2,6,5,14,25,-11,12,,,City Ground,Nottingham
1995/96,23,4,Chelsea,8,25,10,9,6,30,25,5,39,13,6,5,2,20,12,8,23,12,4,4,4,10,13,-3,16,,,Stamford Bridge,London
1995/96,23,1,Arsenal,9,25,10,8,7,33,25,8,38,13,6,5,2,21,13,8,23,12,4,3,5,12,12,0,15,,,Highbury,London
1995/96,23,7,Everton,10,25,10,7,8,37,28,9,37,12,6,3,3,21,12,9,21,13,4,4,5,16,16,0,16,,,Goodison Park,Liverpool
1995/96,23,9,Leeds United,11,25,10,5,10,31,37,-6,35,12,7,2,3,16,10,6,23,13,3,3,7,15,27,-12,12,,,Elland Road,Leeds
1995/96,23,13,Middlesbrough,12,25,9,6,10,26,31,-5,33,12,7,2,3,20,12,8,23,13,2,4,7,6,19,-13,10,,,Riverside Stadium,Middlesbrough
1995/96,23,25,West Ham United,13,24,8,5,11,26,35,-9,29,12,5,3,4,14,16,-2,18,12,3,2,7,12,19,-7,11,,,Boleyn Ground,London
1995/96,23,19,Sheffield Wednesday,14,24,6,8,10,33,38,-5,26,12,4,4,4,21,19,2,16,12,2,4,6,12,19,-7,10,,,Hillsborough,Sheffield
1995/96,23,20,Southampton,15,25,5,10,10,25,36,-11,25,13,4,6,3,14,13,1,18,12,1,4,7,11,23,-12,7,,,The Dell,Southampton
1995/96,23,22,Wimbledon,16,25,6,6,13,35,50,-15,24,13,3,4,6,19,24,-5,13,12,3,2,7,16,26,-10,11,,,Selhurst Park,London
1995/96,23,11,Manchester City,17,25,6,6,13,16,34,-18,24,13,5,4,4,10,9,1,19,12,1,2,9,6,25,-19,5,,,Maine Road,Manchester
1995/96,23,5,Coventry City,18,25,4,9,12,32,49,-17,21,12,3,4,5,16,19,-3,13,13,1,5,7,16,30,-14,8,R,EN_D1,Highfield Road,Coventry
1995/96,23,17,Queens Park Rangers,19,25,5,3,17,18,38,-20,18,12,3,3,6,12,19,-7,12,13,2,0,11,6,19,-13,6,R,EN_D1,Loftus Road,London
1995/96,23,27,Bolton Wanderers,20,25,3,4,18,24,49,-25,13,12,3,3,6,9,16,-7,12,13,0,1,12,15,33,-18,1,R,EN_D1,Burnden Park,Bolton
1995/96,24,23,Newcastle United,1,25,19,3,3,49,20,29,60,13,13,0,0,30,6,24,39,12,6,3,3,19,14,5,21,Q,EU_CL,St. James' Park,Newcastle
1995/96,24,12,Manchester United,2,26,15,6,5,47,29,18,51,13,9,4,0,25,9,16,31,13,6,2,5,22,20,2,20,Q,EU_UC,Old Trafford,Manchester
1995/96,24,10,Liverpool,3,26,14,7,5,50,22,28,49,13,9,3,1,32,8,24,30,13,5,4,4,18,14,4,19,Q,EU_CWC,Anfield,Liverpool
1995/96,24,2,Aston Villa,4,25,13,6,6,34,18,16,45,12,7,3,2,19,9,10,24,13,6,3,4,15,9,6,21,Q,EU_UC,Villa Park,Birmingham
1995/96,24,21,Tottenham Hotspur,5,26,11,9,6,33,25,8,42,13,6,3,4,17,13,4,21,13,5,6,2,16,12,4,21,Q,EU_UC,White Hart Lane,London
1995/96,24,3,Blackburn Rovers,6,26,12,5,9,40,28,12,41,13,11,1,1,35,9,26,34,13,1,4,8,5,19,-14,7,,,Ewood Park,Blackburn
1995/96,24,1,Arsenal,7,26,11,8,7,34,25,9,41,13,6,5,2,21,13,8,23,13,5,3,5,13,12,1,18,,,Highbury,London
1995/96,24,7,Everton,8,26,11,7,8,39,28,11,40,13,7,3,3,23,12,11,24,13,4,4,5,16,16,0,16,,,Goodison Park,Liverpool
1995/96,24,15,Nottingham Forest,9,26,10,10,6,35,35,0,40,13,8,4,1,21,10,11,28,13,2,6,5,14,25,-11,12,,,City Ground,Nottingham
1995/96,24,4,Chelsea,10,26,10,9,7,30,26,4,39,13,6,5,2,20,12,8,23,13,4,4,5,10,14,-4,16,,,Stamford Bridge,London
1995/96,24,9,Leeds United,11,25,10,5,10,31,37,-6,35,12,7,2,3,16,10,6,23,13,3,3,7,15,27,-12,12,,,Elland Road,Leeds
1995/96,24,13,Middlesbrough,12,26,9,6,11,27,33,-6,33,13,7,2,4,21,14,7,23,13,2,4,7,6,19,-13,10,,,Riverside Stadium,Middlesbrough
1995/96,24,25,West Ham United,13,25,9,5,11,27,35,-8,32,12,5,3,4,14,16,-2,18,13,4,2,7,13,19,-6,14,,,Boleyn Ground,London
1995/96,24,19,Sheffield Wednesday,14,25,7,8,10,35,39,-4,29,13,5,4,4,23,20,3,19,12,2,4,6,12,19,-7,10,,,Hillsborough,Sheffield
1995/96,24,20,Southampton,15,25,5,10,10,25,36,-11,25,13,4,6,3,14,13,1,18,12,1,4,7,11,23,-12,7,,,The Dell,Southampton
1995/96,24,22,Wimbledon,16,26,6,6,14,36,52,-16,24,13,3,4,6,19,24,-5,13,13,3,2,8,17,28,-11,11,,,Selhurst Park,London
1995/96,24,5,Coventry City,17,26,5,9,12,33,49,-16,24,13,4,4,5,17,19,-2,16,13,1,5,7,16,30,-14,8,,,Highfield Road,Coventry
1995/96,24,11,Manchester City,18,26,6,6,14,16,36,-20,24,13,5,4,4,10,9,1,19,13,1,2,10,6,27,-21,5,R,EN_D1,Maine Road,Manchester
1995/96,24,17,Queens Park Rangers,19,26,5,3,18,19,40,-21,18,13,3,3,7,13,21,-8,12,13,2,0,11,6,19,-13,6,R,EN_D1,Loftus Road,London
1995/96,24,27,Bolton Wanderers,20,26,3,4,19,24,51,-27,13,13,3,3,7,9,18,-9,12,13,0,1,12,15,33,-18,1,R,EN_D1,Burnden Park,Bolton
1995/96,25,23,Newcastle United,1,26,19,3,4,49,22,27,60,13,13,0,0,30,6,24,39,13,6,3,4,19,16,3,21,Q,EU_CL,St. James' Park,Newcastle
1995/96,25,12,Manchester United,2,27,16,6,5,49,29,20,54,14,10,4,0,27,9,18,34,13,6,2,5,22,20,2,20,Q,EU_UC,Old Trafford,Manchester
1995/96,25,10,Liverpool,3,26,14,7,5,50,22,28,49,13,9,3,1,32,8,24,30,13,5,4,4,18,14,4,19,Q,EU_CWC,Anfield,Liverpool
1995/96,25,2,Aston Villa,4,25,13,6,6,34,18,16,45,12,7,3,2,19,9,10,24,13,6,3,4,15,9,6,21,Q,EU_UC,Villa Park,Birmingham
1995/96,25,21,Tottenham Hotspur,5,26,11,9,6,33,25,8,42,13,6,3,4,17,13,4,21,13,5,6,2,16,12,4,21,Q,EU_UC,White Hart Lane,London
1995/96,25,3,Blackburn Rovers,6,26,12,5,9,40,28,12,41,13,11,1,1,35,9,26,34,13,1,4,8,5,19,-14,7,,,Ewood Park,Blackburn
1995/96,25,1,Arsenal,7,26,11,8,7,34,25,9,41,13,6,5,2,21,13,8,23,13,5,3,5,13,12,1,18,,,Highbury,London
1995/96,25,7,Everton,8,27,11,7,9,39,30,9,40,13,7,3,3,23,12,11,24,14,4,4,6,16,18,-2,16,,,Goodison Park,Liverpool
1995/96,25,15,Nottingham Forest,9,26,10,10,6,35,35,0,40,13,8,4,1,21,10,11,28,13,2,6,5,14,25,-11,12,,,City Ground,Nottingham
1995/96,25,4,Chelsea,10,27,10,9,8,31,28,3,39,14,6,5,3,21,14,7,23,13,4,4,5,10,14,-4,16,,,Stamford Bridge,London
1995/96,25,25,West Ham United,11,27,11,5,11,31,36,-5,38,13,6,3,4,16,16,0,21,14,5,2,7,15,20,-5,17,,,Boleyn Ground,London
1995/96,25,9,Leeds United,12,25,10,5,10,31,37,-6,35,12,7,2,3,16,10,6,23,13,3,3,7,15,27,-12,12,,,Elland Road,Leeds
1995/96,25,13,Middlesbrough,13,27,9,6,12,28,37,-9,33,14,7,2,5,22,18,4,23,13,2,4,7,6,19,-13,10,,,Riverside Stadium,Middlesbrough
1995/96,25,19,Sheffield Wednesday,14,26,7,8,11,36,42,-6,29,14,5,4,5,24,23,1,19,12,2,4,6,12,19,-7,10,,,Hillsborough,Sheffield
1995/96,25,20,Southampton,15,25,5,10,10,25,36,-11,25,13,4,6,3,14,13,1,18,12,1,4,7,11,23,-12,7,,,The Dell,Southampton
1995/96,25,22,Wimbledon,16,26,6,6,14,36,52,-16,24,13,3,4,6,19,24,-5,13,13,3,2,8,17,28,-11,11,,,Selhurst Park,London
1995/96,25,5,Coventry City,17,26,5,9,12,33,49,-16,24,13,4,4,5,17,19,-2,16,13,1,5,7,16,30,-14,8,,,Highfield Road,Coventry
1995/96,25,11,Manchester City,18,26,6,6,14,16,36,-20,24,13,5,4,4,10,9,1,19,13,1,2,10,6,27,-21,5,R,EN_D1,Maine Road,Manchester
1995/96,25,17,Queens Park Rangers,19,27,6,3,18,22,41,-19,21,13,3,3,7,13,21,-8,12,14,3,0,11,9,20,-11,9,R,EN_D1,Loftus Road,London
1995/96,25,27,Bolton Wanderers,20,27,4,4,19,28,52,-24,16,13,3,3,7,9,18,-9,12,14,1,1,12,19,34,-15,4,R,EN_D1,Burnden Park,Bolton
1995/96,26,23,Newcastle United,1,27,19,4,4,52,25,27,61,13,13,0,0,30,6,24,39,14,6,4,4,22,19,3,22,Q,EU_CL,St. James' Park,Newcastle
1995/96,26,12,Manchester United,2,28,17,6,5,55,29,26,57,14,10,4,0,27,9,18,34,14,7,2,5,28,20,8,23,Q,EU_UC,Old Trafford,Manchester
1995/96,26,10,Liverpool,3,27,15,7,5,53,24,29,52,13,9,3,1,32,8,24,30,14,6,4,4,21,16,5,22,Q,EU_CWC,Anfield,Liverpool
1995/96,26,2,Aston Villa,4,27,14,7,6,39,21,18,49,13,8,3,2,21,9,12,27,14,6,4,4,18,12,6,22,Q,EU_UC,Villa Park,Birmingham
1995/96,26,21,Tottenham Hotspur,5,27,12,9,6,34,25,9,45,14,7,3,4,18,13,5,24,13,5,6,2,16,12,4,21,Q,EU_UC,White Hart Lane,London
1995/96,26,1,Arsenal,6,27,12,8,7,35,25,10,44,13,6,5,2,21,13,8,23,14,6,3,5,14,12,2,21,,,Highbury,London
1995/96,26,7,Everton,7,28,12,7,9,42,30,12,43,14,8,3,3,26,12,14,27,14,4,4,6,16,18,-2,16,,,Goodison Park,Liverpool
1995/96,26,4,Chelsea,8,28,11,9,8,34,30,4,42,14,6,5,3,21,14,7,23,14,5,4,5,13,16,-3,19,,,Stamford Bridge,London
1995/96,26,3,Blackburn Rovers,9,28,12,5,11,42,33,9,41,14,11,1,2,37,12,25,34,14,1,4,9,5,21,-16,7,,,Ewood Park,Blackburn
1995/96,26,15,Nottingham Forest,10,27,10,10,7,35,38,-3,40,13,8,4,1,21,10,11,28,14,2,6,6,14,28,-14,12,,,City Ground,Nottingham
1995/96,26,25,West Ham United,11,28,11,5,12,31,37,-6,38,14,6,3,5,16,17,-1,21,14,5,2,7,15,20,-5,17,,,Boleyn Ground,London
1995/96,26,9,Leeds United,12,25,10,5,10,31,37,-6,35,12,7,2,3,16,10,6,23,13,3,3,7,15,27,-12,12,,,Elland Road,Leeds
1995/96,26,13,Middlesbrough,13,28,9,7,12,28,37,-9,34,14,7,2,5,22,18,4,23,14,2,5,7,6,19,-13,11,,,Riverside Stadium,Middlesbrough
1995/96,26,19,Sheffield Wednesday,14,27,7,8,12,36,43,-7,29,14,5,4,5,24,23,1,19,13,2,4,7,12,20,-8,10,,,Hillsborough,Sheffield
1995/96,26,20,Southampton,15,26,5,10,11,27,39,-12,25,14,4,6,4,16,16,0,18,12,1,4,7,11,23,-12,7,,,The Dell,Southampton
1995/96,26,22,Wimbledon,16,27,6,7,14,39,55,-16,25,14,3,5,6,22,27,-5,14,13,3,2,8,17,28,-11,11,,,Selhurst Park,London
1995/96,26,5,Coventry City,17,27,5,10,12,33,49,-16,25,14,4,5,5,17,19,-2,17,13,1,5,7,16,30,-14,8,,,Highfield Road,Coventry
1995/96,26,11,Manchester City,18,27,6,7,14,19,39,-20,25,14,5,5,4,13,12,1,20,13,1,2,10,6,27,-21,5,R,EN_D1,Maine Road,Manchester
1995/96,26,17,Queens Park Rangers,19,27,6,3,18,22,41,-19,21,13,3,3,7,13,21,-8,12,14,3,0,11,9,20,-11,9,R,EN_D1,Loftus Road,London
1995/96,26,27,Bolton Wanderers,20,28,4,4,20,28,58,-30,16,14,3,3,8,9,24,-15,12,14,1,1,12,19,34,-15,4,R,EN_D1,Burnden Park,Bolton
1995/96,28,23,Newcastle United,1,28,19,4,5,52,26,26,61,14,13,0,1,30,7,23,39,14,6,4,4,22,19,3,22,Q,EU_CL,St. James' Park,Newcastle
1995/96,28,12,Manchester United,2,29,18,6,5,56,29,27,60,14,10,4,0,27,9,18,34,15,8,2,5,29,20,9,26,Q,EU_UC,Old Trafford,Manchester
1995/96,28,10,Liverpool,3,28,16,7,5,56,24,32,55,14,10,3,1,35,8,27,33,14,6,4,4,21,16,5,22,Q,EU_CWC,Anfield,Liverpool
1995/96,28,2,Aston Villa,4,30,16,7,7,46,28,18,55,15,10,3,2,28,13,15,33,15,6,4,5,18,15,3,22,Q,EU_UC,Villa Park,Birmingham
1995/96,28,1,Arsenal,5,29,13,9,7,39,27,12,48,14,7,5,2,24,14,10,26,15,6,4,5,15,13,2,22,Q,EU_UC,Highbury,London
1995/96,28,21,Tottenham Hotspur,6,28,13,9,6,35,25,10,48,15,8,3,4,19,13,6,27,13,5,6,2,16,12,4,21,,,White Hart Lane,London
1995/96,28,7,Everton,7,30,13,8,9,46,32,14,47,15,8,4,3,28,14,14,28,15,5,4,6,18,18,0,19,,,Goodison Park,Liverpool
1995/96,28,4,Chelsea,8,29,11,10,8,35,31,4,43,14,6,5,3,21,14,7,23,15,5,5,5,14,17,-3,20,,,Stamford Bridge,London
1995/96,28,15,Nottingham Forest,9,28,11,10,7,38,39,-1,43,13,8,4,1,21,10,11,28,15,3,6,6,17,29,-12,15,,,City Ground,Nottingham
1995/96,28,3,Blackburn Rovers,10,29,12,6,11,43,34,9,42,14,11,1,2,37,12,25,34,15,1,5,9,6,22,-16,8,,,Ewood Park,Blackburn
1995/96,28,25,West Ham United,11,30,12,6,12,35,39,-4,42,15,7,3,5,18,17,1,24,15,5,3,7,17,22,-5,18,,,Boleyn Ground,London
1995/96,28,9,Leeds United,12,27,11,5,11,33,39,-6,38,13,7,2,4,16,11,5,23,14,4,3,7,17,28,-11,15,,,Elland Road,Leeds
1995/96,28,13,Middlesbrough,13,30,9,7,14,28,41,-13,34,15,7,2,6,22,20,2,23,15,2,5,8,6,21,-15,11,,,Riverside Stadium,Middlesbrough
1995/96,28,19,Sheffield Wednesday,14,29,7,8,14,39,49,-10,29,15,5,4,6,25,26,-1,19,14,2,4,8,14,23,-9,10,,,Hillsborough,Sheffield
1995/96,28,5,Coventry City,15,29,5,12,12,37,53,-16,27,15,4,6,5,19,21,-2,18,14,1,6,7,18,32,-14,9,,,Highfield Road,Coventry
1995/96,28,22,Wimbledon,16,28,6,8,14,40,56,-16,26,15,3,6,6,23,28,-5,15,13,3,2,8,17,28,-11,11,,,Selhurst Park,London
1995/96,28,11,Manchester City,17,29,6,8,15,21,43,-22,26,15,5,6,4,14,13,1,21,14,1,2,11,7,30,-23,5,,,Maine Road,Manchester
1995/96,28,20,Southampton,18,27,5,10,12,27,40,-13,25,14,4,6,4,16,16,0,18,13,1,4,8,11,24,-13,7,R,EN_D1,The Dell,Southampton
1995/96,28,17,Queens Park Rangers,19,30,6,4,20,26,48,-22,22,15,3,4,8,15,24,-9,13,15,3,0,12,11,24,-13,9,R,EN_D1,Loftus Road,London
1995/96,28,27,Bolton Wanderers,20,29,5,4,20,29,58,-29,19,14,3,3,8,9,24,-15,12,15,2,1,12,20,34,-14,7,R,EN_D1,Burnden Park,Bolton
1995/96,29,23,Newcastle United,1,28,19,4,5,52,26,26,61,14,13,0,1,30,7,23,39,14,6,4,4,22,19,3,22,Q,EU_CL,St. James' Park,Newcastle
1995/96,29,12,Manchester United,2,29,18,6,5,56,29,27,60,14,10,4,0,27,9,18,34,15,8,2,5,29,20,9,26,Q,EU_UC,Old Trafford,Manchester
1995/96,29,10,Liverpool,3,29,16,8,5,58,26,32,56,15,10,4,1,37,10,27,34,14,6,4,4,21,16,5,22,Q,EU_CWC,Anfield,Liverpool
1995/96,29,2,Aston Villa,4,30,16,7,7,46,28,18,55,15,10,3,2,28,13,15,33,15,6,4,5,18,15,3,22,Q,EU_UC,Villa Park,Birmingham
1995/96,29,1,Arsenal,5,29,13,9,7,39,27,12,48,14,7,5,2,24,14,10,26,15,6,4,5,15,13,2,22,Q,EU_UC,Highbury,London
1995/96,29,21,Tottenham Hotspur,6,28,13,9,6,35,25,10,48,15,8,3,4,19,13,6,27,13,5,6,2,16,12,4,21,,,White Hart Lane,London
1995/96,29,7,Everton,7,30,13,8,9,46,32,14,47,15,8,4,3,28,14,14,28,15,5,4,6,18,18,0,19,,,Goodison Park,Liverpool
1995/96,29,3,Blackburn Rovers,8,30,13,6,11,44,34,10,45,15,12,1,2,38,12,26,37,15,1,5,9,6,22,-16,8,,,Ewood Park,Blackburn
1995/96,29,4,Chelsea,9,30,11,11,8,36,32,4,44,15,6,6,3,22,15,7,24,15,5,5,5,14,17,-3,20,,,Stamford Bridge,London
1995/96,29,15,Nottingham Forest,10,28,11,10,7,38,39,-1,43,13,8,4,1,21,10,11,28,15,3,6,6,17,29,-12,15,,,City Ground,Nottingham
1995/96,29,25,West Ham United,11,30,12,6,12,35,39,-4,42,15,7,3,5,18,17,1,24,15,5,3,7,17,22,-5,18,,,Boleyn Ground,London
1995/96,29,9,Leeds United,12,28,11,5,12,33,40,-7,38,13,7,2,4,16,11,5,23,15,4,3,8,17,29,-12,15,,,Elland Road,Leeds
1995/96,29,13,Middlesbrough,13,30,9,7,14,28,41,-13,34,15,7,2,6,22,20,2,23,15,2,5,8,6,21,-15,11,,,Riverside Stadium,Middlesbrough
1995/96,29,19,Sheffield Wednesday,14,29,7,8,14,39,49,-10,29,15,5,4,6,25,26,-1,19,14,2,4,8,14,23,-9,10,,,Hillsborough,Sheffield
1995/96,29,22,Wimbledon,15,29,6,9,14,42,58,-16,27,15,3,6,6,23,28,-5,15,14,3,3,8,19,30,-11,12,,,Selhurst Park,London
1995/96,29,5,Coventry City,16,29,5,12,12,37,53,-16,27,15,4,6,5,19,21,-2,18,14,1,6,7,18,32,-14,9,,,Highfield Road,Coventry
1995/96,29,11,Manchester City,17,30,6,9,15,22,44,-22,27,15,5,6,4,14,13,1,21,15,1,3,11,8,31,-23,6,,,Maine Road,Manchester
1995/96,29,20,Southampton,18,27,5,10,12,27,40,-13,25,14,4,6,4,16,16,0,18,13,1,4,8,11,24,-13,7,R,EN_D1,The Dell,Southampton
1995/96,29,17,Queens Park Rangers,19,30,6,4,20,26,48,-22,22,15,3,4,8,15,24,-9,13,15,3,0,12,11,24,-13,9,R,EN_D1,Loftus Road,London
1995/96,29,27,Bolton Wanderers,20,29,5,4,20,29,58,-29,19,14,3,3,8,9,24,-15,12,15,2,1,12,20,34,-14,7,R,EN_D1,Burnden Park,Bolton
1995/96,30,23,Newcastle United,1,29,20,4,5,55,26,29,64,15,14,0,1,33,7,26,42,14,6,4,4,22,19,3,22,Q,EU_CL,St. James' Park,Newcastle
1995/96,30,12,Manchester United,2,31,19,7,5,58,30,28,64,15,11,4,0,28,9,19,37,16,8,3,5,30,21,9,27,Q,EU_UC,Old Trafford,Manchester
1995/96,30,10,Liverpool,3,30,17,8,5,60,26,34,59,16,11,4,1,39,10,29,37,14,6,4,4,21,16,5,22,Q,EU_CWC,Anfield,Liverpool
1995/96,30,2,Aston Villa,4,32,16,8,8,46,30,16,56,16,10,4,2,28,13,15,34,16,6,4,6,18,17,1,22,Q,EU_UC,Villa Park,Birmingham
1995/96,30,1,Arsenal,5,31,14,9,8,42,28,14,51,14,7,5,2,24,14,10,26,17,7,4,6,18,14,4,25,Q,EU_UC,Highbury,London
1995/96,30,21,Tottenham Hotspur,6,30,14,9,7,40,30,10,51,16,8,3,5,21,16,5,27,14,6,6,2,19,14,5,24,,,White Hart Lane,London
1995/96,30,7,Everton,7,31,13,9,9,48,34,14,48,15,8,4,3,28,14,14,28,16,5,5,6,20,20,0,20,,,Goodison Park,Liverpool
1995/96,30,3,Blackburn Rovers,8,31,14,6,11,47,36,11,48,15,12,1,2,38,12,26,37,16,2,5,9,9,24,-15,11,,,Ewood Park,Blackburn
1995/96,30,4,Chelsea,9,31,11,11,9,36,34,2,44,15,6,6,3,22,15,7,24,16,5,5,6,14,19,-5,20,,,Stamford Bridge,London
1995/96,30,15,Nottingham Forest,10,29,11,11,7,39,40,-1,44,13,8,4,1,21,10,11,28,16,3,7,6,18,30,-12,16,,,City Ground,Nottingham
1995/96,30,25,West Ham United,11,31,12,6,13,35,42,-7,42,15,7,3,5,18,17,1,24,16,5,3,8,17,25,-8,18,,,Boleyn Ground,London
1995/96,30,9,Leeds United,12,29,11,6,12,35,42,-7,39,14,7,3,4,18,13,5,24,15,4,3,8,17,29,-12,15,,,Elland Road,Leeds
1995/96,30,13,Middlesbrough,13,32,9,9,14,29,42,-13,36,16,7,3,6,23,21,2,24,16,2,6,8,6,21,-15,12,,,Riverside Stadium,Middlesbrough
1995/96,30,19,Sheffield Wednesday,14,31,9,8,14,42,49,-7,35,16,6,4,6,27,26,1,22,15,3,4,8,15,23,-8,13,,,Hillsborough,Sheffield
1995/96,30,11,Manchester City,15,31,7,9,15,24,45,-21,30,16,6,6,4,16,14,2,24,15,1,3,11,8,31,-23,6,,,Maine Road,Manchester
1995/96,30,5,Coventry City,16,30,5,12,13,37,55,-18,27,16,4,6,6,19,23,-4,18,14,1,6,7,18,32,-14,9,,,Highfield Road,Coventry
1995/96,30,22,Wimbledon,17,30,6,9,15,42,61,-19,27,16,3,6,7,23,31,-8,15,14,3,3,8,19,30,-11,12,,,Selhurst Park,London
1995/96,30,20,Southampton,18,29,5,10,14,28,43,-15,25,15,4,6,5,16,17,-1,18,14,1,4,9,12,26,-14,7,R,EN_D1,The Dell,Southampton
1995/96,30,17,Queens Park Rangers,19,31,6,5,20,27,49,-22,23,16,3,5,8,16,25,-9,14,15,3,0,12,11,24,-13,9,R,EN_D1,Loftus Road,London
1995/96,30,27,Bolton Wanderers,20,31,6,4,21,33,61,-28,22,15,3,3,9,11,27,-16,12,16,3,1,12,22,34,-12,10,R,EN_D1,Burnden Park,Bolton
1995/96,31,12,Manchester United,1,32,20,7,5,59,30,29,67,16,12,4,0,29,9,20,40,16,8,3,5,30,21,9,27,Q,EU_CL,Old Trafford,Manchester
1995/96,31,23,Newcastle United,2,30,20,4,6,55,28,27,64,15,14,0,1,33,7,26,42,15,6,4,5,22,21,1,22,Q,EU_UC,St. James' Park,Newcastle
1995/96,31,10,Liverpool,3,31,17,8,6,60,27,33,59,16,11,4,1,39,10,29,37,15,6,4,5,21,17,4,22,Q,EU_CWC,Anfield,Liverpool
1995/96,31,2,Aston Villa,4,32,16,8,8,46,30,16,56,16,10,4,2,28,13,15,34,16,6,4,6,18,17,1,22,Q,EU_UC,Villa Park,Birmingham
1995/96,31,1,Arsenal,5,32,15,9,8,44,28,16,54,15,8,5,2,26,14,12,29,17,7,4,6,18,14,4,25,Q,EU_UC,Highbury,London
1995/96,31,21,Tottenham Hotspur,6,31,14,9,8,40,31,9,51,16,8,3,5,21,16,5,27,15,6,6,3,19,15,4,24,,,White Hart Lane,London
1995/96,31,7,Everton,7,32,13,9,10,50,38,12,48,16,8,4,4,30,18,12,28,16,5,5,6,20,20,0,20,,,Goodison Park,Liverpool
1995/96,31,3,Blackburn Rovers,8,31,14,6,11,47,36,11,48,15,12,1,2,38,12,26,37,16,2,5,9,9,24,-15,11,,,Ewood Park,Blackburn
1995/96,31,15,Nottingham Forest,9,30,12,11,7,40,40,0,47,14,9,4,1,22,10,12,31,16,3,7,6,18,30,-12,16,,,City Ground,Nottingham
1995/96,31,4,Chelsea,10,32,11,12,9,37,35,2,45,16,6,7,3,23,16,7,25,16,5,5,6,14,19,-5,20,,,Stamford Bridge,London
1995/96,31,25,West Ham United,11,32,13,6,13,39,44,-5,45,16,8,3,5,22,19,3,27,16,5,3,8,17,25,-8,18,,,Boleyn Ground,London
1995/96,31,9,Leeds United,12,29,11,6,12,35,42,-7,39,14,7,3,4,18,13,5,24,15,4,3,8,17,29,-12,15,,,Elland Road,Leeds
1995/96,31,13,Middlesbrough,13,32,9,9,14,29,42,-13,36,16,7,3,6,23,21,2,24,16,2,6,8,6,21,-15,12,,,Riverside Stadium,Middlesbrough
1995/96,31,19,Sheffield Wednesday,14,32,9,8,15,43,51,-8,35,16,6,4,6,27,26,1,22,16,3,4,9,16,25,-9,13,,,Hillsborough,Sheffield
1995/96,31,22,Wimbledon,15,31,7,9,15,46,63,-17,30,16,3,6,7,23,31,-8,15,15,4,3,8,23,32,-9,15,,,Selhurst Park,London
1995/96,31,11,Manchester City,16,32,7,9,16,26,49,-23,30,16,6,6,4,16,14,2,24,16,1,3,12,10,35,-25,6,,,Maine Road,Manchester
1995/96,31,20,Southampton,17,30,6,10,14,29,43,-14,28,16,5,6,5,17,17,0,21,14,1,4,9,12,26,-14,7,,,The Dell,Southampton
1995/96,31,5,Coventry City,18,31,5,12,14,37,56,-19,27,16,4,6,6,19,23,-4,18,15,1,6,8,18,33,-15,9,R,EN_D1,Highfield Road,Coventry
1995/96,31,27,Bolton Wanderers,19,32,7,4,21,35,62,-27,25,16,4,3,9,13,28,-15,15,16,3,1,12,22,34,-12,10,R,EN_D1,Burnden Park,Bolton
1995/96,31,17,Queens Park Rangers,20,32,6,6,20,28,50,-22,24,16,3,5,8,16,25,-9,14,16,3,1,12,12,25,-13,10,R,EN_D1,Loftus Road,London
1995/96,32,12,Manchester United,1,32,20,7,5,59,30,29,67,16,12,4,0,29,9,20,40,16,8,3,5,30,21,9,27,Q,EU_CL,Old Trafford,Manchester
1995/96,32,23,Newcastle United,2,31,20,4,7,58,32,26,64,15,14,0,1,33,7,26,42,16,6,4,6,25,25,0,22,Q,EU_UC,St. James' Park,Newcastle
1995/96,32,10,Liverpool,3,32,18,8,6,64,30,34,62,17,12,4,1,43,13,30,40,15,6,4,5,21,17,4,22,Q,EU_CWC,Anfield,Liverpool
1995/96,32,2,Aston Villa,4,32,16,8,8,46,30,16,56,16,10,4,2,28,13,15,34,16,6,4,6,18,17,1,22,Q,EU_UC,Villa Park,Birmingham
1995/96,32,1,Arsenal,5,32,15,9,8,44,28,16,54,15,8,5,2,26,14,12,29,17,7,4,6,18,14,4,25,Q,EU_UC,Highbury,London
1995/96,32,21,Tottenham Hotspur,6,32,15,9,8,43,32,11,54,17,9,3,5,24,17,7,30,15,6,6,3,19,15,4,24,,,White Hart Lane,London
1995/96,32,7,Everton,7,33,14,9,10,53,38,15,51,16,8,4,4,30,18,12,28,17,6,5,6,23,20,3,23,,,Goodison Park,Liverpool
1995/96,32,3,Blackburn Rovers,8,32,14,6,12,47,39,8,48,16,12,1,3,38,15,23,37,16,2,5,9,9,24,-15,11,,,Ewood Park,Blackburn
1995/96,32,15,Nottingham Forest,9,31,12,11,8,40,41,-1,47,14,9,4,1,22,10,12,31,17,3,7,7,18,31,-13,16,,,City Ground,Nottingham
1995/96,32,4,Chelsea,10,32,11,12,9,37,35,2,45,16,6,7,3,23,16,7,25,16,5,5,6,14,19,-5,20,,,Stamford Bridge,London
1995/96,32,25,West Ham United,11,32,13,6,13,39,44,-5,45,16,8,3,5,22,19,3,27,16,5,3,8,17,25,-8,18,,,Boleyn Ground,London
1995/96,32,9,Leeds United,12,31,12,6,13,36,43,-7,42,16,8,3,5,19,14,5,27,15,4,3,8,17,29,-12,15,,,Elland Road,Leeds
1995/96,32,13,Middlesbrough,13,33,10,9,14,30,42,-12,39,16,7,3,6,23,21,2,24,17,3,6,8,7,21,-14,15,,,Riverside Stadium,Middlesbrough
1995/96,32,19,Sheffield Wednesday,14,32,9,8,15,43,51,-8,35,16,6,4,6,27,26,1,22,16,3,4,9,16,25,-9,13,,,Hillsborough,Sheffield
1995/96,32,22,Wimbledon,15,32,8,9,15,47,63,-16,33,17,4,6,7,24,31,-7,18,15,4,3,8,23,32,-9,15,,,Selhurst Park,London
1995/96,32,11,Manchester City,16,33,7,10,16,27,50,-23,31,16,6,6,4,16,14,2,24,17,1,4,12,11,36,-25,7,,,Maine Road,Manchester
1995/96,32,20,Southampton,17,32,6,10,16,29,47,-18,28,16,5,6,5,17,17,0,21,16,1,4,11,12,30,-18,7,,,The Dell,Southampton
1995/96,32,17,Queens Park Rangers,18,33,7,6,20,31,50,-19,27,17,4,5,8,19,25,-6,17,16,3,1,12,12,25,-13,10,R,EN_D1,Loftus Road,London
1995/96,32,5,Coventry City,19,32,5,12,15,38,59,-21,27,16,4,6,6,19,23,-4,18,16,1,6,9,19,36,-17,9,R,EN_D1,Highfield Road,Coventry
1995/96,32,27,Bolton Wanderers,20,33,7,5,21,36,63,-27,26,17,4,4,9,14,29,-15,16,16,3,1,12,22,34,-12,10,R,EN_D1,Burnden Park,Bolton
1995/96,33,12,Manchester United,1,33,21,7,5,62,32,30,70,16,12,4,0,29,9,20,40,17,9,3,5,33,23,10,30,Q,EU_CL,Old Trafford,Manchester
1995/96,33,23,Newcastle United,2,32,21,4,7,60,33,27,67,16,15,0,1,35,8,27,45,16,6,4,6,25,25,0,22,Q,EU_UC,St. James' Park,Newcastle
1995/96,33,10,Liverpool,3,33,18,8,7,64,31,33,62,17,12,4,1,43,13,30,40,16,6,4,6,21,18,3,22,Q,EU_CWC,Anfield,Liverpool
1995/96,33,2,Aston Villa,4,33,17,8,8,48,31,17,59,16,10,4,2,28,13,15,34,17,7,4,6,20,18,2,25,Q,EU_UC,Villa Park,Birmingham
1995/96,33,1,Arsenal,5,33,16,9,8,46,29,17,57,16,9,5,2,28,15,13,32,17,7,4,6,18,14,4,25,Q,EU_UC,Highbury,London
1995/96,33,7,Everton,6,34,15,9,10,56,38,18,54,17,9,4,4,33,18,15,31,17,6,5,6,23,20,3,23,,,Goodison Park,Liverpool
1995/96,33,21,Tottenham Hotspur,7,33,15,9,9,44,34,10,54,17,9,3,5,24,17,7,30,16,6,6,4,20,17,3,24,,,White Hart Lane,London
1995/96,33,15,Nottingham Forest,8,32,13,11,8,42,42,0,50,15,10,4,1,24,11,13,34,17,3,7,7,18,31,-13,16,,,City Ground,Nottingham
1995/96,33,3,Blackburn Rovers,9,33,14,6,13,47,40,7,48,16,12,1,3,38,15,23,37,17,2,5,10,9,25,-16,11,,,Ewood Park,Blackburn
1995/96,33,25,West Ham United,10,33,13,7,13,40,45,-5,46,17,8,4,5,23,20,3,28,16,5,3,8,17,25,-8,18,,,Boleyn Ground,London
1995/96,33,4,Chelsea,11,33,11,12,10,38,37,1,45,17,6,7,4,24,18,6,25,16,5,5,6,14,19,-5,20,,,Stamford Bridge,London
1995/96,33,9,Leeds United,12,32,12,6,14,37,45,-8,42,16,8,3,5,19,14,5,27,16,4,3,9,18,31,-13,15,,,Elland Road,Leeds
1995/96,33,13,Middlesbrough,13,34,11,9,14,33,43,-10,42,17,8,3,6,26,22,4,27,17,3,6,8,7,21,-14,15,,,Riverside Stadium,Middlesbrough
1995/96,33,19,Sheffield Wednesday,14,33,9,8,16,44,54,-10,35,16,6,4,6,27,26,1,22,17,3,4,10,17,28,-11,13,,,Hillsborough,Sheffield
1995/96,33,22,Wimbledon,15,33,8,10,15,48,64,-16,34,17,4,6,7,24,31,-7,18,16,4,4,8,24,33,-9,16,,,Selhurst Park,London
1995/96,33,20,Southampton,16,33,7,10,16,30,47,-17,31,17,6,6,5,18,17,1,24,16,1,4,11,12,30,-18,7,,,The Dell,Southampton
1995/96,33,11,Manchester City,17,34,7,10,17,29,53,-24,31,17,6,6,5,18,17,1,24,17,1,4,12,11,36,-25,7,,,Maine Road,Manchester
1995/96,33,5,Coventry City,18,33,6,12,15,39,59,-20,30,17,5,6,6,20,23,-3,21,16,1,6,9,19,36,-17,9,R,EN_D1,Highfield Road,Coventry
1995/96,33,17,Queens Park Rangers,19,34,7,6,21,32,52,-20,27,17,4,5,8,19,25,-6,17,17,3,1,13,13,27,-14,10,R,EN_D1,Loftus Road,London
1995/96,33,27,Bolton Wanderers,20,34,7,5,22,36,66,-30,26,17,4,4,9,14,29,-15,16,17,3,1,13,22,37,-15,10,R,EN_D1,Burnden Park,Bolton
1995/96,34,12,Manchester United,1,34,22,7,5,63,32,31,73,17,13,4,0,30,9,21,43,17,9,3,5,33,23,10,30,Q,EU_CL,Old Trafford,Manchester
1995/96,34,23,Newcastle United,2,33,21,4,8,61,35,26,67,16,15,0,1,35,8,27,45,17,6,4,7,26,27,-1,22,Q,EU_UC,St. James' Park,Newcastle
1995/96,34,10,Liverpool,3,34,19,8,7,66,31,35,65,18,13,4,1,45,13,32,43,16,6,4,6,21,18,3,22,Q,EU_CWC,Anfield,Liverpool
1995/96,34,2,Aston Villa,4,34,18,8,8,51,31,20,62,17,11,4,2,31,13,18,37,17,7,4,6,20,18,2,25,Q,EU_UC,Villa Park,Birmingham
1995/96,34,1,Arsenal,5,34,16,9,9,46,30,16,57,16,9,5,2,28,15,13,32,18,7,4,7,18,15,3,25,Q,EU_UC,Highbury,London
1995/96,34,21,Tottenham Hotspur,6,34,15,10,9,45,35,10,55,18,9,4,5,25,18,7,31,16,6,6,4,20,17,3,24,,,White Hart Lane,London
1995/96,34,7,Everton,7,35,15,9,11,57,41,16,54,17,9,4,4,33,18,15,31,18,6,5,7,24,23,1,23,,,Goodison Park,Liverpool
1995/96,34,15,Nottingham Forest,8,33,14,11,8,45,43,2,53,15,10,4,1,24,11,13,34,18,4,7,7,21,32,-11,19,,,City Ground,Nottingham
1995/96,34,3,Blackburn Rovers,9,34,15,6,13,49,41,8,51,17,13,1,3,40,16,24,40,17,2,5,10,9,25,-16,11,,,Ewood Park,Blackburn
1995/96,34,25,West Ham United,10,34,13,7,14,40,47,-7,46,17,8,4,5,23,20,3,28,17,5,3,9,17,27,-10,18,,,Boleyn Ground,London
1995/96,34,4,Chelsea,11,34,11,12,11,39,39,0,45,17,6,7,4,24,18,6,25,17,5,5,7,15,21,-6,20,,,Stamford Bridge,London
1995/96,34,13,Middlesbrough,12,35,11,10,14,34,44,-10,43,17,8,3,6,26,22,4,27,18,3,7,8,8,22,-14,16,,,Riverside Stadium,Middlesbrough
1995/96,34,9,Leeds United,13,33,12,6,15,38,48,-10,42,17,8,3,6,20,17,3,27,16,4,3,9,18,31,-13,15,,,Elland Road,Leeds
1995/96,34,19,Sheffield Wednesday,14,34,10,8,16,45,54,-9,38,17,7,4,6,28,26,2,25,17,3,4,10,17,28,-11,13,,,Hillsborough,Sheffield
1995/96,34,22,Wimbledon,15,34,9,10,15,51,64,-13,37,18,5,6,7,27,31,-4,21,16,4,4,8,24,33,-9,16,,,Selhurst Park,London
1995/96,34,20,Southampton,16,34,7,10,17,30,50,-20,31,17,6,6,5,18,17,1,24,17,1,4,12,12,33,-21,7,,,The Dell,Southampton
1995/96,34,11,Manchester City,17,35,7,10,18,29,56,-27,31,17,6,6,5,18,17,1,24,18,1,4,13,11,39,-28,7,,,Maine Road,Manchester
1995/96,34,17,Queens Park Rangers,18,35,8,6,21,35,53,-18,30,18,5,5,8,22,26,-4,20,17,3,1,13,13,27,-14,10,R,EN_D1,Loftus Road,London
1995/96,34,5,Coventry City,19,34,6,12,16,39,60,-21,30,17,5,6,6,20,23,-3,21,17,1,6,10,19,37,-18,9,R,EN_D1,Highfield Road,Coventry
1995/96,34,27,Bolton Wanderers,20,35,8,5,22,38,67,-29,29,18,5,4,9,16,30,-14,19,17,3,1,13,22,37,-15,10,R,EN_D1,Burnden Park,Bolton
1995/96,35,12,Manchester United,1,36,23,7,6,65,35,30,76,18,14,4,0,31,9,22,46,18,9,3,6,34,26,8,30,Q,EU_CL,Old Trafford,Manchester
1995/96,35,23,Newcastle United,2,35,23,4,8,63,35,28,73,18,17,0,1,37,8,29,51,17,6,4,7,26,27,-1,22,Q,EU_UC,St. James' Park,Newcastle
1995/96,35,10,Liverpool,3,35,19,9,7,67,32,35,66,18,13,4,1,45,13,32,43,17,6,5,6,22,19,3,23,Q,EU_CWC,Anfield,Liverpool
1995/96,35,2,Aston Villa,4,36,18,9,9,52,33,19,63,18,11,5,2,32,14,18,38,18,7,4,7,20,19,1,25,Q,EU_UC,Villa Park,Birmingham
1995/96,35,1,Arsenal,5,35,16,10,9,46,30,16,58,17,9,6,2,28,15,13,33,18,7,4,7,18,15,3,25,Q,EU_UC,Highbury,London
1995/96,35,3,Blackburn Rovers,6,36,17,6,13,57,44,13,57,18,14,1,3,43,18,25,43,18,3,5,10,14,26,-12,14,,,Ewood Park,Blackburn
1995/96,35,21,Tottenham Hotspur,7,35,15,11,9,45,35,10,56,18,9,4,5,25,18,7,31,17,6,7,4,20,17,3,25,,,White Hart Lane,London
1995/96,35,7,Everton,8,36,15,10,11,58,42,16,55,18,9,5,4,34,19,15,32,18,6,5,7,24,23,1,23,,,Goodison Park,Liverpool
1995/96,35,15,Nottingham Forest,9,35,14,12,9,46,48,-2,54,17,10,5,2,25,16,9,35,18,4,7,7,21,32,-11,19,,,City Ground,Nottingham
1995/96,35,25,West Ham United,10,36,14,8,14,42,48,-6,50,18,9,4,5,24,20,4,31,18,5,4,9,18,28,-10,19,,,Boleyn Ground,London
1995/96,35,4,Chelsea,11,36,12,13,11,43,40,3,49,18,7,7,4,28,19,9,28,18,5,6,7,15,21,-6,21,,,Stamford Bridge,London
1995/96,35,13,Middlesbrough,12,36,11,10,15,35,46,-11,43,18,8,3,7,27,24,3,27,18,3,7,8,8,22,-14,16,,,Riverside Stadium,Middlesbrough
1995/96,35,9,Leeds United,13,35,12,6,17,39,53,-14,42,17,8,3,6,20,17,3,27,18,4,3,11,19,36,-17,15,,,Elland Road,Leeds
1995/96,35,22,Wimbledon,14,36,10,10,16,55,68,-13,40,18,5,6,7,27,31,-4,21,18,5,4,9,28,37,-9,19,,,Selhurst Park,London
1995/96,35,19,Sheffield Wednesday,15,36,10,9,17,45,55,-10,39,18,7,5,6,28,26,2,26,18,3,4,11,17,29,-12,13,,,Hillsborough,Sheffield
1995/96,35,20,Southampton,16,36,8,10,18,33,52,-19,34,18,7,6,5,21,18,3,27,18,1,4,13,12,34,-22,7,,,The Dell,Southampton
1995/96,35,5,Coventry City,17,36,7,13,16,40,60,-20,34,18,6,6,6,21,23,-2,24,18,1,7,10,19,37,-18,10,,,Highfield Road,Coventry
1995/96,35,11,Manchester City,18,36,8,10,18,30,56,-26,34,18,7,6,5,19,17,2,27,18,1,4,13,11,39,-28,7,R,EN_D1,Maine Road,Manchester
1995/96,35,17,Queens Park Rangers,19,36,8,6,22,35,54,-19,30,18,5,5,8,22,26,-4,20,18,3,1,14,13,28,-15,10,R,EN_D1,Loftus Road,London
1995/96,35,27,Bolton Wanderers,20,36,8,5,23,38,68,-30,29,18,5,4,9,16,30,-14,19,18,3,1,14,22,38,-16,10,R,EN_D1,Burnden Park,Bolton
1995/96,36,12,Manchester United,1,37,24,7,6,70,35,35,79,19,15,4,0,36,9,27,49,18,9,3,6,34,26,8,30,Q,EU_CL,Old Trafford,Manchester
1995/96,36,23,Newcastle United,2,36,24,4,8,64,35,29,76,18,17,0,1,37,8,29,51,18,7,4,7,27,27,0,25,Q,EU_UC,St. James' Park,Newcastle
1995/96,36,10,Liverpool,3,36,20,9,7,68,32,36,69,19,14,4,1,46,13,33,46,17,6,5,6,22,19,3,23,Q,EU_CWC,Anfield,Liverpool
1995/96,36,2,Aston Villa,4,37,18,9,10,52,34,18,63,19,11,5,3,32,15,17,38,18,7,4,7,20,19,1,25,Q,EU_UC,Villa Park,Birmingham
1995/96,36,1,Arsenal,5,36,16,11,9,47,31,16,59,17,9,6,2,28,15,13,33,19,7,5,7,19,16,3,26,Q,EU_UC,Highbury,London
1995/96,36,7,Everton,6,37,16,10,11,63,44,19,58,18,9,5,4,34,19,15,32,19,7,5,7,29,25,4,26,,,Goodison Park,Liverpool
1995/96,36,3,Blackburn Rovers,7,37,17,7,13,58,45,13,58,19,14,2,3,44,19,25,44,18,3,5,10,14,26,-12,14,,,Ewood Park,Blackburn
1995/96,36,21,Tottenham Hotspur,8,36,15,12,9,46,36,10,57,19,9,5,5,26,19,7,32,17,6,7,4,20,17,3,25,,,White Hart Lane,London
1995/96,36,15,Nottingham Forest,9,36,14,12,10,46,53,-7,54,17,10,5,2,25,16,9,35,19,4,7,8,21,37,-16,19,,,City Ground,Nottingham
1995/96,36,4,Chelsea,10,37,12,14,11,44,41,3,50,18,7,7,4,28,19,9,28,19,5,7,7,16,22,-6,22,,,Stamford Bridge,London
1995/96,36,25,West Ham United,11,37,14,8,15,42,51,-9,50,18,9,4,5,24,20,4,31,19,5,4,10,18,31,-13,19,,,Boleyn Ground,London
1995/96,36,13,Middlesbrough,12,37,11,10,16,35,47,-12,43,18,8,3,7,27,24,3,27,19,3,7,9,8,23,-15,16,,,Riverside Stadium,Middlesbrough
1995/96,36,9,Leeds United,13,36,12,6,18,39,54,-15,42,18,8,3,7,20,18,2,27,18,4,3,11,19,36,-17,15,,,Elland Road,Leeds
1995/96,36,22,Wimbledon,14,37,10,10,17,55,70,-15,40,19,5,6,8,27,33,-6,21,18,5,4,9,28,37,-9,19,,,Selhurst Park,London
1995/96,36,19,Sheffield Wednesday,15,37,10,9,18,47,60,-13,39,19,7,5,7,30,31,-1,26,18,3,4,11,17,29,-12,13,,,Hillsborough,Sheffield
1995/96,36,5,Coventry City,16,37,8,13,16,42,60,-18,37,18,6,6,6,21,23,-2,24,19,2,7,10,21,37,-16,13,,,Highfield Road,Coventry
1995/96,36,20,Southampton,17,37,9,10,18,34,52,-18,37,18,7,6,5,21,18,3,27,19,2,4,13,13,34,-21,10,,,The Dell,Southampton
1995/96,36,11,Manchester City,18,37,9,10,18,31,56,-25,37,18,7,6,5,19,17,2,27,19,2,4,13,12,39,-27,10,R,EN_D1,Maine Road,Manchester
1995/96,36,17,Queens Park Rangers,19,37,9,6,22,38,54,-16,33,19,6,5,8,25,26,-1,23,18,3,1,14,13,28,-15,10,R,EN_D1,Loftus Road,London
1995/96,36,27,Bolton Wanderers,20,37,8,5,24,38,69,-31,29,19,5,4,10,16,31,-15,19,18,3,1,14,22,38,-16,10,R,EN_D1,Burnden Park,Bolton
1995/96,37,12,Manchester United,1,37,24,7,6,70,35,35,79,19,15,4,0,36,9,27,49,18,9,3,6,34,26,8,30,Q,EU_CL,Old Trafford,Manchester
1995/96,37,23,Newcastle United,2,37,24,5,8,65,36,29,77,18,17,0,1,37,8,29,51,19,7,5,7,28,28,0,26,Q,EU_UC,St. James' Park,Newcastle
1995/96,37,10,Liverpool,3,37,20,10,7,68,32,36,70,19,14,4,1,46,13,33,46,18,6,6,6,22,19,3,24,Q,EU_CWC,Anfield,Liverpool
1995/96,37,2,Aston Villa,4,37,18,9,10,52,34,18,63,19,11,5,3,32,15,17,38,18,7,4,7,20,19,1,25,Q,EU_UC,Villa Park,Birmingham
1995/96,37,1,Arsenal,5,37,16,12,9,47,31,16,60,18,9,7,2,28,15,13,34,19,7,5,7,19,16,3,26,Q,EU_UC,Highbury,London
1995/96,37,21,Tottenham Hotspur,6,37,16,12,9,49,37,12,60,19,9,5,5,26,19,7,32,18,7,7,4,23,18,5,28,,,White Hart Lane,London
1995/96,37,7,Everton,7,37,16,10,11,63,44,19,58,18,9,5,4,34,19,15,32,19,7,5,7,29,25,4,26,,,Goodison Park,Liverpool
1995/96,37,3,Blackburn Rovers,8,37,17,7,13,58,45,13,58,19,14,2,3,44,19,25,44,18,3,5,10,14,26,-12,14,,,Ewood Park,Blackburn
1995/96,37,15,Nottingham Forest,9,37,14,13,10,47,54,-7,55,18,10,6,2,26,17,9,36,19,4,7,8,21,37,-16,19,,,City Ground,Nottingham
1995/96,37,4,Chelsea,10,37,12,14,11,44,41,3,50,18,7,7,4,28,19,9,28,19,5,7,7,16,22,-6,22,,,Stamford Bridge,London
1995/96,37,25,West Ham United,11,37,14,8,15,42,51,-9,50,18,9,4,5,24,20,4,31,19,5,4,10,18,31,-13,19,,,Boleyn Ground,London
1995/96,37,13,Middlesbrough,12,37,11,10,16,35,47,-12,43,18,8,3,7,27,24,3,27,19,3,7,9,8,23,-15,16,,,Riverside Stadium,Middlesbrough
1995/96,37,9,Leeds United,13,37,12,6,19,40,57,-17,42,19,8,3,8,21,21,0,27,18,4,3,11,19,36,-17,15,,,Elland Road,Leeds
1995/96,37,22,Wimbledon,14,37,10,10,17,55,70,-15,40,19,5,6,8,27,33,-6,21,18,5,4,9,28,37,-9,19,,,Selhurst Park,London
1995/96,37,19,Sheffield Wednesday,15,37,10,9,18,47,60,-13,39,19,7,5,7,30,31,-1,26,18,3,4,11,17,29,-12,13,,,Hillsborough,Sheffield
1995/96,37,5,Coventry City,16,37,8,13,16,42,60,-18,37,18,6,6,6,21,23,-2,24,19,2,7,10,21,37,-16,13,,,Highfield Road,Coventry
1995/96,37,20,Southampton,17,37,9,10,18,34,52,-18,37,18,7,6,5,21,18,3,27,19,2,4,13,13,34,-21,10,,,The Dell,Southampton
1995/96,37,11,Manchester City,18,37,9,10,18,31,56,-25,37,18,7,6,5,19,17,2,27,19,2,4,13,12,39,-27,10,R,EN_D1,Maine Road,Manchester
1995/96,37,17,Queens Park Rangers,19,37,9,6,22,38,54,-16,33,19,6,5,8,25,26,-1,23,18,3,1,14,13,28,-15,10,R,EN_D1,Loftus Road,London
1995/96,37,27,Bolton Wanderers,20,37,8,5,24,38,69,-31,29,19,5,4,10,16,31,-15,19,18,3,1,14,22,38,-16,10,R,EN_D1,Burnden Park,Bolton
1995/96,38,12,Manchester United,1,38,25,7,6,73,35,38,82,19,15,4,0,36,9,27,49,19,10,3,6,37,26,11,33,Q,EU_CL,Old Trafford,Manchester
1995/96,38,23,Newcastle United,2,38,24,6,8,66,37,29,78,19,17,1,1,38,9,29,52,19,7,5,7,28,28,0,26,Q,EU_UC,St. James' Park,Newcastle
1995/96,38,10,Liverpool,3,38,20,11,7,70,34,36,71,19,14,4,1,46,13,33,46,19,6,7,6,24,21,3,25,Q,EU_CWC,Anfield,Liverpool
1995/96,38,2,Aston Villa,4,38,18,9,11,52,35,17,63,19,11,5,3,32,15,17,38,19,7,4,8,20,20,0,25,Q,EU_UC,Villa Park,Birmingham
1995/96,38,1,Arsenal,5,38,17,12,9,49,32,17,63,19,10,7,2,30,16,14,37,19,7,5,7,19,16,3,26,Q,EU_UC,Highbury,London
1995/96,38,7,Everton,6,38,17,10,11,64,44,20,61,19,10,5,4,35,19,16,35,19,7,5,7,29,25,4,26,,,Goodison Park,Liverpool
1995/96,38,3,Blackburn Rovers,7,38,18,7,13,61,47,14,61,19,14,2,3,44,19,25,44,19,4,5,10,17,28,-11,17,,,Ewood Park,Blackburn
1995/96,38,21,Tottenham Hotspur,8,38,16,13,9,50,38,12,61,19,9,5,5,26,19,7,32,19,7,8,4,24,19,5,29,,,White Hart Lane,London
1995/96,38,15,Nottingham Forest,9,38,15,13,10,50,54,-4,58,19,11,6,2,29,17,12,39,19,4,7,8,21,37,-16,19,,,City Ground,Nottingham
1995/96,38,25,West Ham United,10,38,14,9,15,43,52,-9,51,19,9,5,5,25,21,4,32,19,5,4,10,18,31,-13,19,,,Boleyn Ground,London
1995/96,38,4,Chelsea,11,38,12,14,12,46,44,2,50,19,7,7,5,30,22,8,28,19,5,7,7,16,22,-6,22,,,Stamford Bridge,London
1995/96,38,13,Middlesbrough,12,38,11,10,17,35,50,-15,43,19,8,3,8,27,27,0,27,19,3,7,9,8,23,-15,16,,,Riverside Stadium,Middlesbrough
1995/96,38,9,Leeds United,13,38,12,7,19,40,57,-17,43,19,8,3,8,21,21,0,27,19,4,4,11,19,36,-17,16,,,Elland Road,Leeds
1995/96,38,22,Wimbledon,14,38,10,11,17,55,70,-15,41,19,5,6,8,27,33,-6,21,19,5,5,9,28,37,-9,20,,,Selhurst Park,London
1995/96,38,19,Sheffield Wednesday,15,38,10,10,18,48,61,-13,40,19,7,5,7,30,31,-1,26,19,3,5,11,18,30,-12,14,,,Hillsborough,Sheffield
1995/96,38,5,Coventry City,16,38,8,14,16,42,60,-18,38,19,6,7,6,21,23,-2,25,19,2,7,10,21,37,-16,13,,,Highfield Road,Coventry
1995/96,38,20,Southampton,17,38,9,11,18,34,52,-18,38,19,7,7,5,21,18,3,28,19,2,4,13,13,34,-21,10,,,The Dell,Southampton
1995/96,38,11,Manchester City,18,38,9,11,18,33,58,-25,38,19,7,7,5,21,19,2,28,19,2,4,13,12,39,-27,10,R,EN_D1,Maine Road,Manchester
1995/96,38,17,Queens Park Rangers,19,38,9,6,23,38,57,-19,33,19,6,5,8,25,26,-1,23,19,3,1,15,13,31,-18,10,R,EN_D1,Loftus Road,London
1995/96,38,27,Bolton Wanderers,20,38,8,5,25,39,71,-32,29,19,5,4,10,16,31,-15,19,19,3,1,15,23,40,-17,10,R,EN_D1,Burnden Park,Bolton
