season,match_week,team_id,team_name,position,played,won,drawn,lost,goals_for,goals_against,goal_difference,points,home_played,home_won,home_drawn,home_lost,home_goals_for,home_goals_against,home_goal_difference,home_points,away_played,away_won,away_drawn,away_lost,away_goals_for,away_goals_against,away_goal_difference,away_points,annotation_types,annotation_destinations,stadium_name,stadium_city
1997/98,1,3,Blackburn Rovers,1,2,2,0,0,5,0,5,6,1,1,0,0,1,0,1,3,1,1,0,0,4,0,4,3,Q,EU_CL,Ewood Park,Blackburn
1997/98,1,12,Manchester United,2,2,2,0,0,3,0,3,6,1,1,0,0,1,0,1,3,1,1,0,0,2,0,2,3,Q,EU_CL,Old Trafford,Manchester
1997/98,1,25,West Ham United,3,2,2,0,0,4,2,2,6,1,1,0,0,2,1,1,3,1,1,0,0,2,1,1,3,Q,EU_UC,Boleyn Ground,London
1997/98,1,26,Leicester City,4,2,2,0,0,3,1,2,6,1,1,0,0,1,0,1,3,1,1,0,0,2,1,1,3,,,Filbert Street,Leicester
1997/98,1,9,Leeds United,5,2,1,1,0,4,2,2,4,1,0,1,0,1,1,0,1,1,1,0,0,3,1,2,3,Q,EU_UC,Elland Road,Leeds
1997/98,1,1,Arsenal,6,2,1,1,0,3,1,2,4,1,1,0,0,2,0,2,3,1,0,1,0,1,1,0,1,Q,EU_UC,Highbury,London
1997/98,1,23,Newcastle United,7,1,1,0,0,2,1,1,3,1,1,0,0,2,1,1,3,0,0,0,0,0,0,0,0,"Q,Q","EU_UC,EU_CWC",St. James' Park,Newcastle
1997/98,1,27,Bolton Wanderers,8,1,1,0,0,1,0,1,3,0,0,0,0,0,0,0,0,1,1,0,0,1,0,1,3,,,Macron Stadium,Bolton
1997/98,1,30,Barnsley,9,2,1,0,1,2,2,0,3,1,0,0,1,1,2,-1,0,1,1,0,0,1,0,1,3,,,Oakwell,Barnsley
1997/98,1,6,Crystal Palace,10,2,1,0,1,2,2,0,3,1,0,0,1,0,1,-1,0,1,1,0,0,2,1,1,3,Q,EU_IT,Selhurst Park,London
1997/98,1,5,Coventry City,11,2,1,0,1,3,4,-1,3,1,1,0,0,3,2,1,3,1,0,0,1,0,2,-2,0,,,Highfield Road,Coventry
1997/98,1,22,Wimbledon,12,1,0,1,0,1,1,0,1,1,0,1,0,1,1,0,1,0,0,0,0,0,0,0,0,,,Selhurst Park,London
1997/98,1,10,Liverpool,13,2,0,1,1,2,3,-1,1,1,0,0,1,1,2,-1,0,1,0,1,0,1,1,0,1,,,Anfield,Liverpool
1997/98,1,4,Chelsea,14,1,0,0,1,2,3,-1,0,0,0,0,0,0,0,0,0,1,0,0,1,2,3,-1,0,Q,EU_CWC,Stamford Bridge,London
1997/98,1,7,Everton,15,1,0,0,1,1,2,-1,0,1,0,0,1,1,2,-1,0,0,0,0,0,0,0,0,0,,,Goodison Park,Liverpool
1997/98,1,28,Derby County,16,1,0,0,1,0,1,-1,0,0,0,0,0,0,0,0,0,1,0,0,1,0,1,-1,0,,,Pride Park,Derby
1997/98,1,20,Southampton,17,2,0,0,2,0,2,-2,0,1,0,0,1,0,1,-1,0,1,0,0,1,0,1,-1,0,,,The Dell,Southampton
1997/98,1,19,Sheffield Wednesday,18,2,0,0,2,2,5,-3,0,1,0,0,1,1,3,-2,0,1,0,0,1,1,2,-1,0,R,EN_D1,Hillsborough,Sheffield
1997/98,1,21,Tottenham Hotspur,19,2,0,0,2,1,4,-3,0,1,0,0,1,0,2,-2,0,1,0,0,1,1,2,-1,0,R,EN_D1,White Hart Lane,London
1997/98,1,2,Aston Villa,20,2,0,0,2,0,5,-5,0,1,0,0,1,0,4,-4,0,1,0,0,1,0,1,-1,0,R,EN_D1,Villa Park,Birmingham
1997/98,2,3,Blackburn Rovers,1,4,3,1,0,13,3,10,10,3,2,1,0,9,3,6,7,1,1,0,0,4,0,4,3,Q,EU_CL,Ewood Park,Blackburn
1997/98,2,12,Manchester United,2,4,3,1,0,5,0,5,10,1,1,0,0,1,0,1,3,3,2,1,0,4,0,4,7,Q,EU_CL,Old Trafford,Manchester
1997/98,2,1,Arsenal,3,4,2,2,0,9,5,4,8,1,1,0,0,2,0,2,3,3,1,2,0,7,5,2,5,Q,EU_UC,Highbury,London
1997/98,2,26,Leicester City,4,4,2,2,0,6,4,2,8,3,1,2,0,4,3,1,5,1,1,0,0,2,1,1,3,,,Filbert Street,Leicester
1997/98,2,25,West Ham United,5,4,2,1,1,6,5,1,7,1,1,0,0,2,1,1,3,3,1,1,1,4,4,0,4,Q,EU_UC,Boleyn Ground,London
1997/98,2,4,Chelsea,6,3,2,0,1,10,3,7,6,0,0,0,0,0,0,0,0,3,2,0,1,10,3,7,6,"Q,Q","EU_CWC,EU_UC",Stamford Bridge,London
1997/98,2,23,Newcastle United,7,2,2,0,0,3,1,2,6,2,2,0,0,3,1,2,6,0,0,0,0,0,0,0,0,"Q,Q","EU_UC,EU_CWC",St. James' Park,Newcastle
1997/98,2,6,Crystal Palace,8,4,2,0,2,4,3,1,6,1,0,0,1,0,1,-1,0,3,2,0,1,4,2,2,6,Q,EU_IT,Selhurst Park,London
1997/98,2,21,Tottenham Hotspur,9,4,2,0,2,5,6,-1,6,3,2,0,1,4,4,0,6,1,0,0,1,1,2,-1,0,,,White Hart Lane,London
1997/98,2,30,Barnsley,10,4,2,0,2,4,9,-5,6,3,1,0,2,3,9,-6,3,1,1,0,0,1,0,1,3,,,Oakwell,Barnsley
1997/98,2,10,Liverpool,11,4,1,2,1,5,4,1,5,1,0,0,1,1,2,-1,0,3,1,2,0,4,2,2,5,,,Anfield,Liverpool
1997/98,2,5,Coventry City,12,4,1,2,1,6,7,-1,5,3,1,2,0,6,5,1,5,1,0,0,1,0,2,-2,0,,,Highfield Road,Coventry
1997/98,2,27,Bolton Wanderers,13,3,1,1,1,4,4,0,4,0,0,0,0,0,0,0,0,3,1,1,1,4,4,0,4,,,Macron Stadium,Bolton
1997/98,2,9,Leeds United,14,4,1,1,2,4,6,-2,4,3,0,1,2,1,5,-4,1,1,1,0,0,3,1,2,3,,,Elland Road,Leeds
1997/98,2,7,Everton,15,3,1,0,2,3,5,-2,3,3,1,0,2,3,5,-2,3,0,0,0,0,0,0,0,0,,,Goodison Park,Liverpool
1997/98,2,20,Southampton,16,4,1,0,3,2,5,-3,3,3,1,0,2,2,4,-2,3,1,0,0,1,0,1,-1,0,,,The Dell,Southampton
1997/98,2,22,Wimbledon,17,3,0,2,1,2,4,-2,2,3,0,2,1,2,4,-2,2,0,0,0,0,0,0,0,0,,,Selhurst Park,London
1997/98,2,19,Sheffield Wednesday,18,4,0,1,3,5,13,-8,1,1,0,0,1,1,3,-2,0,3,0,1,2,4,10,-6,1,R,EN_D1,Hillsborough,Sheffield
1997/98,2,28,Derby County,19,2,0,0,2,0,2,-2,0,0,0,0,0,0,0,0,0,2,0,0,2,0,2,-2,0,R,EN_D1,Pride Park,Derby
1997/98,2,2,Aston Villa,20,4,0,0,4,2,9,-7,0,1,0,0,1,0,4,-4,0,3,0,0,3,2,5,-3,0,R,EN_D1,Villa Park,Birmingham
1997/98,3,3,Blackburn Rovers,1,5,4,1,0,15,4,11,13,3,2,1,0,9,3,6,7,2,2,0,0,6,1,5,6,Q,EU_CL,Ewood Park,Blackburn
1997/98,3,12,Manchester United,2,5,4,1,0,8,0,8,13,2,2,0,0,4,0,4,6,3,2,1,0,4,0,4,7,Q,EU_CL,Old Trafford,Manchester
1997/98,3,25,West Ham United,3,5,3,1,1,9,6,3,10,2,2,0,0,5,2,3,6,3,1,1,1,4,4,0,4,Q,EU_UC,Boleyn Ground,London
1997/98,3,4,Chelsea,4,4,3,0,1,14,5,9,9,1,1,0,0,4,2,2,3,3,2,0,1,10,3,7,6,Q,EU_CWC,Stamford Bridge,London
1997/98,3,1,Arsenal,5,5,2,3,0,9,5,4,9,2,1,1,0,2,0,2,4,3,1,2,0,7,5,2,5,Q,EU_UC,Highbury,London
1997/98,3,26,Leicester City,6,5,2,2,1,6,5,1,8,3,1,2,0,4,3,1,5,2,1,0,1,2,2,0,3,Q,EU_UC,Filbert Street,Leicester
1997/98,3,21,Tottenham Hotspur,7,5,2,1,2,5,6,-1,7,3,2,0,1,4,4,0,6,2,0,1,1,1,2,-1,1,Q,EU_UC,White Hart Lane,London
1997/98,3,23,Newcastle United,8,2,2,0,0,3,1,2,6,2,2,0,0,3,1,2,6,0,0,0,0,0,0,0,0,Q,EU_CWC,St. James' Park,Newcastle
1997/98,3,6,Crystal Palace,9,5,2,0,3,5,5,0,6,2,0,0,2,1,3,-2,0,3,2,0,1,4,2,2,6,Q,EU_IT,Selhurst Park,London
1997/98,3,30,Barnsley,10,5,2,0,3,4,10,-6,6,3,1,0,2,3,9,-6,3,2,1,0,1,1,1,0,3,,,Oakwell,Barnsley
1997/98,3,10,Liverpool,11,4,1,2,1,5,4,1,5,1,0,0,1,1,2,-1,0,3,1,2,0,4,2,2,5,,,Anfield,Liverpool
1997/98,3,27,Bolton Wanderers,12,4,1,2,1,4,4,0,5,1,0,1,0,0,0,0,1,3,1,1,1,4,4,0,4,,,Macron Stadium,Bolton
1997/98,3,5,Coventry City,13,5,1,2,2,6,10,-4,5,3,1,2,0,6,5,1,5,2,0,0,2,0,5,-5,0,,,Highfield Road,Coventry
1997/98,3,7,Everton,14,4,1,1,2,3,5,-2,4,3,1,0,2,3,5,-2,3,1,0,1,0,0,0,0,1,,,Goodison Park,Liverpool
1997/98,3,9,Leeds United,15,5,1,1,3,4,7,-3,4,3,0,1,2,1,5,-4,1,2,1,0,1,3,2,1,3,,,Elland Road,Leeds
1997/98,3,19,Sheffield Wednesday,16,5,1,1,3,6,13,-7,4,2,1,0,1,2,3,-1,3,3,0,1,2,4,10,-6,1,,,Hillsborough,Sheffield
1997/98,3,28,Derby County,17,3,1,0,2,1,2,-1,3,1,1,0,0,1,0,1,3,2,0,0,2,0,2,-2,0,,,Pride Park,Derby
1997/98,3,20,Southampton,18,5,1,0,4,4,9,-5,3,3,1,0,2,2,4,-2,3,2,0,0,2,2,5,-3,0,R,EN_D1,The Dell,Southampton
1997/98,3,2,Aston Villa,19,5,1,0,4,3,9,-6,3,2,1,0,1,1,4,-3,3,3,0,0,3,2,5,-3,0,R,EN_D1,Villa Park,Birmingham
1997/98,3,22,Wimbledon,20,4,0,2,2,3,7,-4,2,3,0,2,1,2,4,-2,2,1,0,0,1,1,3,-2,0,R,EN_D1,Selhurst Park,London
1997/98,4,12,Manchester United,1,6,5,1,0,10,1,9,16,3,3,0,0,6,1,5,9,3,2,1,0,4,0,4,7,Q,EU_CL,Old Trafford,Manchester
1997/98,4,3,Blackburn Rovers,2,6,4,1,1,18,8,10,13,4,2,1,1,12,7,5,7,2,2,0,0,6,1,5,6,Q,EU_CL,Ewood Park,Blackburn
1997/98,4,4,Chelsea,3,5,4,0,1,17,5,12,12,1,1,0,0,4,2,2,3,4,3,0,1,13,3,10,9,"Q,Q","EU_UC,EU_CWC",Stamford Bridge,London
1997/98,4,1,Arsenal,4,6,3,3,0,13,6,7,12,3,2,1,0,6,1,5,7,3,1,2,0,7,5,2,5,,,Highbury,London
1997/98,4,26,Leicester City,5,6,3,2,1,9,5,4,11,4,2,2,0,7,3,4,8,2,1,0,1,2,2,0,3,Q,EU_UC,Filbert Street,Leicester
1997/98,4,25,West Ham United,6,6,3,1,2,10,8,2,10,2,2,0,0,5,2,3,6,4,1,1,2,5,6,-1,4,Q,EU_UC,Boleyn Ground,London
1997/98,4,10,Liverpool,7,5,2,2,1,7,5,2,8,2,1,0,1,3,3,0,3,3,1,2,0,4,2,2,5,Q,EU_UC,Anfield,Liverpool
1997/98,4,5,Coventry City,8,6,2,2,2,7,10,-3,8,4,2,2,0,7,5,2,8,2,0,0,2,0,5,-5,0,,,Highfield Road,Coventry
1997/98,4,9,Leeds United,9,6,2,1,3,8,10,-2,7,3,0,1,2,1,5,-4,1,3,2,0,1,7,5,2,6,,,Elland Road,Leeds
1997/98,4,21,Tottenham Hotspur,10,6,2,1,3,5,9,-4,7,3,2,0,1,4,4,0,6,3,0,1,2,1,5,-4,1,,,White Hart Lane,London
1997/98,4,28,Derby County,11,4,2,0,2,4,3,1,6,2,2,0,0,4,1,3,6,2,0,0,2,0,2,-2,0,,,Pride Park,Derby
1997/98,4,23,Newcastle United,12,3,2,0,1,4,4,0,6,3,2,0,1,4,4,0,6,0,0,0,0,0,0,0,0,Q,EU_CWC,St. James' Park,Newcastle
1997/98,4,2,Aston Villa,13,6,2,0,4,6,9,-3,6,2,1,0,1,1,4,-3,3,4,1,0,3,5,5,0,3,,,Villa Park,Birmingham
1997/98,4,6,Crystal Palace,14,6,2,0,4,5,8,-3,6,3,0,0,3,1,6,-5,0,3,2,0,1,4,2,2,6,Q,EU_IT,Selhurst Park,London
1997/98,4,30,Barnsley,15,6,2,0,4,4,13,-9,6,4,1,0,3,3,12,-9,3,2,1,0,1,1,1,0,3,,,Oakwell,Barnsley
1997/98,4,22,Wimbledon,16,5,1,2,2,6,8,-2,5,3,0,2,1,2,4,-2,2,2,1,0,1,4,4,0,3,,,Selhurst Park,London
1997/98,4,27,Bolton Wanderers,17,5,1,2,2,5,8,-3,5,1,0,1,0,0,0,0,1,4,1,1,2,5,8,-3,4,,,Macron Stadium,Bolton
1997/98,4,7,Everton,18,5,1,1,3,4,8,-4,4,3,1,0,2,3,5,-2,3,2,0,1,1,1,3,-2,1,R,EN_D1,Goodison Park,Liverpool
1997/98,4,19,Sheffield Wednesday,19,6,1,1,4,7,15,-8,4,2,1,0,1,2,3,-1,3,4,0,1,3,5,12,-7,1,R,EN_D1,Hillsborough,Sheffield
1997/98,4,20,Southampton,20,6,1,0,5,4,10,-6,3,3,1,0,2,2,4,-2,3,3,0,0,3,2,6,-4,0,R,EN_D1,The Dell,Southampton
1997/98,5,1,Arsenal,1,8,5,3,0,20,8,12,18,4,3,1,0,10,1,9,10,4,2,2,0,10,7,3,8,Q,EU_CL,Highbury,London
1997/98,5,12,Manchester United,2,8,5,3,0,12,3,9,18,4,3,1,0,8,3,5,10,4,2,2,0,4,0,4,8,Q,EU_CL,Old Trafford,Manchester
1997/98,5,3,Blackburn Rovers,3,8,4,3,1,19,9,10,15,4,2,1,1,12,7,5,7,4,2,2,0,7,2,5,8,Q,EU_UC,Ewood Park,Blackburn
1997/98,5,26,Leicester City,4,8,4,3,1,11,6,5,15,5,2,3,0,8,4,4,9,3,2,0,1,3,2,1,6,,,Filbert Street,Leicester
1997/98,5,4,Chelsea,5,7,4,1,2,21,10,11,13,2,1,0,1,6,5,1,3,5,3,1,1,15,5,10,10,"Q,Q","EU_CWC,EU_UC",Stamford Bridge,London
1997/98,5,10,Liverpool,6,7,3,3,1,11,6,5,12,3,2,0,1,6,3,3,6,4,1,3,0,5,3,2,6,Q,EU_UC,Anfield,Liverpool
1997/98,5,23,Newcastle United,7,5,4,0,1,6,4,2,12,4,3,0,1,5,4,1,9,1,1,0,0,1,0,1,3,"Q,Q","EU_UC,EU_CWC",St. James' Park,Newcastle
1997/98,5,9,Leeds United,8,8,3,1,4,10,11,-1,10,4,0,1,3,1,6,-5,1,4,3,0,1,9,5,4,9,,,Elland Road,Leeds
1997/98,5,6,Crystal Palace,9,8,3,1,4,7,9,-2,10,3,0,0,3,1,6,-5,0,5,3,1,1,6,3,3,10,Q,EU_IT,Selhurst Park,London
1997/98,5,25,West Ham United,10,8,3,1,4,10,13,-3,10,3,2,0,1,5,3,2,6,5,1,1,3,5,10,-5,4,,,Boleyn Ground,London
1997/98,5,5,Coventry City,11,8,2,4,2,8,11,-3,10,5,2,3,0,8,6,2,9,3,0,1,2,0,5,-5,1,,,Highfield Road,Coventry
1997/98,5,28,Derby County,12,6,3,0,3,10,7,3,9,2,2,0,0,4,1,3,6,4,1,0,3,6,6,0,3,,,Pride Park,Derby
1997/98,5,21,Tottenham Hotspur,13,8,2,3,3,6,10,-4,9,4,2,1,1,4,4,0,7,4,0,2,2,2,6,-4,2,,,White Hart Lane,London
1997/98,5,2,Aston Villa,14,8,3,0,5,8,13,-5,9,3,2,0,1,3,5,-2,6,5,1,0,4,5,8,-3,3,,,Villa Park,Birmingham
1997/98,5,22,Wimbledon,15,7,2,2,3,10,10,0,8,5,1,2,2,6,6,0,5,2,1,0,1,4,4,0,3,,,Selhurst Park,London
1997/98,5,7,Everton,16,7,2,1,4,8,11,-3,7,4,2,0,2,7,7,0,6,3,0,1,2,1,4,-3,1,,,Goodison Park,Liverpool
1997/98,5,27,Bolton Wanderers,17,7,1,4,2,6,9,-3,7,3,0,3,0,1,1,0,3,4,1,1,2,5,8,-3,4,,,Macron Stadium,Bolton
1997/98,5,30,Barnsley,18,8,2,0,6,7,21,-14,6,4,1,0,3,3,12,-9,3,4,1,0,3,4,9,-5,3,R,EN_D1,Oakwell,Barnsley
1997/98,5,19,Sheffield Wednesday,19,8,1,2,5,9,20,-11,5,4,1,1,2,4,8,-4,4,4,0,1,3,5,12,-7,1,R,EN_D1,Hillsborough,Sheffield
1997/98,5,20,Southampton,20,8,1,1,6,5,13,-8,4,5,1,1,3,3,7,-4,4,3,0,0,3,2,6,-4,0,R,EN_D1,The Dell,Southampton
1997/98,6,1,Arsenal,1,9,5,4,0,22,10,12,19,4,3,1,0,10,1,9,10,5,2,3,0,12,9,3,9,Q,EU_CL,Highbury,London
1997/98,6,12,Manchester United,2,9,5,3,1,12,4,8,18,4,3,1,0,8,3,5,10,5,2,2,1,4,1,3,8,Q,EU_CL,Old Trafford,Manchester
1997/98,6,26,Leicester City,3,9,5,3,1,13,6,7,18,5,2,3,0,8,4,4,9,4,3,0,1,5,2,3,9,Q,EU_UC,Filbert Street,Leicester
1997/98,6,4,Chelsea,4,8,5,1,2,22,10,12,16,3,2,0,1,7,5,2,6,5,3,1,1,15,5,10,10,Q,EU_CWC,Stamford Bridge,London
1997/98,6,3,Blackburn Rovers,5,9,4,4,1,19,9,10,16,5,2,2,1,12,7,5,8,4,2,2,0,7,2,5,8,Q,EU_UC,Ewood Park,Blackburn
1997/98,6,9,Leeds United,6,9,4,1,4,11,11,0,13,5,1,1,3,2,6,-4,4,4,3,0,1,9,5,4,9,Q,EU_UC,Elland Road,Leeds
1997/98,6,25,West Ham United,7,9,4,1,4,12,14,-2,13,4,3,0,1,7,4,3,9,5,1,1,3,5,10,-5,4,Q,EU_UC,Boleyn Ground,London
1997/98,6,28,Derby County,8,7,4,0,3,14,7,7,12,3,3,0,0,8,1,7,9,4,1,0,3,6,6,0,3,,,Pride Park,Derby
1997/98,6,10,Liverpool,9,8,3,3,2,12,8,4,12,3,2,0,1,6,3,3,6,5,1,3,1,6,5,1,6,,,Anfield,Liverpool
1997/98,6,23,Newcastle United,10,6,4,0,2,6,5,1,12,4,3,0,1,5,4,1,9,2,1,0,1,1,1,0,3,Q,EU_CWC,St. James' Park,Newcastle
1997/98,6,6,Crystal Palace,11,9,3,2,4,9,11,-2,11,4,0,1,3,3,8,-5,1,5,3,1,1,6,3,3,10,Q,EU_IT,Selhurst Park,London
1997/98,6,5,Coventry City,12,9,2,5,2,8,11,-3,11,5,2,3,0,8,6,2,9,4,0,2,2,0,5,-5,2,,,Highfield Road,Coventry
1997/98,6,21,Tottenham Hotspur,13,9,2,4,3,6,10,-4,10,5,2,2,1,4,4,0,8,4,0,2,2,2,6,-4,2,,,White Hart Lane,London
1997/98,6,2,Aston Villa,14,9,3,1,5,10,15,-5,10,4,2,1,1,5,7,-2,7,5,1,0,4,5,8,-3,3,,,Villa Park,Birmingham
1997/98,6,22,Wimbledon,15,8,2,3,3,10,10,0,9,5,1,2,2,6,6,0,5,3,1,1,1,4,4,0,4,,,Selhurst Park,London
1997/98,6,7,Everton,16,8,2,2,4,10,13,-3,8,5,2,1,2,9,9,0,7,3,0,1,2,1,4,-3,1,,,Goodison Park,Liverpool
1997/98,6,27,Bolton Wanderers,17,8,1,5,2,8,11,-3,8,3,0,3,0,1,1,0,3,5,1,2,2,7,10,-3,5,,,Macron Stadium,Bolton
1997/98,6,19,Sheffield Wednesday,18,9,1,3,5,11,22,-11,6,4,1,1,2,4,8,-4,4,5,0,2,3,7,14,-7,2,R,EN_D1,Hillsborough,Sheffield
1997/98,6,30,Barnsley,19,9,2,0,7,7,23,-16,6,5,1,0,4,3,14,-11,3,4,1,0,3,4,9,-5,3,R,EN_D1,Oakwell,Barnsley
1997/98,6,20,Southampton,20,9,1,1,7,5,17,-12,4,5,1,1,3,3,7,-4,4,4,0,0,4,2,10,-8,0,R,EN_D1,The Dell,Southampton
1997/98,7,1,Arsenal,1,10,6,4,0,27,10,17,22,5,4,1,0,15,1,14,13,5,2,3,0,12,9,3,9,Q,EU_CL,Highbury,London
1997/98,7,12,Manchester United,2,10,6,3,1,14,4,10,21,5,4,1,0,10,3,7,13,5,2,2,1,4,1,3,8,Q,EU_CL,Old Trafford,Manchester
1997/98,7,3,Blackburn Rovers,3,10,5,4,1,20,9,11,19,5,2,2,1,12,7,5,8,5,3,2,0,8,2,6,11,Q,EU_UC,Ewood Park,Blackburn
1997/98,7,26,Leicester City,4,10,5,3,2,14,8,6,18,6,2,3,1,9,6,3,9,4,3,0,1,5,2,3,9,,,Filbert Street,Leicester
1997/98,7,4,Chelsea,5,9,5,1,3,24,14,10,16,3,2,0,1,7,5,2,6,6,3,1,2,17,9,8,10,"Q,Q","EU_CWC,EU_UC",Stamford Bridge,London
1997/98,7,28,Derby County,6,8,5,0,3,16,8,8,15,3,3,0,0,8,1,7,9,5,2,0,3,8,7,1,6,Q,EU_UC,Pride Park,Derby
1997/98,7,10,Liverpool,7,9,4,3,2,16,10,6,15,4,3,0,1,10,5,5,9,5,1,3,1,6,5,1,6,Q,EU_UC,Anfield,Liverpool
1997/98,7,23,Newcastle United,8,7,5,0,2,7,5,2,15,5,4,0,1,6,4,2,12,2,1,0,1,1,1,0,3,Q,EU_CWC,St. James' Park,Newcastle
1997/98,7,9,Leeds United,9,10,4,2,4,11,11,0,14,5,1,1,3,2,6,-4,4,5,3,1,1,9,5,4,10,,,Elland Road,Leeds
1997/98,7,2,Aston Villa,10,10,4,1,5,11,15,-4,13,4,2,1,1,5,7,-2,7,6,2,0,4,6,8,-2,6,,,Villa Park,Birmingham
1997/98,7,25,West Ham United,11,10,4,1,5,12,17,-5,13,4,3,0,1,7,4,3,9,6,1,1,4,5,13,-8,4,,,Boleyn Ground,London
1997/98,7,5,Coventry City,12,10,2,6,2,8,11,-3,12,6,2,4,0,8,6,2,10,4,0,2,2,0,5,-5,2,,,Highfield Road,Coventry
1997/98,7,6,Crystal Palace,13,10,3,2,5,9,13,-4,11,4,0,1,3,3,8,-5,1,6,3,1,2,6,5,1,10,Q,EU_IT,Selhurst Park,London
1997/98,7,21,Tottenham Hotspur,14,10,2,4,4,6,11,-5,10,5,2,2,1,4,4,0,8,5,0,2,3,2,7,-5,2,,,White Hart Lane,London
1997/98,7,22,Wimbledon,15,9,2,3,4,10,11,-1,9,6,1,2,3,6,7,-1,5,3,1,1,1,4,4,0,4,,,Selhurst Park,London
1997/98,7,19,Sheffield Wednesday,16,10,2,3,5,14,23,-9,9,5,2,1,2,7,9,-2,7,5,0,2,3,7,14,-7,2,,,Hillsborough,Sheffield
1997/98,7,27,Bolton Wanderers,17,9,1,5,3,8,12,-4,8,4,0,3,1,1,2,-1,3,5,1,2,2,7,10,-3,5,,,Macron Stadium,Bolton
1997/98,7,7,Everton,18,9,2,2,5,11,16,-5,8,5,2,1,2,9,9,0,7,4,0,1,3,2,7,-5,1,R,EN_D1,Goodison Park,Liverpool
1997/98,7,20,Southampton,19,10,2,1,7,8,17,-9,7,6,2,1,3,6,7,-1,7,4,0,0,4,2,10,-8,0,R,EN_D1,The Dell,Southampton
1997/98,7,30,Barnsley,20,10,2,0,8,7,28,-21,6,5,1,0,4,3,14,-11,3,5,1,0,4,4,14,-10,3,R,EN_D1,Oakwell,Barnsley
1997/98,8,1,Arsenal,1,11,6,5,0,27,10,17,23,5,4,1,0,15,1,14,13,6,2,4,0,12,9,3,10,Q,EU_CL,Highbury,London
1997/98,8,3,Blackburn Rovers,2,11,6,4,1,21,9,12,22,6,3,2,1,13,7,6,11,5,3,2,0,8,2,6,11,Q,EU_CL,Ewood Park,Blackburn
1997/98,8,12,Manchester United,3,11,6,4,1,16,6,10,22,5,4,1,0,10,3,7,13,6,2,3,1,6,3,3,9,Q,EU_UC,Old Trafford,Manchester
1997/98,8,4,Chelsea,4,10,6,1,3,25,14,11,19,4,3,0,1,8,5,3,9,6,3,1,2,17,9,8,10,Q,EU_CWC,Stamford Bridge,London
1997/98,8,26,Leicester City,5,11,5,3,3,14,9,5,18,6,2,3,1,9,6,3,9,5,3,0,2,5,3,2,9,Q,EU_UC,Filbert Street,Leicester
1997/98,8,28,Derby County,6,10,5,2,3,19,11,8,17,5,3,2,0,11,4,7,11,5,2,0,3,8,7,1,6,Q,EU_UC,Pride Park,Derby
1997/98,8,9,Leeds United,7,11,5,2,4,15,12,3,17,6,2,1,3,6,7,-1,7,5,3,1,1,9,5,4,10,Q,EU_UC,Elland Road,Leeds
1997/98,8,25,West Ham United,8,11,5,1,5,15,17,-2,16,5,4,0,1,10,4,6,12,6,1,1,4,5,13,-8,4,,,Boleyn Ground,London
1997/98,8,10,Liverpool,9,10,4,3,3,16,12,4,15,4,3,0,1,10,5,5,9,6,1,3,2,6,7,-1,6,,,Anfield,Liverpool
1997/98,8,23,Newcastle United,10,8,5,0,3,8,9,-1,15,5,4,0,1,6,4,2,12,3,1,0,2,2,5,-3,3,Q,EU_CWC,St. James' Park,Newcastle
1997/98,8,22,Wimbledon,11,11,3,4,4,13,13,0,13,6,1,2,3,6,7,-1,5,5,2,2,1,7,6,1,8,,,Selhurst Park,London
1997/98,8,21,Tottenham Hotspur,12,11,3,4,4,9,13,-4,13,6,3,2,1,7,6,1,11,5,0,2,3,2,7,-5,2,,,White Hart Lane,London
1997/98,8,2,Aston Villa,13,11,4,1,6,12,17,-5,13,5,2,1,2,6,9,-3,7,6,2,0,4,6,8,-2,6,,,Villa Park,Birmingham
1997/98,8,6,Crystal Palace,14,11,3,3,5,9,13,-4,12,5,0,2,3,3,8,-5,2,6,3,1,2,6,5,1,10,Q,EU_IT,Selhurst Park,London
1997/98,8,5,Coventry City,15,11,2,6,3,8,13,-5,12,6,2,4,0,8,6,2,10,5,0,2,3,0,7,-7,2,,,Highfield Road,Coventry
1997/98,8,7,Everton,16,10,3,2,5,13,16,-3,11,6,3,1,2,11,9,2,10,4,0,1,3,2,7,-5,1,,,Goodison Park,Liverpool
1997/98,8,19,Sheffield Wednesday,17,11,2,3,6,16,26,-10,9,5,2,1,2,7,9,-2,7,6,0,2,4,9,17,-8,2,,,Hillsborough,Sheffield
1997/98,8,30,Barnsley,18,11,3,0,8,9,28,-19,9,6,2,0,4,5,14,-9,6,5,1,0,4,4,14,-10,3,R,EN_D1,Oakwell,Barnsley
1997/98,8,27,Bolton Wanderers,19,10,1,5,4,8,15,-7,8,4,0,3,1,1,2,-1,3,6,1,2,3,7,13,-6,5,R,EN_D1,Macron Stadium,Bolton
1997/98,8,20,Southampton,20,11,2,1,8,8,18,-10,7,6,2,1,3,6,7,-1,7,5,0,0,5,2,11,-9,0,R,EN_D1,The Dell,Southampton
1997/98,9,12,Manchester United,1,12,7,4,1,23,6,17,25,6,5,1,0,17,3,14,16,6,2,3,1,6,3,3,9,Q,EU_CL,Old Trafford,Manchester
1997/98,9,1,Arsenal,2,12,6,6,0,27,10,17,24,6,4,2,0,15,1,14,14,6,2,4,0,12,9,3,10,Q,EU_CL,Highbury,London
1997/98,9,3,Blackburn Rovers,3,12,6,5,1,22,10,12,23,6,3,2,1,13,7,6,11,6,3,3,0,9,3,6,12,Q,EU_UC,Ewood Park,Blackburn
1997/98,9,26,Leicester City,4,12,6,3,3,16,10,6,21,7,3,3,1,11,7,4,12,5,3,0,2,5,3,2,9,,,Filbert Street,Leicester
1997/98,9,4,Chelsea,5,11,6,1,4,25,15,10,19,4,3,0,1,8,5,3,9,7,3,1,3,17,10,7,10,"Q,Q","EU_CWC,EU_UC",Stamford Bridge,London
1997/98,9,10,Liverpool,6,11,5,3,3,20,12,8,18,5,4,0,1,14,5,9,12,6,1,3,2,6,7,-1,6,Q,EU_UC,Anfield,Liverpool
1997/98,9,28,Derby County,7,11,5,2,4,19,15,4,17,5,3,2,0,11,4,7,11,6,2,0,4,8,11,-3,6,Q,EU_UC,Pride Park,Derby
1997/98,9,9,Leeds United,8,12,5,2,5,15,13,2,17,6,2,1,3,6,7,-1,7,6,3,1,2,9,6,3,10,,,Elland Road,Leeds
1997/98,9,22,Wimbledon,9,12,4,4,4,14,13,1,16,7,2,2,3,7,7,0,8,5,2,2,1,7,6,1,8,,,Selhurst Park,London
1997/98,9,23,Newcastle United,10,9,5,1,3,9,10,-1,16,6,4,1,1,7,5,2,13,3,1,0,2,2,5,-3,3,Q,EU_CWC,St. James' Park,Newcastle
1997/98,9,25,West Ham United,11,12,5,1,6,16,19,-3,16,5,4,0,1,10,4,6,12,7,1,1,5,6,15,-9,4,,,Boleyn Ground,London
1997/98,9,6,Crystal Palace,12,12,4,3,5,12,14,-2,15,5,0,2,3,3,8,-5,2,7,4,1,2,9,6,3,13,Q,EU_IT,Selhurst Park,London
1997/98,9,2,Aston Villa,13,12,4,2,6,12,17,-5,14,5,2,1,2,6,9,-3,7,7,2,1,4,6,8,-2,7,,,Villa Park,Birmingham
1997/98,9,21,Tottenham Hotspur,14,12,3,4,5,11,16,-5,13,6,3,2,1,7,6,1,11,6,0,2,4,4,10,-6,2,,,White Hart Lane,London
1997/98,9,5,Coventry City,15,12,2,7,3,8,13,-5,13,7,2,5,0,8,6,2,11,5,0,2,3,0,7,-7,2,,,Highfield Road,Coventry
1997/98,9,7,Everton,16,11,3,3,5,13,16,-3,12,6,3,1,2,11,9,2,10,5,0,2,3,2,7,-5,2,,,Goodison Park,Liverpool
1997/98,9,27,Bolton Wanderers,17,11,2,5,4,9,15,-6,11,5,1,3,1,2,2,0,6,6,1,2,3,7,13,-6,5,,,Macron Stadium,Bolton
1997/98,9,20,Southampton,18,12,3,1,8,11,20,-9,10,7,3,1,3,9,9,0,10,5,0,0,5,2,11,-9,0,R,EN_D1,The Dell,Southampton
1997/98,9,19,Sheffield Wednesday,19,12,2,3,7,17,29,-12,9,6,2,1,3,8,12,-4,7,6,0,2,4,9,17,-8,2,R,EN_D1,Hillsborough,Sheffield
1997/98,9,30,Barnsley,20,12,3,0,9,9,35,-26,9,6,2,0,4,5,14,-9,6,6,1,0,5,4,21,-17,3,R,EN_D1,Oakwell,Barnsley
1997/98,10,12,Manchester United,1,13,8,4,1,29,7,22,28,7,6,1,0,23,4,19,19,6,2,3,1,6,3,3,9,Q,EU_CL,Old Trafford,Manchester
1997/98,10,1,Arsenal,2,13,6,6,1,27,13,14,24,6,4,2,0,15,1,14,14,7,2,4,1,12,12,0,10,Q,EU_CL,Highbury,London
1997/98,10,3,Blackburn Rovers,3,13,6,6,1,23,11,12,24,6,3,2,1,13,7,6,11,7,3,4,0,10,4,6,13,Q,EU_UC,Ewood Park,Blackburn
1997/98,10,4,Chelsea,4,12,7,1,4,27,15,12,22,4,3,0,1,8,5,3,9,8,4,1,3,19,10,9,13,Q,EU_CWC,Stamford Bridge,London
1997/98,10,26,Leicester City,5,13,6,4,3,19,13,6,22,7,3,3,1,11,7,4,12,6,3,1,2,8,6,2,10,Q,EU_UC,Filbert Street,Leicester
1997/98,10,28,Derby County,6,12,6,2,4,22,15,7,20,6,4,2,0,14,4,10,14,6,2,0,4,8,11,-3,6,Q,EU_UC,Pride Park,Derby
1997/98,10,9,Leeds United,7,13,6,2,5,16,13,3,20,6,2,1,3,6,7,-1,7,7,4,1,2,10,6,4,13,Q,EU_UC,Elland Road,Leeds
1997/98,10,10,Liverpool,8,12,5,4,3,21,13,8,19,5,4,0,1,14,5,9,12,7,1,4,2,7,8,-1,7,,,Anfield,Liverpool
1997/98,10,23,Newcastle United,9,10,5,2,3,12,13,-1,17,7,4,2,1,10,8,2,14,3,1,0,2,2,5,-3,3,Q,EU_CWC,St. James' Park,Newcastle
1997/98,10,22,Wimbledon,10,13,4,4,5,15,15,0,16,8,2,2,4,8,9,-1,8,5,2,2,1,7,6,1,8,,,Selhurst Park,London
1997/98,10,25,West Ham United,11,12,5,1,6,16,19,-3,16,5,4,0,1,10,4,6,12,7,1,1,5,6,15,-9,4,,,Boleyn Ground,London
1997/98,10,5,Coventry City,12,13,3,7,3,10,14,-4,16,7,2,5,0,8,6,2,11,6,1,2,3,2,8,-6,5,,,Highfield Road,Coventry
1997/98,10,6,Crystal Palace,13,12,4,3,5,12,14,-2,15,5,0,2,3,3,8,-5,2,7,4,1,2,9,6,3,13,Q,EU_IT,Selhurst Park,London
1997/98,10,2,Aston Villa,14,13,4,2,7,12,19,-7,14,6,2,1,3,6,11,-5,7,7,2,1,4,6,8,-2,7,,,Villa Park,Birmingham
1997/98,10,21,Tottenham Hotspur,15,13,3,4,6,11,17,-6,13,7,3,2,2,7,7,0,11,6,0,2,4,4,10,-6,2,,,White Hart Lane,London
1997/98,10,20,Southampton,16,13,4,1,8,13,20,-7,13,7,3,1,3,9,9,0,10,6,1,0,5,4,11,-7,3,,,The Dell,Southampton
1997/98,10,7,Everton,17,12,3,3,6,13,18,-5,12,7,3,1,3,11,11,0,10,5,0,2,3,2,7,-5,2,,,Goodison Park,Liverpool
1997/98,10,27,Bolton Wanderers,18,12,2,6,4,10,16,-6,12,6,1,4,1,3,3,0,7,6,1,2,3,7,13,-6,5,R,EN_D1,Macron Stadium,Bolton
1997/98,10,30,Barnsley,19,13,3,1,9,10,36,-26,10,7,2,1,4,6,15,-9,7,6,1,0,5,4,21,-17,3,R,EN_D1,Oakwell,Barnsley
1997/98,10,19,Sheffield Wednesday,20,13,2,3,8,18,35,-17,9,6,2,1,3,8,12,-4,7,7,0,2,5,10,23,-13,2,R,EN_D1,Hillsborough,Sheffield
1997/98,11,12,Manchester United,1,14,8,4,2,31,10,21,28,7,6,1,0,23,4,19,19,7,2,3,2,8,6,2,9,Q,EU_CL,Old Trafford,Manchester
1997/98,11,1,Arsenal,2,14,7,6,1,30,15,15,27,7,5,2,0,18,3,15,17,7,2,4,1,12,12,0,10,Q,EU_CL,Highbury,London
1997/98,11,3,Blackburn Rovers,3,14,7,6,1,26,13,13,27,7,4,2,1,16,9,7,14,7,3,4,0,10,4,6,13,Q,EU_UC,Ewood Park,Blackburn
1997/98,11,4,Chelsea,4,13,8,1,4,29,16,13,25,5,4,0,1,10,6,4,12,8,4,1,3,19,10,9,13,Q,EU_CWC,Stamford Bridge,London
1997/98,11,9,Leeds United,5,14,7,2,5,20,16,4,23,7,3,1,3,10,10,0,10,7,4,1,2,10,6,4,13,Q,EU_UC,Elland Road,Leeds
1997/98,11,10,Liverpool,6,13,6,4,3,25,13,12,22,6,5,0,1,18,5,13,15,7,1,4,2,7,8,-1,7,Q,EU_UC,Anfield,Liverpool
1997/98,11,26,Leicester City,7,14,6,4,4,19,14,5,22,8,3,3,2,11,8,3,12,6,3,1,2,8,6,2,10,Q,EU_UC,Filbert Street,Leicester
1997/98,11,28,Derby County,8,13,6,2,5,25,19,6,20,6,4,2,0,14,4,10,14,7,2,0,5,11,15,-4,6,,,Pride Park,Derby
1997/98,11,22,Wimbledon,9,14,5,4,5,16,15,1,19,8,2,2,4,8,9,-1,8,6,3,2,1,8,6,2,11,,,Selhurst Park,London
1997/98,11,23,Newcastle United,10,11,5,3,3,14,15,-1,18,7,4,2,1,10,8,2,14,4,1,1,2,4,7,-3,4,Q,EU_CWC,St. James' Park,Newcastle
1997/98,11,5,Coventry City,11,14,3,8,3,12,16,-4,17,8,2,6,0,10,8,2,12,6,1,2,3,2,8,-6,5,,,Highfield Road,Coventry
1997/98,11,6,Crystal Palace,12,13,4,4,5,13,15,-2,16,6,0,3,3,4,9,-5,3,7,4,1,2,9,6,3,13,Q,EU_IT,Selhurst Park,London
1997/98,11,20,Southampton,13,14,5,1,8,17,21,-4,16,8,4,1,3,13,10,3,13,6,1,0,5,4,11,-7,3,,,The Dell,Southampton
1997/98,11,25,West Ham United,14,13,5,1,7,17,21,-4,16,5,4,0,1,10,4,6,12,8,1,1,6,7,17,-10,4,,,Boleyn Ground,London
1997/98,11,2,Aston Villa,15,14,4,3,7,13,20,-7,15,6,2,1,3,6,11,-5,7,8,2,2,4,7,9,-2,8,,,Villa Park,Birmingham
1997/98,11,21,Tottenham Hotspur,16,14,3,4,7,11,21,-10,13,7,3,2,2,7,7,0,11,7,0,2,5,4,14,-10,2,,,White Hart Lane,London
1997/98,11,7,Everton,17,13,3,3,7,15,21,-6,12,7,3,1,3,11,11,0,10,6,0,2,4,4,10,-6,2,,,Goodison Park,Liverpool
1997/98,11,27,Bolton Wanderers,18,13,2,6,5,10,21,-11,12,6,1,4,1,3,3,0,7,7,1,2,4,7,18,-11,5,R,EN_D1,Macron Stadium,Bolton
1997/98,11,19,Sheffield Wednesday,19,14,3,3,8,23,35,-12,12,7,3,1,3,13,12,1,10,7,0,2,5,10,23,-13,2,R,EN_D1,Hillsborough,Sheffield
1997/98,11,30,Barnsley,20,14,3,1,10,11,40,-29,10,7,2,1,4,6,15,-9,7,7,1,0,6,5,25,-20,3,R,EN_D1,Oakwell,Barnsley
1997/98,12,12,Manchester United,1,15,9,4,2,36,12,24,31,7,6,1,0,23,4,19,19,8,3,3,2,13,8,5,12,Q,EU_CL,Old Trafford,Manchester
1997/98,12,3,Blackburn Rovers,2,15,8,6,1,27,13,14,30,8,5,2,1,17,9,8,17,7,3,4,0,10,4,6,13,Q,EU_CL,Ewood Park,Blackburn
1997/98,12,4,Chelsea,3,15,9,1,5,31,17,14,28,6,5,0,1,12,6,6,15,9,4,1,4,19,11,8,13,"Q,Q","EU_UC,EU_CWC",Stamford Bridge,London
1997/98,12,1,Arsenal,4,15,7,6,2,30,17,13,27,7,5,2,0,18,3,15,17,8,2,4,2,12,14,-2,10,,,Highbury,London
1997/98,12,9,Leeds United,5,15,8,2,5,23,17,6,26,8,4,1,3,13,11,2,13,7,4,1,2,10,6,4,13,Q,EU_UC,Elland Road,Leeds
1997/98,12,28,Derby County,6,14,7,2,5,28,20,8,23,7,5,2,0,17,5,12,17,7,2,0,5,11,15,-4,6,Q,EU_UC,Pride Park,Derby
1997/98,12,26,Leicester City,7,15,6,5,4,19,14,5,23,9,3,4,2,11,8,3,13,6,3,1,2,8,6,2,10,Q,EU_UC,Filbert Street,Leicester
1997/98,12,10,Liverpool,8,14,6,4,4,25,14,11,22,7,5,0,2,18,6,12,15,7,1,4,2,7,8,-1,7,,,Anfield,Liverpool
1997/98,12,23,Newcastle United,9,12,6,3,3,16,16,0,21,8,5,2,1,12,9,3,17,4,1,1,2,4,7,-3,4,Q,EU_CWC,St. James' Park,Newcastle
1997/98,12,6,Crystal Palace,10,14,5,4,5,14,15,-1,19,6,0,3,3,4,9,-5,3,8,5,1,2,10,6,4,16,Q,EU_IT,Selhurst Park,London
1997/98,12,22,Wimbledon,11,15,5,4,6,18,20,-2,19,9,2,2,5,10,14,-4,8,6,3,2,1,8,6,2,11,,,Selhurst Park,London
1997/98,12,2,Aston Villa,12,15,5,3,7,15,21,-6,18,7,3,1,3,8,12,-4,10,8,2,2,4,7,9,-2,8,,,Villa Park,Birmingham
1997/98,12,5,Coventry City,13,15,3,8,4,13,19,-6,17,8,2,6,0,10,8,2,12,7,1,2,4,3,11,-8,5,,,Highfield Road,Coventry
1997/98,12,20,Southampton,14,15,5,1,9,18,23,-5,16,8,4,1,3,13,10,3,13,7,1,0,6,5,13,-8,3,,,The Dell,Southampton
1997/98,12,25,West Ham United,15,14,5,1,8,18,24,-6,16,5,4,0,1,10,4,6,12,9,1,1,7,8,20,-12,4,,,Boleyn Ground,London
1997/98,12,19,Sheffield Wednesday,16,15,4,3,8,25,35,-10,15,8,4,1,3,15,12,3,13,7,0,2,5,10,23,-13,2,,,Hillsborough,Sheffield
1997/98,12,21,Tottenham Hotspur,17,15,3,4,8,11,22,-11,13,8,3,2,3,7,8,-1,11,7,0,2,5,4,14,-10,2,,,White Hart Lane,London
1997/98,12,27,Bolton Wanderers,18,14,2,7,5,10,21,-11,13,6,1,4,1,3,3,0,7,8,1,3,4,7,18,-11,6,R,EN_D1,Macron Stadium,Bolton
1997/98,12,30,Barnsley,19,15,4,1,10,12,40,-28,13,7,2,1,4,6,15,-9,7,8,2,0,6,6,25,-19,6,R,EN_D1,Oakwell,Barnsley
1997/98,12,7,Everton,20,15,3,3,9,16,25,-9,12,7,3,1,3,11,11,0,10,8,0,2,6,5,14,-9,2,R,EN_D1,Goodison Park,Liverpool
1997/98,13,12,Manchester United,1,16,10,4,2,40,12,28,34,8,7,1,0,27,4,23,22,8,3,3,2,13,8,5,12,Q,EU_CL,Old Trafford,Manchester
1997/98,13,4,Chelsea,2,16,10,1,5,35,17,18,31,7,6,0,1,16,6,10,18,9,4,1,4,19,11,8,13,"Q,Q","EU_CL,EU_CWC",Stamford Bridge,London
1997/98,13,3,Blackburn Rovers,3,16,8,6,2,27,17,10,30,8,5,2,1,17,9,8,17,8,3,4,1,10,8,2,13,Q,EU_UC,Ewood Park,Blackburn
1997/98,13,9,Leeds United,4,16,9,2,5,26,19,7,29,8,4,1,3,13,11,2,13,8,5,1,2,13,8,5,16,,,Elland Road,Leeds
1997/98,13,1,Arsenal,5,16,7,6,3,30,18,12,27,8,5,2,1,18,4,14,17,8,2,4,2,12,14,-2,10,Q,EU_UC,Highbury,London
1997/98,13,26,Leicester City,6,16,7,5,4,21,14,7,26,9,3,4,2,11,8,3,13,7,4,1,2,10,6,4,13,Q,EU_UC,Filbert Street,Leicester
1997/98,13,10,Liverpool,7,15,7,4,4,26,14,12,25,7,5,0,2,18,6,12,15,8,2,4,2,8,8,0,10,Q,EU_UC,Anfield,Liverpool
1997/98,13,23,Newcastle United,8,14,7,3,4,18,18,0,24,8,5,2,1,12,9,3,17,6,2,1,3,6,9,-3,7,Q,EU_CWC,St. James' Park,Newcastle
1997/98,13,28,Derby County,9,15,7,2,6,28,24,4,23,7,5,2,0,17,5,12,17,8,2,0,6,11,19,-8,6,,,Pride Park,Derby
1997/98,13,25,West Ham United,10,16,7,1,8,24,26,-2,22,7,6,0,1,16,6,10,18,9,1,1,7,8,20,-12,4,,,Boleyn Ground,London
1997/98,13,22,Wimbledon,11,16,5,4,7,18,21,-3,19,9,2,2,5,10,14,-4,8,7,3,2,2,8,7,1,11,,,Selhurst Park,London
1997/98,13,6,Crystal Palace,12,16,5,4,7,16,21,-5,19,7,0,3,4,5,11,-6,3,9,5,1,3,11,10,1,16,Q,EU_IT,Selhurst Park,London
1997/98,13,27,Bolton Wanderers,13,16,4,7,5,12,21,-9,19,8,3,4,1,5,3,2,13,8,1,3,4,7,18,-11,6,,,Macron Stadium,Bolton
1997/98,13,2,Aston Villa,14,16,5,3,8,16,23,-7,18,7,3,1,3,8,12,-4,10,9,2,2,5,8,11,-3,8,,,Villa Park,Birmingham
1997/98,13,19,Sheffield Wednesday,15,16,5,3,8,28,37,-9,18,8,4,1,3,15,12,3,13,8,1,2,5,13,25,-12,5,,,Hillsborough,Sheffield
1997/98,13,5,Coventry City,16,16,3,8,5,13,21,-8,17,9,2,6,1,10,10,0,12,7,1,2,4,3,11,-8,5,,,Highfield Road,Coventry
1997/98,13,20,Southampton,17,16,5,1,10,20,26,-6,16,9,4,1,4,15,13,2,13,7,1,0,6,5,13,-8,3,,,The Dell,Southampton
1997/98,13,21,Tottenham Hotspur,18,16,4,4,8,13,22,-9,16,8,3,2,3,7,8,-1,11,8,1,2,5,6,14,-8,5,R,EN_D1,White Hart Lane,London
1997/98,13,30,Barnsley,19,16,4,1,11,14,43,-29,13,8,2,1,5,8,18,-10,7,8,2,0,6,6,25,-19,6,R,EN_D1,Oakwell,Barnsley
1997/98,13,7,Everton,20,16,3,3,10,16,27,-11,12,8,3,1,4,11,13,-2,10,8,0,2,6,5,14,-9,2,R,EN_D1,Goodison Park,Liverpool
1997/98,14,12,Manchester United,1,17,11,4,2,43,13,30,37,8,7,1,0,27,4,23,22,9,4,3,2,16,9,7,15,Q,EU_CL,Old Trafford,Manchester
1997/98,14,4,Chelsea,2,17,11,1,5,41,18,23,34,7,6,0,1,16,6,10,18,10,5,1,4,25,12,13,16,"Q,Q","EU_CL,EU_CWC",Stamford Bridge,London
1997/98,14,3,Blackburn Rovers,3,17,9,6,2,30,18,12,33,9,6,2,1,20,10,10,20,8,3,4,1,10,8,2,13,Q,EU_UC,Ewood Park,Blackburn
1997/98,14,1,Arsenal,4,17,8,6,3,31,18,13,30,8,5,2,1,18,4,14,17,9,3,4,2,13,14,-1,13,,,Highbury,London
1997/98,14,9,Leeds United,5,17,9,3,5,26,19,7,30,9,4,2,3,13,11,2,14,8,5,1,2,13,8,5,16,Q,EU_UC,Elland Road,Leeds
1997/98,14,26,Leicester City,6,17,7,6,4,22,15,7,27,10,3,5,2,12,9,3,14,7,4,1,2,10,6,4,13,Q,EU_UC,Filbert Street,Leicester
1997/98,14,28,Derby County,7,16,8,2,6,30,24,6,26,8,6,2,0,19,5,14,20,8,2,0,6,11,19,-8,6,Q,EU_UC,Pride Park,Derby
1997/98,14,10,Liverpool,8,16,7,4,5,27,17,10,25,8,5,0,3,19,9,10,15,8,2,4,2,8,8,0,10,,,Anfield,Liverpool
1997/98,14,23,Newcastle United,9,15,7,3,5,18,19,-1,24,9,5,2,2,12,10,2,17,6,2,1,3,6,9,-3,7,Q,EU_CWC,St. James' Park,Newcastle
1997/98,14,22,Wimbledon,10,17,6,4,7,19,21,-2,22,10,3,2,5,11,14,-3,11,7,3,2,2,8,7,1,11,,,Selhurst Park,London
1997/98,14,25,West Ham United,11,17,7,1,9,24,28,-4,22,7,6,0,1,16,6,10,18,10,1,1,8,8,22,-14,4,,,Boleyn Ground,London
1997/98,14,2,Aston Villa,12,17,6,3,8,19,23,-4,21,8,4,1,3,11,12,-1,13,9,2,2,5,8,11,-3,8,,,Villa Park,Birmingham
1997/98,14,19,Sheffield Wednesday,13,17,6,3,8,30,38,-8,21,9,5,1,3,17,13,4,16,8,1,2,5,13,25,-12,5,,,Hillsborough,Sheffield
1997/98,14,6,Crystal Palace,14,17,5,5,7,17,22,-5,20,7,0,3,4,5,11,-6,3,10,5,2,3,12,11,1,17,Q,EU_IT,Selhurst Park,London
1997/98,14,27,Bolton Wanderers,15,17,4,7,6,13,24,-11,19,8,3,4,1,5,3,2,13,9,1,3,5,8,21,-13,6,,,Macron Stadium,Bolton
1997/98,14,5,Coventry City,16,17,3,8,6,13,24,-11,17,9,2,6,1,10,10,0,12,8,1,2,5,3,14,-11,5,,,Highfield Road,Coventry
1997/98,14,20,Southampton,17,17,5,1,11,20,27,-7,16,9,4,1,4,15,13,2,13,8,1,0,7,5,14,-9,3,,,The Dell,Southampton
1997/98,14,21,Tottenham Hotspur,18,17,4,4,9,14,28,-14,16,9,3,2,4,8,14,-6,11,8,1,2,5,6,14,-8,5,R,EN_D1,White Hart Lane,London
1997/98,14,7,Everton,19,17,3,4,10,16,27,-11,13,8,3,1,4,11,13,-2,10,9,0,3,6,5,14,-9,3,R,EN_D1,Goodison Park,Liverpool
1997/98,14,30,Barnsley,20,17,4,1,12,15,45,-30,13,8,2,1,5,8,18,-10,7,9,2,0,7,7,27,-20,6,R,EN_D1,Oakwell,Barnsley
1997/98,15,12,Manchester United,1,18,12,4,2,44,13,31,40,9,8,1,0,28,4,24,25,9,4,3,2,16,9,7,15,Q,EU_CL,Old Trafford,Manchester
1997/98,15,3,Blackburn Rovers,2,18,10,6,2,33,19,14,36,9,6,2,1,20,10,10,20,9,4,4,1,13,9,4,16,Q,EU_CL,Ewood Park,Blackburn
1997/98,15,4,Chelsea,3,18,11,2,5,41,18,23,35,8,6,1,1,16,6,10,19,10,5,1,4,25,12,13,16,"Q,Q","EU_UC,EU_CWC",Stamford Bridge,London
1997/98,15,9,Leeds United,4,18,9,4,5,26,19,7,31,9,4,2,3,13,11,2,14,9,5,2,2,13,8,5,17,,,Elland Road,Leeds
1997/98,15,1,Arsenal,5,18,8,6,4,32,21,11,30,9,5,2,2,19,7,12,17,9,3,4,2,13,14,-1,13,Q,EU_UC,Highbury,London
1997/98,15,10,Liverpool,6,17,8,4,5,30,17,13,28,8,5,0,3,19,9,10,15,9,3,4,2,11,8,3,13,Q,EU_UC,Anfield,Liverpool
1997/98,15,28,Derby County,7,18,8,4,6,33,27,6,28,8,6,2,0,19,5,14,20,10,2,2,6,14,22,-8,8,Q,EU_UC,Pride Park,Derby
1997/98,15,26,Leicester City,8,18,7,6,5,23,17,6,27,10,3,5,2,12,9,3,14,8,4,1,3,11,8,3,13,,,Filbert Street,Leicester
1997/98,15,23,Newcastle United,9,17,7,5,5,20,21,-1,26,10,5,3,2,12,10,2,18,7,2,2,3,8,11,-3,8,Q,EU_CWC,St. James' Park,Newcastle
1997/98,15,25,West Ham United,10,18,8,1,9,25,28,-3,25,8,7,0,1,17,6,11,21,10,1,1,8,8,22,-14,4,,,Boleyn Ground,London
1997/98,15,22,Wimbledon,11,18,6,5,7,19,21,-2,23,10,3,2,5,11,14,-3,11,8,3,3,2,8,7,1,12,,,Selhurst Park,London
1997/98,15,2,Aston Villa,12,18,6,3,9,19,24,-5,21,8,4,1,3,11,12,-1,13,10,2,2,6,8,12,-4,8,,,Villa Park,Birmingham
1997/98,15,19,Sheffield Wednesday,13,18,6,3,9,30,39,-9,21,9,5,1,3,17,13,4,16,9,1,2,6,13,26,-13,5,,,Hillsborough,Sheffield
1997/98,15,5,Coventry City,14,18,4,8,6,17,24,-7,20,10,3,6,1,14,10,4,15,8,1,2,5,3,14,-11,5,,,Highfield Road,Coventry
1997/98,15,6,Crystal Palace,15,18,5,5,8,17,25,-8,20,8,0,3,5,5,14,-9,3,10,5,2,3,12,11,1,17,Q,EU_IT,Selhurst Park,London
1997/98,15,27,Bolton Wanderers,16,18,4,8,6,16,27,-11,20,9,3,5,1,8,6,2,14,9,1,3,5,8,21,-13,6,,,Macron Stadium,Bolton
1997/98,15,20,Southampton,17,18,6,1,11,22,28,-6,19,10,5,1,4,17,14,3,16,8,1,0,7,5,14,-9,3,,,The Dell,Southampton
1997/98,15,21,Tottenham Hotspur,18,18,4,4,10,14,32,-18,16,9,3,2,4,8,14,-6,11,9,1,2,6,6,18,-12,5,R,EN_D1,White Hart Lane,London
1997/98,15,7,Everton,19,18,3,5,10,16,27,-11,14,9,3,2,4,11,13,-2,11,9,0,3,6,5,14,-9,3,R,EN_D1,Goodison Park,Liverpool
1997/98,15,30,Barnsley,20,18,4,2,12,17,47,-30,14,9,2,2,5,10,20,-10,8,9,2,0,7,7,27,-20,6,R,EN_D1,Oakwell,Barnsley
1997/98,16,12,Manchester United,1,19,13,4,2,45,13,32,43,9,8,1,0,28,4,24,25,10,5,3,2,17,9,8,18,Q,EU_CL,Old Trafford,Manchester
1997/98,16,3,Blackburn Rovers,2,19,11,6,2,36,19,17,39,10,7,2,1,23,10,13,23,9,4,4,1,13,9,4,16,Q,EU_CL,Ewood Park,Blackburn
1997/98,16,4,Chelsea,3,19,12,2,5,45,19,26,38,8,6,1,1,16,6,10,19,11,6,1,4,29,13,16,19,"Q,Q","EU_UC,EU_CWC",Stamford Bridge,London
1997/98,16,9,Leeds United,4,19,10,4,5,28,19,9,34,10,5,2,3,15,11,4,17,9,5,2,2,13,8,5,17,,,Elland Road,Leeds
1997/98,16,10,Liverpool,5,18,9,4,5,31,17,14,31,9,6,0,3,20,9,11,18,9,3,4,2,11,8,3,13,Q,EU_UC,Anfield,Liverpool
1997/98,16,1,Arsenal,6,18,8,6,4,32,21,11,30,9,5,2,2,19,7,12,17,9,3,4,2,13,14,-1,13,Q,EU_UC,Highbury,London
1997/98,16,28,Derby County,7,19,8,5,6,33,27,6,29,9,6,3,0,19,5,14,21,10,2,2,6,14,22,-8,8,Q,EU_UC,Pride Park,Derby
1997/98,16,26,Leicester City,8,19,7,6,6,23,18,5,27,11,3,5,3,12,10,2,14,8,4,1,3,11,8,3,13,,,Filbert Street,Leicester
1997/98,16,23,Newcastle United,9,18,7,5,6,20,22,-2,26,11,5,3,3,12,11,1,18,7,2,2,3,8,11,-3,8,Q,EU_CWC,St. James' Park,Newcastle
1997/98,16,25,West Ham United,10,19,8,1,10,25,31,-6,25,8,7,0,1,17,6,11,21,11,1,1,9,8,25,-17,4,,,Boleyn Ground,London
1997/98,16,22,Wimbledon,11,18,6,5,7,19,21,-2,23,10,3,2,5,11,14,-3,11,8,3,3,2,8,7,1,12,,,Selhurst Park,London
1997/98,16,2,Aston Villa,12,19,6,4,9,20,25,-5,22,9,4,2,3,12,13,-1,14,10,2,2,6,8,12,-4,8,,,Villa Park,Birmingham
1997/98,16,6,Crystal Palace,13,19,5,6,8,17,25,-8,21,8,0,3,5,5,14,-9,3,11,5,3,3,12,11,1,18,Q,EU_IT,Selhurst Park,London
1997/98,16,19,Sheffield Wednesday,14,19,6,3,10,31,43,-12,21,10,5,1,4,18,17,1,16,9,1,2,6,13,26,-13,5,,,Hillsborough,Sheffield
1997/98,16,20,Southampton,15,19,6,2,11,23,29,-6,20,10,5,1,4,17,14,3,16,9,1,1,7,6,15,-9,4,,,The Dell,Southampton
1997/98,16,5,Coventry City,16,19,4,8,7,17,25,-8,20,10,3,6,1,14,10,4,15,9,1,2,6,3,15,-12,5,,,Highfield Road,Coventry
1997/98,16,27,Bolton Wanderers,17,19,4,8,7,16,29,-13,20,9,3,5,1,8,6,2,14,10,1,3,6,8,23,-15,6,,,Macron Stadium,Bolton
1997/98,16,21,Tottenham Hotspur,18,19,5,4,10,17,32,-15,19,10,4,2,4,11,14,-3,14,9,1,2,6,6,18,-12,5,R,EN_D1,White Hart Lane,London
1997/98,16,7,Everton,19,19,4,5,10,17,27,-10,17,9,3,2,4,11,13,-2,11,10,1,3,6,6,14,-8,6,R,EN_D1,Goodison Park,Liverpool
1997/98,16,30,Barnsley,20,19,4,2,13,17,50,-33,14,9,2,2,5,10,20,-10,8,10,2,0,8,7,30,-23,6,R,EN_D1,Oakwell,Barnsley
1997/98,17,12,Manchester United,1,20,14,4,2,47,13,34,46,10,9,1,0,30,4,26,28,10,5,3,2,17,9,8,18,Q,EU_CL,Old Trafford,Manchester
1997/98,17,3,Blackburn Rovers,2,20,11,7,2,36,19,17,40,10,7,2,1,23,10,13,23,10,4,5,1,13,9,4,17,Q,EU_CL,Ewood Park,Blackburn
1997/98,17,4,Chelsea,3,20,12,3,5,46,20,26,39,9,6,2,1,17,7,10,20,11,6,1,4,29,13,16,19,"Q,Q","EU_UC,EU_CWC",Stamford Bridge,London
1997/98,17,10,Liverpool,4,19,10,4,5,34,18,16,34,10,7,0,3,23,10,13,21,9,3,4,2,11,8,3,13,,,Anfield,Liverpool
1997/98,17,9,Leeds United,5,20,10,4,6,29,22,7,34,10,5,2,3,15,11,4,17,10,5,2,3,14,11,3,17,Q,EU_UC,Elland Road,Leeds
1997/98,17,1,Arsenal,6,19,9,6,4,34,22,12,33,10,6,2,2,21,8,13,20,9,3,4,2,13,14,-1,13,Q,EU_UC,Highbury,London
1997/98,17,28,Derby County,7,20,9,5,6,34,27,7,32,10,7,3,0,20,5,15,24,10,2,2,6,14,22,-8,8,Q,EU_UC,Pride Park,Derby
1997/98,17,25,West Ham United,8,20,9,1,10,26,31,-5,28,9,8,0,1,18,6,12,24,11,1,1,9,8,25,-17,4,,,Boleyn Ground,London
1997/98,17,26,Leicester City,9,20,7,6,7,24,20,4,27,11,3,5,3,12,10,2,14,9,4,1,4,12,10,2,13,,,Filbert Street,Leicester
1997/98,17,23,Newcastle United,10,19,7,5,7,20,23,-3,26,11,5,3,3,12,11,1,18,8,2,2,4,8,12,-4,8,Q,EU_CWC,St. James' Park,Newcastle
1997/98,17,2,Aston Villa,11,20,7,4,9,24,26,-2,25,10,5,2,3,16,14,2,17,10,2,2,6,8,12,-4,8,,,Villa Park,Birmingham
1997/98,17,22,Wimbledon,12,19,6,6,7,20,22,-2,24,10,3,2,5,11,14,-3,11,9,3,4,2,9,8,1,13,,,Selhurst Park,London
1997/98,17,6,Crystal Palace,13,20,5,7,8,18,26,-8,22,9,0,4,5,6,15,-9,4,11,5,3,3,12,11,1,18,Q,EU_IT,Selhurst Park,London
1997/98,17,19,Sheffield Wednesday,14,20,6,4,10,31,43,-12,22,11,5,2,4,18,17,1,17,9,1,2,6,13,26,-13,5,,,Hillsborough,Sheffield
1997/98,17,20,Southampton,15,20,6,3,11,24,30,-6,21,10,5,1,4,17,14,3,16,10,1,2,7,7,16,-9,5,,,The Dell,Southampton
1997/98,17,27,Bolton Wanderers,16,20,4,9,7,17,30,-13,21,10,3,6,1,9,7,2,15,10,1,3,6,8,23,-15,6,,,Macron Stadium,Bolton
1997/98,17,5,Coventry City,17,20,4,8,8,17,26,-9,20,10,3,6,1,14,10,4,15,10,1,2,7,3,16,-13,5,,,Highfield Road,Coventry
1997/98,17,21,Tottenham Hotspur,18,20,5,4,11,18,36,-18,19,10,4,2,4,11,14,-3,14,10,1,2,7,7,22,-15,5,R,EN_D1,White Hart Lane,London
1997/98,17,7,Everton,19,20,4,5,11,17,29,-12,17,9,3,2,4,11,13,-2,11,11,1,3,7,6,16,-10,6,R,EN_D1,Goodison Park,Liverpool
1997/98,17,30,Barnsley,20,20,4,3,13,18,51,-33,15,9,2,2,5,10,20,-10,8,11,2,1,8,8,31,-23,7,R,EN_D1,Oakwell,Barnsley
1997/98,18,12,Manchester United,1,21,14,4,3,49,16,33,46,10,9,1,0,30,4,26,28,11,5,3,3,19,12,7,18,Q,EU_CL,Old Trafford,Manchester
1997/98,18,3,Blackburn Rovers,2,21,11,8,2,38,21,17,41,11,7,3,1,25,12,13,24,10,4,5,1,13,9,4,17,Q,EU_CL,Ewood Park,Blackburn
1997/98,18,4,Chelsea,3,21,12,3,6,46,21,25,39,9,6,2,1,17,7,10,20,12,6,1,5,29,14,15,19,"Q,Q","EU_UC,EU_CWC",Stamford Bridge,London
1997/98,18,10,Liverpool,4,20,11,4,5,36,19,17,37,10,7,0,3,23,10,13,21,10,4,4,2,13,9,4,16,,,Anfield,Liverpool
1997/98,18,9,Leeds United,5,21,10,5,6,30,23,7,35,11,5,3,3,16,12,4,18,10,5,2,3,14,11,3,17,Q,EU_UC,Elland Road,Leeds
1997/98,18,1,Arsenal,6,20,9,7,4,35,23,12,34,10,6,2,2,21,8,13,20,10,3,5,2,14,15,-1,14,Q,EU_UC,Highbury,London
1997/98,18,28,Derby County,7,21,9,5,7,34,28,6,32,10,7,3,0,20,5,15,24,11,2,2,7,14,23,-9,8,Q,EU_UC,Pride Park,Derby
1997/98,18,25,West Ham United,8,21,10,1,10,28,32,-4,31,9,8,0,1,18,6,12,24,12,2,1,9,10,26,-16,7,,,Boleyn Ground,London
1997/98,18,26,Leicester City,9,21,7,7,7,25,21,4,28,12,3,6,3,13,11,2,15,9,4,1,4,12,10,2,13,,,Filbert Street,Leicester
1997/98,18,2,Aston Villa,10,21,7,5,9,25,27,-2,26,10,5,2,3,16,14,2,17,11,2,3,6,9,13,-4,9,,,Villa Park,Birmingham
1997/98,18,23,Newcastle United,11,20,7,5,8,21,25,-4,26,12,5,3,4,13,13,0,18,8,2,2,4,8,12,-4,8,Q,EU_CWC,St. James' Park,Newcastle
1997/98,18,22,Wimbledon,12,20,6,6,8,21,24,-3,24,11,3,2,6,12,16,-4,11,9,3,4,2,9,8,1,13,,,Selhurst Park,London
1997/98,18,20,Southampton,13,21,7,3,11,25,30,-5,24,11,6,1,4,18,14,4,19,10,1,2,7,7,16,-9,5,,,The Dell,Southampton
1997/98,18,5,Coventry City,14,21,5,8,8,20,28,-8,23,11,4,6,1,17,12,5,18,10,1,2,7,3,16,-13,5,,,Highfield Road,Coventry
1997/98,18,6,Crystal Palace,15,21,5,8,8,20,28,-8,23,9,0,4,5,6,15,-9,4,12,5,4,3,14,13,1,19,Q,EU_IT,Selhurst Park,London
1997/98,18,19,Sheffield Wednesday,16,21,6,5,10,32,44,-12,23,11,5,2,4,18,17,1,17,10,1,3,6,14,27,-13,6,,,Hillsborough,Sheffield
1997/98,18,27,Bolton Wanderers,17,21,4,9,8,19,33,-14,21,10,3,6,1,9,7,2,15,11,1,3,7,10,26,-16,6,,,Macron Stadium,Bolton
1997/98,18,7,Everton,18,21,5,5,11,20,31,-11,20,10,4,2,4,14,15,-1,14,11,1,3,7,6,16,-10,6,R,EN_D1,Goodison Park,Liverpool
1997/98,18,21,Tottenham Hotspur,19,21,5,5,11,19,37,-18,20,11,4,3,4,12,15,-3,15,10,1,2,7,7,22,-15,5,R,EN_D1,White Hart Lane,London
1997/98,18,30,Barnsley,20,21,5,3,13,19,51,-32,18,10,3,2,5,11,20,-9,11,11,2,1,8,8,31,-23,7,R,EN_D1,Oakwell,Barnsley
1997/98,19,12,Manchester United,1,22,15,4,3,51,16,35,49,11,10,1,0,32,4,28,31,11,5,3,3,19,12,7,18,Q,EU_CL,Old Trafford,Manchester
1997/98,19,4,Chelsea,2,22,13,3,6,49,22,27,42,10,7,2,1,20,8,12,23,12,6,1,5,29,14,15,19,"Q,Q","EU_CL,EU_CWC",Stamford Bridge,London
1997/98,19,3,Blackburn Rovers,3,22,11,8,3,39,24,15,41,11,7,3,1,25,12,13,24,11,4,5,2,14,12,2,17,Q,EU_UC,Ewood Park,Blackburn
1997/98,19,10,Liverpool,4,21,12,4,5,38,19,19,40,11,8,0,3,25,10,15,24,10,4,4,2,13,9,4,16,,,Anfield,Liverpool
1997/98,19,1,Arsenal,5,21,10,7,4,37,24,13,37,11,7,2,2,23,9,14,23,10,3,5,2,14,15,-1,14,Q,EU_UC,Highbury,London
1997/98,19,28,Derby County,6,22,10,5,7,37,29,8,35,11,8,3,0,23,6,17,27,11,2,2,7,14,23,-9,8,Q,EU_UC,Pride Park,Derby
1997/98,19,9,Leeds United,7,22,10,5,7,31,25,6,35,11,5,3,3,16,12,4,18,11,5,2,4,15,13,2,17,Q,EU_UC,Elland Road,Leeds
1997/98,19,25,West Ham United,8,22,11,1,10,34,32,2,34,10,9,0,1,24,6,18,27,12,2,1,9,10,26,-16,7,,,Boleyn Ground,London
1997/98,19,26,Leicester City,9,22,7,8,7,26,22,4,29,12,3,6,3,13,11,2,15,10,4,2,4,13,11,2,14,,,Filbert Street,Leicester
1997/98,19,2,Aston Villa,10,22,7,6,9,26,28,-2,27,11,5,3,3,17,15,2,18,11,2,3,6,9,13,-4,9,,,Villa Park,Birmingham
1997/98,19,23,Newcastle United,11,21,7,5,9,22,27,-5,26,12,5,3,4,13,13,0,18,9,2,2,5,9,14,-5,8,Q,EU_CWC,St. James' Park,Newcastle
1997/98,19,19,Sheffield Wednesday,12,22,7,5,10,34,45,-11,26,12,6,2,4,20,18,2,20,10,1,3,6,14,27,-13,6,,,Hillsborough,Sheffield
1997/98,19,20,Southampton,13,22,7,4,11,25,30,-5,25,11,6,1,4,18,14,4,19,11,1,3,7,7,16,-9,6,,,The Dell,Southampton
1997/98,19,22,Wimbledon,14,21,6,6,9,21,26,-5,24,11,3,2,6,12,16,-4,11,10,3,4,3,9,10,-1,13,,,Selhurst Park,London
1997/98,19,7,Everton,15,22,6,5,11,23,32,-9,23,10,4,2,4,14,15,-1,14,12,2,3,7,9,17,-8,9,,,Goodison Park,Liverpool
1997/98,19,5,Coventry City,16,22,5,8,9,21,31,-10,23,11,4,6,1,17,12,5,18,11,1,2,8,4,19,-15,5,,,Highfield Road,Coventry
1997/98,19,6,Crystal Palace,17,22,5,8,9,21,31,-10,23,10,0,4,6,7,18,-11,4,12,5,4,3,14,13,1,19,Q,EU_IT,Selhurst Park,London
1997/98,19,27,Bolton Wanderers,18,22,4,10,8,19,33,-14,22,11,3,7,1,9,7,2,16,11,1,3,7,10,26,-16,6,R,EN_D1,Macron Stadium,Bolton
1997/98,19,21,Tottenham Hotspur,19,22,5,5,12,19,39,-20,20,11,4,3,4,12,15,-3,15,11,1,2,8,7,24,-17,5,R,EN_D1,White Hart Lane,London
1997/98,19,30,Barnsley,20,22,5,3,14,19,57,-38,18,10,3,2,5,11,20,-9,11,12,2,1,9,8,37,-29,7,R,EN_D1,Oakwell,Barnsley
1997/98,20,12,Manchester United,1,23,15,4,4,51,17,34,49,11,10,1,0,32,4,28,31,12,5,3,4,19,13,6,18,Q,EU_CL,Old Trafford,Manchester
1997/98,20,3,Blackburn Rovers,2,23,12,8,3,44,24,20,44,12,8,3,1,30,12,18,27,11,4,5,2,14,12,2,17,Q,EU_CL,Ewood Park,Blackburn
1997/98,20,10,Liverpool,3,23,13,5,5,39,19,20,44,12,9,0,3,26,10,16,27,11,4,5,2,13,9,4,17,Q,EU_UC,Anfield,Liverpool
1997/98,20,4,Chelsea,4,23,13,3,7,50,25,25,42,10,7,2,1,20,8,12,23,13,6,1,6,30,17,13,19,Q,EU_CWC,Stamford Bridge,London
1997/98,20,1,Arsenal,5,22,10,8,4,39,26,13,38,11,7,2,2,23,9,14,23,11,3,6,2,16,17,-1,15,Q,EU_UC,Highbury,London
1997/98,20,28,Derby County,6,23,10,6,7,37,29,8,36,11,8,3,0,23,6,17,27,12,2,3,7,14,23,-9,9,Q,EU_UC,Pride Park,Derby
1997/98,20,9,Leeds United,7,23,10,5,8,32,27,5,35,12,5,3,4,17,14,3,18,11,5,2,4,15,13,2,17,Q,EU_UC,Elland Road,Leeds
1997/98,20,25,West Ham United,8,23,11,1,11,34,33,1,34,10,9,0,1,24,6,18,27,13,2,1,10,10,27,-17,7,,,Boleyn Ground,London
1997/98,20,26,Leicester City,9,23,7,9,7,26,22,4,30,13,3,7,3,13,11,2,16,10,4,2,4,13,11,2,14,,,Filbert Street,Leicester
1997/98,20,23,Newcastle United,10,23,8,5,10,24,29,-5,29,13,6,3,4,15,14,1,21,10,2,2,6,9,15,-6,8,Q,EU_CWC,St. James' Park,Newcastle
1997/98,20,19,Sheffield Wednesday,11,23,8,5,10,36,46,-10,29,12,6,2,4,20,18,2,20,11,2,3,6,16,28,-12,9,,,Hillsborough,Sheffield
1997/98,20,20,Southampton,12,23,8,4,11,26,30,-4,28,12,7,1,4,19,14,5,22,11,1,3,7,7,16,-9,6,,,The Dell,Southampton
1997/98,20,2,Aston Villa,13,23,7,6,10,26,33,-7,27,11,5,3,3,17,15,2,18,12,2,3,7,9,18,-9,9,,,Villa Park,Birmingham
1997/98,20,7,Everton,14,23,7,5,11,26,33,-7,26,11,5,2,4,17,16,1,17,12,2,3,7,9,17,-8,9,,,Goodison Park,Liverpool
1997/98,20,22,Wimbledon,15,22,6,7,9,21,26,-5,25,12,3,3,6,12,16,-4,12,10,3,4,3,9,10,-1,13,,,Selhurst Park,London
1997/98,20,5,Coventry City,16,23,5,9,9,23,33,-10,24,12,4,7,1,19,14,5,19,11,1,2,8,4,19,-15,5,,,Highfield Road,Coventry
1997/98,20,6,Crystal Palace,17,23,5,8,10,21,32,-11,23,10,0,4,6,7,18,-11,4,13,5,4,4,14,14,0,19,Q,EU_IT,Selhurst Park,London
1997/98,20,21,Tottenham Hotspur,18,23,6,5,12,20,39,-19,23,12,5,3,4,13,15,-2,18,11,1,2,8,7,24,-17,5,R,EN_D1,White Hart Lane,London
1997/98,20,27,Bolton Wanderers,19,23,4,10,9,20,35,-15,22,11,3,7,1,9,7,2,16,12,1,3,8,11,28,-17,6,R,EN_D1,Macron Stadium,Bolton
1997/98,20,30,Barnsley,20,23,6,3,14,20,57,-37,21,11,4,2,5,12,20,-8,14,12,2,1,9,8,37,-29,7,R,EN_D1,Oakwell,Barnsley
1997/98,21,12,Manchester United,1,24,15,4,5,51,18,33,49,12,10,1,1,32,5,27,31,12,5,3,4,19,13,6,18,Q,EU_CL,Old Trafford,Manchester
1997/98,21,4,Chelsea,2,24,14,3,7,52,25,27,45,11,8,2,1,22,8,14,26,13,6,1,6,30,17,13,19,"Q,Q","EU_CL,EU_CWC",Stamford Bridge,London
1997/98,21,3,Blackburn Rovers,3,24,12,9,3,44,24,20,45,12,8,3,1,30,12,18,27,12,4,6,2,14,12,2,18,Q,EU_UC,Ewood Park,Blackburn
1997/98,21,10,Liverpool,4,24,13,6,5,39,19,20,45,13,9,1,3,26,10,16,28,11,4,5,2,13,9,4,17,,,Anfield,Liverpool
1997/98,21,1,Arsenal,5,23,11,8,4,42,26,16,41,12,8,2,2,26,9,17,26,11,3,6,2,16,17,-1,15,Q,EU_UC,Highbury,London
1997/98,21,28,Derby County,6,24,11,6,7,39,30,9,39,12,9,3,0,25,7,18,30,12,2,3,7,14,23,-9,9,Q,EU_UC,Pride Park,Derby
1997/98,21,9,Leeds United,7,24,11,5,8,34,27,7,38,12,5,3,4,17,14,3,18,12,6,2,4,17,13,4,20,Q,EU_UC,Elland Road,Leeds
1997/98,21,25,West Ham United,8,24,11,2,11,36,35,1,35,11,9,1,1,26,8,18,28,13,2,1,10,10,27,-17,7,,,Boleyn Ground,London
1997/98,21,26,Leicester City,9,24,8,9,7,27,22,5,33,13,3,7,3,13,11,2,16,11,5,2,4,14,11,3,17,,,Filbert Street,Leicester
1997/98,21,23,Newcastle United,10,24,9,5,10,25,29,-4,32,13,6,3,4,15,14,1,21,11,3,2,6,10,15,-5,11,Q,EU_CWC,St. James' Park,Newcastle
1997/98,21,19,Sheffield Wednesday,11,24,8,6,10,37,47,-10,30,13,6,3,4,21,19,2,21,11,2,3,6,16,28,-12,9,,,Hillsborough,Sheffield
1997/98,21,20,Southampton,12,24,8,4,12,26,33,-7,28,12,7,1,4,19,14,5,22,12,1,3,8,7,19,-12,6,,,The Dell,Southampton
1997/98,21,5,Coventry City,13,24,6,9,9,28,34,-6,27,12,4,7,1,19,14,5,19,12,2,2,8,9,20,-11,8,,,Highfield Road,Coventry
1997/98,21,7,Everton,14,24,7,6,11,28,35,-7,27,11,5,2,4,17,16,1,17,13,2,4,7,11,19,-8,10,,,Goodison Park,Liverpool
1997/98,21,2,Aston Villa,15,24,7,6,11,26,34,-8,27,12,5,3,4,17,16,1,18,12,2,3,7,9,18,-9,9,,,Villa Park,Birmingham
1997/98,21,22,Wimbledon,16,23,6,8,9,22,27,-5,26,12,3,3,6,12,16,-4,12,11,3,5,3,10,11,-1,14,,,Selhurst Park,London
1997/98,21,6,Crystal Palace,17,24,5,8,11,21,34,-13,23,11,0,4,7,7,20,-13,4,13,5,4,4,14,14,0,19,Q,EU_IT,Selhurst Park,London
1997/98,21,21,Tottenham Hotspur,18,24,6,5,13,21,41,-20,23,12,5,3,4,13,15,-2,18,12,1,2,9,8,26,-18,5,R,EN_D1,White Hart Lane,London
1997/98,21,27,Bolton Wanderers,19,24,4,10,10,21,40,-19,22,12,3,7,2,10,12,-2,16,12,1,3,8,11,28,-17,6,R,EN_D1,Macron Stadium,Bolton
1997/98,21,30,Barnsley,20,24,6,3,15,20,59,-39,21,11,4,2,5,12,20,-8,14,13,2,1,10,8,39,-31,7,R,EN_D1,Oakwell,Barnsley
1997/98,22,12,Manchester United,1,25,15,5,5,52,19,33,50,13,10,2,1,33,6,27,32,12,5,3,4,19,13,6,18,Q,EU_CL,Old Trafford,Manchester
1997/98,22,4,Chelsea,2,25,14,3,8,52,27,25,45,11,8,2,1,22,8,14,26,14,6,1,7,30,19,11,19,"Q,Q","EU_CL,EU_CWC",Stamford Bridge,London
1997/98,22,10,Liverpool,3,25,13,6,6,41,22,19,45,14,9,1,4,28,13,15,28,11,4,5,2,13,9,4,17,Q,EU_UC,Anfield,Liverpool
1997/98,22,3,Blackburn Rovers,4,25,12,9,4,44,27,17,45,13,8,3,2,30,15,15,27,12,4,6,2,14,12,2,18,,,Ewood Park,Blackburn
1997/98,22,1,Arsenal,5,24,12,8,4,44,26,18,44,13,9,2,2,28,9,19,29,11,3,6,2,16,17,-1,15,Q,EU_UC,Highbury,London
1997/98,22,28,Derby County,6,25,11,6,8,39,31,8,39,13,9,3,1,25,8,17,30,12,2,3,7,14,23,-9,9,Q,EU_UC,Pride Park,Derby
1997/98,22,9,Leeds United,7,25,11,5,9,34,28,6,38,12,5,3,4,17,14,3,18,13,6,2,5,17,14,3,20,Q,EU_UC,Elland Road,Leeds
1997/98,22,25,West Ham United,8,25,12,2,11,37,35,2,38,11,9,1,1,26,8,18,28,14,3,1,10,11,27,-16,10,,,Boleyn Ground,London
1997/98,22,26,Leicester City,9,25,9,9,7,28,22,6,36,14,4,7,3,14,11,3,19,11,5,2,4,14,11,3,17,,,Filbert Street,Leicester
1997/98,22,23,Newcastle United,10,25,9,5,11,25,30,-5,32,14,6,3,5,15,15,0,21,11,3,2,6,10,15,-5,11,Q,EU_CWC,St. James' Park,Newcastle
1997/98,22,20,Southampton,11,25,9,4,12,29,35,-6,31,12,7,1,4,19,14,5,22,13,2,3,8,10,21,-11,9,,,The Dell,Southampton
1997/98,22,5,Coventry City,12,25,7,9,9,29,34,-5,30,13,5,7,1,20,14,6,22,12,2,2,8,9,20,-11,8,,,Highfield Road,Coventry
1997/98,22,2,Aston Villa,13,25,8,6,11,27,34,-7,30,12,5,3,4,17,16,1,18,13,3,3,7,10,18,-8,12,,,Villa Park,Birmingham
1997/98,22,19,Sheffield Wednesday,14,25,8,6,11,37,48,-11,30,13,6,3,4,21,19,2,21,12,2,3,7,16,29,-13,9,,,Hillsborough,Sheffield
1997/98,22,22,Wimbledon,15,24,7,8,9,25,27,-2,29,12,3,3,6,12,16,-4,12,12,4,5,3,13,11,2,17,,,Selhurst Park,London
1997/98,22,7,Everton,16,25,7,7,11,30,37,-7,28,11,5,2,4,17,16,1,17,14,2,5,7,13,21,-8,11,,,Goodison Park,Liverpool
1997/98,22,21,Tottenham Hotspur,17,25,7,5,13,24,41,-17,26,12,5,3,4,13,15,-2,18,13,2,2,9,11,26,-15,8,,,White Hart Lane,London
1997/98,22,6,Crystal Palace,18,25,5,8,12,21,37,-16,23,12,0,4,8,7,23,-16,4,13,5,4,4,14,14,0,19,"R,Q","EN_D1,EU_IT",Selhurst Park,London
1997/98,22,27,Bolton Wanderers,19,25,4,11,10,22,41,-19,23,12,3,7,2,10,12,-2,16,13,1,4,8,12,29,-17,7,R,EN_D1,Macron Stadium,Bolton
1997/98,22,30,Barnsley,20,25,6,4,15,22,61,-39,22,12,4,3,5,14,22,-8,15,13,2,1,10,8,39,-31,7,R,EN_D1,Oakwell,Barnsley
1997/98,23,12,Manchester United,1,26,16,5,5,54,19,35,53,13,10,2,1,33,6,27,32,13,6,3,4,21,13,8,21,Q,EU_CL,Old Trafford,Manchester
1997/98,23,10,Liverpool,2,26,13,7,6,44,25,19,46,14,9,1,4,28,13,15,28,12,4,6,2,16,12,4,18,Q,EU_CL,Anfield,Liverpool
1997/98,23,4,Chelsea,3,25,14,3,8,52,27,25,45,11,8,2,1,22,8,14,26,14,6,1,7,30,19,11,19,"Q,Q","EU_UC,EU_CWC",Stamford Bridge,London
1997/98,23,3,Blackburn Rovers,4,25,12,9,4,44,27,17,45,13,8,3,2,30,15,15,27,12,4,6,2,14,12,2,18,,,Ewood Park,Blackburn
1997/98,23,1,Arsenal,5,24,12,8,4,44,26,18,44,13,9,2,2,28,9,19,29,11,3,6,2,16,17,-1,15,Q,EU_UC,Highbury,London
1997/98,23,28,Derby County,6,26,12,6,8,41,32,9,42,13,9,3,1,25,8,17,30,13,3,3,7,16,24,-8,12,Q,EU_UC,Pride Park,Derby
1997/98,23,9,Leeds United,7,25,11,5,9,34,28,6,38,12,5,3,4,17,14,3,18,13,6,2,5,17,14,3,20,Q,EU_UC,Elland Road,Leeds
1997/98,23,25,West Ham United,8,25,12,2,11,37,35,2,38,11,9,1,1,26,8,18,28,14,3,1,10,11,27,-16,10,,,Boleyn Ground,London
1997/98,23,26,Leicester City,9,26,9,10,7,29,23,6,37,14,4,7,3,14,11,3,19,12,5,3,4,15,12,3,18,,,Filbert Street,Leicester
1997/98,23,5,Coventry City,10,26,8,9,9,31,35,-4,33,13,5,7,1,20,14,6,22,13,3,2,8,11,21,-10,11,,,Highfield Road,Coventry
1997/98,23,23,Newcastle United,11,25,9,5,11,25,30,-5,32,14,6,3,5,15,15,0,21,11,3,2,6,10,15,-5,11,Q,EU_CWC,St. James' Park,Newcastle
1997/98,23,20,Southampton,12,26,9,4,13,30,37,-7,31,13,7,1,5,20,16,4,22,13,2,3,8,10,21,-11,9,,,The Dell,Southampton
1997/98,23,19,Sheffield Wednesday,13,26,8,7,11,40,51,-11,31,14,6,4,4,24,22,2,22,12,2,3,7,16,29,-13,9,,,Hillsborough,Sheffield
1997/98,23,2,Aston Villa,14,26,8,6,12,27,36,-9,30,13,5,3,5,17,18,-1,18,13,3,3,7,10,18,-8,12,,,Villa Park,Birmingham
1997/98,23,22,Wimbledon,15,24,7,8,9,25,27,-2,29,12,3,3,6,12,16,-4,12,12,4,5,3,13,11,2,17,,,Selhurst Park,London
1997/98,23,7,Everton,16,26,7,7,12,31,39,-8,28,12,5,2,5,18,18,0,17,14,2,5,7,13,21,-8,11,,,Goodison Park,Liverpool
1997/98,23,21,Tottenham Hotspur,17,26,7,6,13,25,42,-17,27,13,5,4,4,14,16,-2,19,13,2,2,9,11,26,-15,8,,,White Hart Lane,London
1997/98,23,6,Crystal Palace,18,25,5,8,12,21,37,-16,23,12,0,4,8,7,23,-16,4,13,5,4,4,14,14,0,19,"R,Q","EN_D1,EU_IT",Selhurst Park,London
1997/98,23,27,Bolton Wanderers,19,25,4,11,10,22,41,-19,23,12,3,7,2,10,12,-2,16,13,1,4,8,12,29,-17,7,R,EN_D1,Macron Stadium,Bolton
1997/98,23,30,Barnsley,20,25,6,4,15,22,61,-39,22,12,4,3,5,14,22,-8,15,13,2,1,10,8,39,-31,7,R,EN_D1,Oakwell,Barnsley
1997/98,24,12,Manchester United,1,27,17,5,5,56,19,37,56,14,11,2,1,35,6,29,35,13,6,3,4,21,13,8,21,Q,EU_CL,Old Trafford,Manchester
1997/98,24,1,Arsenal,2,25,13,8,4,45,26,19,47,14,10,2,2,29,9,20,32,11,3,6,2,16,17,-1,15,Q,EU_CL,Highbury,London
1997/98,24,10,Liverpool,3,27,13,8,6,45,26,19,47,15,9,2,4,29,14,15,29,12,4,6,2,16,12,4,18,Q,EU_UC,Anfield,Liverpool
1997/98,24,4,Chelsea,4,26,14,3,9,52,29,23,45,11,8,2,1,22,8,14,26,15,6,1,8,30,21,9,19,Q,EU_CWC,Stamford Bridge,London
1997/98,24,3,Blackburn Rovers,5,26,12,9,5,44,30,14,45,13,8,3,2,30,15,15,27,13,4,6,3,14,15,-1,18,Q,EU_UC,Ewood Park,Blackburn
1997/98,24,28,Derby County,6,27,12,6,9,41,34,7,42,13,9,3,1,25,8,17,30,14,3,3,8,16,26,-10,12,Q,EU_UC,Pride Park,Derby
1997/98,24,26,Leicester City,7,27,10,10,7,31,23,8,40,15,5,7,3,16,11,5,22,12,5,3,4,15,12,3,18,Q,EU_UC,Filbert Street,Leicester
1997/98,24,9,Leeds United,8,26,11,6,9,35,29,6,39,12,5,3,4,17,14,3,18,14,6,3,5,18,15,3,21,,,Elland Road,Leeds
1997/98,24,25,West Ham United,9,26,12,3,11,38,36,2,39,11,9,1,1,26,8,18,28,15,3,2,10,12,28,-16,11,,,Boleyn Ground,London
1997/98,24,5,Coventry City,10,27,9,9,9,32,35,-3,36,14,6,7,1,21,14,7,25,13,3,2,8,11,21,-10,11,,,Highfield Road,Coventry
1997/98,24,20,Southampton,11,27,10,4,13,33,37,-4,34,14,8,1,5,23,16,7,25,13,2,3,8,10,21,-11,9,,,The Dell,Southampton
1997/98,24,19,Sheffield Wednesday,12,27,9,7,11,41,51,-10,34,15,7,4,4,25,22,3,25,12,2,3,7,16,29,-13,9,,,Hillsborough,Sheffield
1997/98,24,23,Newcastle United,13,26,9,6,11,26,31,-5,33,15,6,4,5,16,16,0,22,11,3,2,6,10,15,-5,11,Q,EU_CWC,St. James' Park,Newcastle
1997/98,24,22,Wimbledon,14,25,8,8,9,27,28,-1,32,13,4,3,6,14,17,-3,15,12,4,5,3,13,11,2,17,,,Selhurst Park,London
1997/98,24,2,Aston Villa,15,27,8,6,13,28,38,-10,30,13,5,3,5,17,18,-1,18,14,3,3,8,11,20,-9,12,,,Villa Park,Birmingham
1997/98,24,7,Everton,16,27,7,8,12,32,40,-8,29,12,5,2,5,18,18,0,17,15,2,6,7,14,22,-8,12,,,Goodison Park,Liverpool
1997/98,24,21,Tottenham Hotspur,17,27,7,6,14,25,43,-18,27,13,5,4,4,14,16,-2,19,14,2,2,10,11,27,-16,8,,,White Hart Lane,London
1997/98,24,27,Bolton Wanderers,18,26,4,12,10,23,42,-19,24,13,3,8,2,11,13,-2,17,13,1,4,8,12,29,-17,7,R,EN_D1,Macron Stadium,Bolton
1997/98,24,6,Crystal Palace,19,26,5,8,13,21,38,-17,23,12,0,4,8,7,23,-16,4,14,5,4,5,14,15,-1,19,"R,Q","EN_D1,EU_IT",Selhurst Park,London
1997/98,24,30,Barnsley,20,26,6,4,16,22,62,-40,22,12,4,3,5,14,22,-8,15,14,2,1,11,8,40,-32,7,R,EN_D1,Oakwell,Barnsley
1997/98,25,12,Manchester United,1,28,18,5,5,57,19,38,59,14,11,2,1,35,6,29,35,14,7,3,4,22,13,9,24,Q,EU_CL,Old Trafford,Manchester
1997/98,25,1,Arsenal,2,26,13,9,4,45,26,19,48,14,10,2,2,29,9,20,32,12,3,7,2,16,17,-1,16,Q,EU_CL,Highbury,London
1997/98,25,3,Blackburn Rovers,3,27,13,9,5,49,33,16,48,14,9,3,2,35,18,17,30,13,4,6,3,14,15,-1,18,Q,EU_UC,Ewood Park,Blackburn
1997/98,25,10,Liverpool,4,28,13,8,7,46,28,18,47,15,9,2,4,29,14,15,29,13,4,6,3,17,14,3,18,,,Anfield,Liverpool
1997/98,25,4,Chelsea,5,27,14,3,10,52,30,22,45,12,8,2,2,22,9,13,26,15,6,1,8,30,21,9,19,"Q,Q","EU_CWC,EU_UC",Stamford Bridge,London
1997/98,25,28,Derby County,6,28,13,6,9,44,34,10,45,14,10,3,1,28,8,20,33,14,3,3,8,16,26,-10,12,Q,EU_UC,Pride Park,Derby
1997/98,25,9,Leeds United,7,28,12,6,10,36,30,6,42,14,6,3,5,18,15,3,21,14,6,3,5,18,15,3,21,Q,EU_UC,Elland Road,Leeds
1997/98,25,26,Leicester City,8,28,10,10,8,34,28,6,40,15,5,7,3,16,11,5,22,13,5,3,5,18,17,1,18,,,Filbert Street,Leicester
1997/98,25,25,West Ham United,9,27,12,4,11,38,36,2,40,12,9,2,1,26,8,18,29,15,3,2,10,12,28,-16,11,,,Boleyn Ground,London
1997/98,25,5,Coventry City,10,28,10,9,9,35,35,0,39,14,6,7,1,21,14,7,25,14,4,2,8,14,21,-7,14,,,Highfield Road,Coventry
1997/98,25,20,Southampton,11,28,11,4,13,34,37,-3,37,14,8,1,5,23,16,7,25,14,3,3,8,11,21,-10,12,,,The Dell,Southampton
1997/98,25,23,Newcastle United,12,27,9,7,11,26,31,-5,34,15,6,4,5,16,16,0,22,12,3,3,6,10,15,-5,12,Q,EU_CWC,St. James' Park,Newcastle
1997/98,25,19,Sheffield Wednesday,13,28,9,7,12,41,54,-13,34,15,7,4,4,25,22,3,25,13,2,3,8,16,32,-16,9,,,Hillsborough,Sheffield
1997/98,25,2,Aston Villa,14,28,9,6,13,30,39,-9,33,14,6,3,5,19,19,0,21,14,3,3,8,11,20,-9,12,,,Villa Park,Birmingham
1997/98,25,22,Wimbledon,15,26,8,8,10,28,30,-2,32,13,4,3,6,14,17,-3,15,13,4,5,4,14,13,1,17,,,Selhurst Park,London
1997/98,25,7,Everton,16,28,7,9,12,32,40,-8,30,13,5,3,5,18,18,0,18,15,2,6,7,14,22,-8,12,,,Goodison Park,Liverpool
1997/98,25,21,Tottenham Hotspur,17,29,8,6,15,26,44,-18,30,14,6,4,4,15,16,-1,22,15,2,2,11,11,28,-17,8,,,White Hart Lane,London
1997/98,25,30,Barnsley,18,27,7,4,16,24,63,-39,25,13,5,3,5,16,23,-7,18,14,2,1,11,8,40,-32,7,R,EN_D1,Oakwell,Barnsley
1997/98,25,27,Bolton Wanderers,19,27,4,12,11,23,43,-20,24,13,3,8,2,11,13,-2,17,14,1,4,9,12,30,-18,7,R,EN_D1,Macron Stadium,Bolton
1997/98,25,6,Crystal Palace,20,27,5,8,14,21,41,-20,23,13,0,4,9,7,26,-19,4,14,5,4,5,14,15,-1,19,"R,Q","EN_D1,EU_IT",Selhurst Park,London
1997/98,26,12,Manchester United,1,29,18,5,6,57,21,36,59,14,11,2,1,35,6,29,35,15,7,3,5,22,15,7,24,Q,EU_CL,Old Trafford,Manchester
1997/98,26,10,Liverpool,2,29,14,8,7,48,29,19,50,16,10,2,4,31,15,16,32,13,4,6,3,17,14,3,18,Q,EU_CL,Anfield,Liverpool
1997/98,26,1,Arsenal,3,26,13,9,4,45,26,19,48,14,10,2,2,29,9,20,32,12,3,7,2,16,17,-1,16,Q,EU_UC,Highbury,London
1997/98,26,3,Blackburn Rovers,4,27,13,9,5,49,33,16,48,14,9,3,2,35,18,17,30,13,4,6,3,14,15,-1,18,,,Ewood Park,Blackburn
1997/98,26,4,Chelsea,5,28,14,3,11,52,31,21,45,13,8,2,3,22,10,12,26,15,6,1,8,30,21,9,19,"Q,Q","EU_CWC,EU_UC",Stamford Bridge,London
1997/98,26,28,Derby County,6,28,13,6,9,44,34,10,45,14,10,3,1,28,8,20,33,14,3,3,8,16,26,-10,12,Q,EU_UC,Pride Park,Derby
1997/98,26,9,Leeds United,7,28,12,6,10,36,30,6,42,14,6,3,5,18,15,3,21,14,6,3,5,18,15,3,21,Q,EU_UC,Elland Road,Leeds
1997/98,26,26,Leicester City,8,28,10,10,8,34,28,6,40,15,5,7,3,16,11,5,22,13,5,3,5,18,17,1,18,,,Filbert Street,Leicester
1997/98,26,25,West Ham United,9,27,12,4,11,38,36,2,40,12,9,2,1,26,8,18,29,15,3,2,10,12,28,-16,11,,,Boleyn Ground,London
1997/98,26,20,Southampton,10,29,12,4,13,36,38,-2,40,15,9,1,5,25,17,8,28,14,3,3,8,11,21,-10,12,,,The Dell,Southampton
1997/98,26,5,Coventry City,11,28,10,9,9,35,35,0,39,14,6,7,1,21,14,7,25,14,4,2,8,14,21,-7,14,,,Highfield Road,Coventry
1997/98,26,19,Sheffield Wednesday,12,29,10,7,12,43,54,-11,37,16,8,4,4,27,22,5,28,13,2,3,8,16,32,-16,9,,,Hillsborough,Sheffield
1997/98,26,2,Aston Villa,13,29,10,6,13,31,39,-8,36,14,6,3,5,19,19,0,21,15,4,3,8,12,20,-8,15,,,Villa Park,Birmingham
1997/98,26,23,Newcastle United,14,27,9,7,11,26,31,-5,34,15,6,4,5,16,16,0,22,12,3,3,6,10,15,-5,12,Q,EU_CWC,St. James' Park,Newcastle
1997/98,26,22,Wimbledon,15,26,8,8,10,28,30,-2,32,13,4,3,6,14,17,-3,15,13,4,5,4,14,13,1,17,,,Selhurst Park,London
1997/98,26,7,Everton,16,29,7,9,13,33,42,-9,30,13,5,3,5,18,18,0,18,16,2,6,8,15,24,-9,12,,,Goodison Park,Liverpool
1997/98,26,21,Tottenham Hotspur,17,29,8,6,15,26,44,-18,30,14,6,4,4,15,16,-1,22,15,2,2,11,11,28,-17,8,,,White Hart Lane,London
1997/98,26,30,Barnsley,18,27,7,4,16,24,63,-39,25,13,5,3,5,16,23,-7,18,14,2,1,11,8,40,-32,7,R,EN_D1,Oakwell,Barnsley
1997/98,26,27,Bolton Wanderers,19,28,4,12,12,24,45,-21,24,13,3,8,2,11,13,-2,17,15,1,4,10,13,32,-19,7,R,EN_D1,Macron Stadium,Bolton
1997/98,26,6,Crystal Palace,20,27,5,8,14,21,41,-20,23,13,0,4,9,7,26,-19,4,14,5,4,5,14,15,-1,19,"R,Q","EN_D1,EU_IT",Selhurst Park,London
1997/98,27,12,Manchester United,1,30,18,6,6,58,22,36,60,14,11,2,1,35,6,29,35,16,7,4,5,23,16,7,25,Q,EU_CL,Old Trafford,Manchester
1997/98,27,1,Arsenal,2,27,14,9,4,46,26,20,51,14,10,2,2,29,9,20,32,13,4,7,2,17,17,0,19,Q,EU_CL,Highbury,London
1997/98,27,10,Liverpool,3,29,14,8,7,48,29,19,50,16,10,2,4,31,15,16,32,13,4,6,3,17,14,3,18,Q,EU_UC,Anfield,Liverpool
1997/98,27,4,Chelsea,4,29,15,3,11,58,33,25,48,14,9,2,3,28,12,16,29,15,6,1,8,30,21,9,19,Q,EU_CWC,Stamford Bridge,London
1997/98,27,3,Blackburn Rovers,5,28,13,9,6,49,37,12,48,14,9,3,2,35,18,17,30,14,4,6,4,14,19,-5,18,Q,EU_UC,Ewood Park,Blackburn
1997/98,27,28,Derby County,6,28,13,6,9,44,34,10,45,14,10,3,1,28,8,20,33,14,3,3,8,16,26,-10,12,Q,EU_UC,Pride Park,Derby
1997/98,27,9,Leeds United,7,29,13,6,10,40,30,10,45,15,7,3,5,22,15,7,24,14,6,3,5,18,15,3,21,Q,EU_UC,Elland Road,Leeds
1997/98,27,25,West Ham United,8,28,12,5,11,39,37,2,41,13,9,3,1,27,9,18,30,15,3,2,10,12,28,-16,11,,,Boleyn Ground,London
1997/98,27,26,Leicester City,9,28,10,10,8,34,28,6,40,15,5,7,3,16,11,5,22,13,5,3,5,18,17,1,18,,,Filbert Street,Leicester
1997/98,27,20,Southampton,10,29,12,4,13,36,38,-2,40,15,9,1,5,25,17,8,28,14,3,3,8,11,21,-10,12,,,The Dell,Southampton
1997/98,27,5,Coventry City,11,28,10,9,9,35,35,0,39,14,6,7,1,21,14,7,25,14,4,2,8,14,21,-7,14,,,Highfield Road,Coventry
1997/98,27,19,Sheffield Wednesday,12,29,10,7,12,43,54,-11,37,16,8,4,4,27,22,5,28,13,2,3,8,16,32,-16,9,,,Hillsborough,Sheffield
1997/98,27,2,Aston Villa,13,30,10,6,14,31,40,-9,36,15,6,3,6,19,20,-1,21,15,4,3,8,12,20,-8,15,,,Villa Park,Birmingham
1997/98,27,23,Newcastle United,14,27,9,7,11,26,31,-5,34,15,6,4,5,16,16,0,22,12,3,3,6,10,15,-5,12,Q,EU_CWC,St. James' Park,Newcastle
1997/98,27,22,Wimbledon,15,27,8,8,11,28,31,-3,32,14,4,3,7,14,18,-4,15,13,4,5,4,14,13,1,17,,,Selhurst Park,London
1997/98,27,7,Everton,16,29,7,9,13,33,42,-9,30,13,5,3,5,18,18,0,18,16,2,6,8,15,24,-9,12,,,Goodison Park,Liverpool
1997/98,27,21,Tottenham Hotspur,17,29,8,6,15,26,44,-18,30,14,6,4,4,15,16,-1,22,15,2,2,11,11,28,-17,8,,,White Hart Lane,London
1997/98,27,30,Barnsley,18,28,8,4,16,25,63,-38,28,13,5,3,5,16,23,-7,18,15,3,1,11,9,40,-31,10,R,EN_D1,Oakwell,Barnsley
1997/98,27,27,Bolton Wanderers,19,28,4,12,12,24,45,-21,24,13,3,8,2,11,13,-2,17,15,1,4,10,13,32,-19,7,R,EN_D1,Macron Stadium,Bolton
1997/98,27,6,Crystal Palace,20,28,5,8,15,23,47,-24,23,13,0,4,9,7,26,-19,4,15,5,4,6,16,21,-5,19,"R,Q","EN_D1,EU_IT",Selhurst Park,London
1997/98,28,12,Manchester United,1,31,18,6,7,58,23,35,60,15,11,2,2,35,7,28,35,16,7,4,5,23,16,7,25,Q,EU_CL,Old Trafford,Manchester
1997/98,28,1,Arsenal,2,28,15,9,4,47,26,21,54,14,10,2,2,29,9,20,32,14,5,7,2,18,17,1,22,Q,EU_CL,Highbury,London
1997/98,28,10,Liverpool,3,30,14,9,7,51,32,19,51,16,10,2,4,31,15,16,32,14,4,7,3,20,17,3,19,Q,EU_UC,Anfield,Liverpool
1997/98,28,4,Chelsea,4,30,15,3,12,59,35,24,48,14,9,2,3,28,12,16,29,16,6,1,9,31,23,8,19,Q,EU_CWC,Stamford Bridge,London
1997/98,28,9,Leeds United,5,30,14,6,10,45,30,15,48,15,7,3,5,22,15,7,24,15,7,3,5,23,15,8,24,Q,EU_UC,Elland Road,Leeds
1997/98,28,3,Blackburn Rovers,6,29,13,9,7,49,38,11,48,14,9,3,2,35,18,17,30,15,4,6,5,14,20,-6,18,Q,EU_UC,Ewood Park,Blackburn
1997/98,28,28,Derby County,7,29,13,6,10,44,39,5,45,15,10,3,2,28,13,15,33,14,3,3,8,16,26,-10,12,Q,EU_UC,Pride Park,Derby
1997/98,28,25,West Ham United,8,29,13,5,11,41,38,3,44,14,10,3,1,29,10,19,33,15,3,2,10,12,28,-16,11,,,Boleyn Ground,London
1997/98,28,26,Leicester City,9,29,10,10,9,35,30,5,40,15,5,7,3,16,11,5,22,14,5,3,6,19,19,0,18,,,Filbert Street,Leicester
1997/98,28,5,Coventry City,10,29,10,10,9,35,35,0,40,14,6,7,1,21,14,7,25,15,4,3,8,14,21,-7,15,,,Highfield Road,Coventry
1997/98,28,20,Southampton,11,30,12,4,14,39,42,-3,40,15,9,1,5,25,17,8,28,15,3,3,9,14,25,-11,12,,,The Dell,Southampton
1997/98,28,2,Aston Villa,12,31,11,6,14,34,41,-7,39,16,7,3,6,22,21,1,24,15,4,3,8,12,20,-8,15,,,Villa Park,Birmingham
1997/98,28,19,Sheffield Wednesday,13,30,10,7,13,45,57,-12,37,16,8,4,4,27,22,5,28,14,2,3,9,18,35,-17,9,,,Hillsborough,Sheffield
1997/98,28,22,Wimbledon,14,28,9,8,11,30,32,-2,35,15,5,3,7,16,19,-3,18,13,4,5,4,14,13,1,17,,,Selhurst Park,London
1997/98,28,23,Newcastle United,15,29,9,8,12,27,33,-6,35,17,6,5,6,17,18,-1,23,12,3,3,6,10,15,-5,12,Q,EU_CWC,St. James' Park,Newcastle
1997/98,28,7,Everton,16,30,8,9,13,34,42,-8,33,14,6,3,5,19,18,1,21,16,2,6,8,15,24,-9,12,,,Goodison Park,Liverpool
1997/98,28,21,Tottenham Hotspur,17,30,8,7,15,29,47,-18,31,15,6,5,4,18,19,-1,23,15,2,2,11,11,28,-17,8,,,White Hart Lane,London
1997/98,28,30,Barnsley,18,29,9,4,16,29,66,-37,31,14,6,3,5,20,26,-6,21,15,3,1,11,9,40,-31,10,R,EN_D1,Oakwell,Barnsley
1997/98,28,27,Bolton Wanderers,19,29,5,12,12,27,47,-20,27,14,4,8,2,14,15,-1,20,15,1,4,10,13,32,-19,7,R,EN_D1,Macron Stadium,Bolton
1997/98,28,6,Crystal Palace,20,30,6,8,16,26,51,-25,26,13,0,4,9,7,26,-19,4,17,6,4,7,19,25,-6,22,"R,Q","EN_D1,EU_IT",Selhurst Park,London
1997/98,29,12,Manchester United,1,32,19,6,7,60,23,37,63,16,12,2,2,37,7,30,38,16,7,4,5,23,16,7,25,Q,EU_CL,Old Trafford,Manchester
1997/98,29,1,Arsenal,2,29,16,9,4,48,26,22,57,15,11,2,2,30,9,21,35,14,5,7,2,18,17,1,22,Q,EU_CL,Highbury,London
1997/98,29,10,Liverpool,3,31,15,9,7,54,34,20,54,16,10,2,4,31,15,16,32,15,5,7,3,23,19,4,22,Q,EU_UC,Anfield,Liverpool
1997/98,29,4,Chelsea,4,30,15,3,12,59,35,24,48,14,9,2,3,28,12,16,29,16,6,1,9,31,23,8,19,Q,EU_CWC,Stamford Bridge,London
1997/98,29,9,Leeds United,5,30,14,6,10,45,30,15,48,15,7,3,5,22,15,7,24,15,7,3,5,23,15,8,24,Q,EU_UC,Elland Road,Leeds
1997/98,29,3,Blackburn Rovers,6,29,13,9,7,49,38,11,48,14,9,3,2,35,18,17,30,15,4,6,5,14,20,-6,18,Q,EU_UC,Ewood Park,Blackburn
1997/98,29,28,Derby County,7,30,13,6,11,44,40,4,45,15,10,3,2,28,13,15,33,15,3,3,9,16,27,-11,12,Q,EU_UC,Pride Park,Derby
1997/98,29,25,West Ham United,8,29,13,5,11,41,38,3,44,14,10,3,1,29,10,19,33,15,3,2,10,12,28,-16,11,,,Boleyn Ground,London
1997/98,29,5,Coventry City,9,30,11,10,9,36,35,1,43,15,7,7,1,22,14,8,28,15,4,3,8,14,21,-7,15,,,Highfield Road,Coventry
1997/98,29,20,Southampton,10,31,13,4,14,41,43,-2,43,16,10,1,5,27,18,9,31,15,3,3,9,14,25,-11,12,,,The Dell,Southampton
1997/98,29,2,Aston Villa,11,32,12,6,14,38,42,-4,42,16,7,3,6,22,21,1,24,16,5,3,8,16,21,-5,18,,,Villa Park,Birmingham
1997/98,29,26,Leicester City,12,30,10,10,10,35,32,3,40,15,5,7,3,16,11,5,22,15,5,3,7,19,21,-2,18,,,Filbert Street,Leicester
1997/98,29,19,Sheffield Wednesday,13,31,10,7,14,45,58,-13,37,16,8,4,4,27,22,5,28,15,2,3,10,18,36,-18,9,,,Hillsborough,Sheffield
1997/98,29,22,Wimbledon,14,29,9,8,12,30,34,-4,35,15,5,3,7,16,19,-3,18,14,4,5,5,14,15,-1,17,,,Selhurst Park,London
1997/98,29,23,Newcastle United,15,30,9,8,13,28,35,-7,35,17,6,5,6,17,18,-1,23,13,3,3,7,11,17,-6,12,Q,EU_CWC,St. James' Park,Newcastle
1997/98,29,21,Tottenham Hotspur,16,31,9,7,15,32,48,-16,34,15,6,5,4,18,19,-1,23,16,3,2,11,14,29,-15,11,,,White Hart Lane,London
1997/98,29,7,Everton,17,31,8,9,14,35,46,-11,33,15,6,3,6,20,22,-2,21,16,2,6,8,15,24,-9,12,,,Goodison Park,Liverpool
1997/98,29,30,Barnsley,18,30,9,4,17,31,69,-38,31,15,6,3,6,22,29,-7,21,15,3,1,11,9,40,-31,10,R,EN_D1,Oakwell,Barnsley
1997/98,29,27,Bolton Wanderers,19,30,6,12,12,29,47,-18,30,15,5,8,2,16,15,1,23,15,1,4,10,13,32,-19,7,R,EN_D1,Macron Stadium,Bolton
1997/98,29,6,Crystal Palace,20,31,6,8,17,27,54,-27,26,14,0,4,10,8,29,-21,4,17,6,4,7,19,25,-6,22,"R,Q","EN_D1,EU_IT",Selhurst Park,London
1997/98,30,12,Manchester United,1,32,19,6,7,60,23,37,63,16,12,2,2,37,7,30,38,16,7,4,5,23,16,7,25,Q,EU_CL,Old Trafford,Manchester
1997/98,30,1,Arsenal,2,30,17,9,4,49,26,23,60,15,11,2,2,30,9,21,35,15,6,7,2,19,17,2,25,Q,EU_CL,Highbury,London
1997/98,30,10,Liverpool,3,31,15,9,7,54,34,20,54,16,10,2,4,31,15,16,32,15,5,7,3,23,19,4,22,Q,EU_UC,Anfield,Liverpool
1997/98,30,3,Blackburn Rovers,4,30,14,9,7,51,39,12,51,15,10,3,2,37,19,18,33,15,4,6,5,14,20,-6,18,,,Ewood Park,Blackburn
1997/98,30,4,Chelsea,5,30,15,3,12,59,35,24,48,14,9,2,3,28,12,16,29,16,6,1,9,31,23,8,19,"Q,Q","EU_CWC,EU_UC",Stamford Bridge,London
1997/98,30,9,Leeds United,6,31,14,6,11,45,33,12,48,15,7,3,5,22,15,7,24,16,7,3,6,23,18,5,24,Q,EU_UC,Elland Road,Leeds
1997/98,30,25,West Ham United,7,30,14,5,11,44,38,6,47,15,11,3,1,32,10,22,36,15,3,2,10,12,28,-16,11,Q,EU_UC,Boleyn Ground,London
1997/98,30,28,Derby County,8,30,13,6,11,44,40,4,45,15,10,3,2,28,13,15,33,15,3,3,9,16,27,-11,12,,,Pride Park,Derby
1997/98,30,5,Coventry City,9,30,11,10,9,36,35,1,43,15,7,7,1,22,14,8,28,15,4,3,8,14,21,-7,15,,,Highfield Road,Coventry
1997/98,30,20,Southampton,10,31,13,4,14,41,43,-2,43,16,10,1,5,27,18,9,31,15,3,3,9,14,25,-11,12,,,The Dell,Southampton
1997/98,30,2,Aston Villa,11,32,12,6,14,38,42,-4,42,16,7,3,6,22,21,1,24,16,5,3,8,16,21,-5,18,,,Villa Park,Birmingham
1997/98,30,26,Leicester City,12,30,10,10,10,35,32,3,40,15,5,7,3,16,11,5,22,15,5,3,7,19,21,-2,18,,,Filbert Street,Leicester
1997/98,30,19,Sheffield Wednesday,13,31,10,7,14,45,58,-13,37,16,8,4,4,27,22,5,28,15,2,3,10,18,36,-18,9,,,Hillsborough,Sheffield
1997/98,30,22,Wimbledon,14,30,9,9,12,30,34,-4,36,16,5,4,7,16,19,-3,19,14,4,5,5,14,15,-1,17,,,Selhurst Park,London
1997/98,30,23,Newcastle United,15,31,9,9,13,28,35,-7,36,17,6,5,6,17,18,-1,23,14,3,4,7,11,17,-6,13,Q,EU_CWC,St. James' Park,Newcastle
1997/98,30,21,Tottenham Hotspur,16,31,9,7,15,32,48,-16,34,15,6,5,4,18,19,-1,23,16,3,2,11,14,29,-15,11,,,White Hart Lane,London
1997/98,30,7,Everton,17,31,8,9,14,35,46,-11,33,15,6,3,6,20,22,-2,21,16,2,6,8,15,24,-9,12,,,Goodison Park,Liverpool
1997/98,30,30,Barnsley,18,31,9,4,18,32,71,-39,31,15,6,3,6,22,29,-7,21,16,3,1,12,10,42,-32,10,R,EN_D1,Oakwell,Barnsley
1997/98,30,27,Bolton Wanderers,19,31,6,12,13,29,48,-19,30,16,5,8,3,16,16,0,23,15,1,4,10,13,32,-19,7,R,EN_D1,Macron Stadium,Bolton
1997/98,30,6,Crystal Palace,20,31,6,8,17,27,54,-27,26,14,0,4,10,8,29,-21,4,17,6,4,7,19,25,-6,22,"R,Q","EN_D1,EU_IT",Selhurst Park,London
1997/98,31,12,Manchester United,1,33,20,6,7,63,24,39,66,16,12,2,2,37,7,30,38,17,8,4,5,26,17,9,28,Q,EU_CL,Old Trafford,Manchester
1997/98,31,1,Arsenal,2,30,17,9,4,49,26,23,60,15,11,2,2,30,9,21,35,15,6,7,2,19,17,2,25,Q,EU_CL,Highbury,London
1997/98,31,10,Liverpool,3,31,15,9,7,54,34,20,54,16,10,2,4,31,15,16,32,15,5,7,3,23,19,4,22,Q,EU_UC,Anfield,Liverpool
1997/98,31,9,Leeds United,4,33,16,6,11,50,35,15,54,17,9,3,5,27,17,10,30,16,7,3,6,23,18,5,24,,,Elland Road,Leeds
1997/98,31,4,Chelsea,5,32,16,3,13,61,38,23,51,14,9,2,3,28,12,16,29,18,7,1,10,33,26,7,22,"Q,Q","EU_CWC,EU_UC",Stamford Bridge,London
1997/98,31,3,Blackburn Rovers,6,31,14,9,8,52,42,10,51,16,10,3,3,38,22,16,33,15,4,6,5,14,20,-6,18,Q,EU_UC,Ewood Park,Blackburn
1997/98,31,25,West Ham United,7,31,14,5,12,44,40,4,47,15,11,3,1,32,10,22,36,16,3,2,11,12,30,-18,11,Q,EU_UC,Boleyn Ground,London
1997/98,31,28,Derby County,8,31,13,6,12,44,41,3,45,16,10,3,3,28,14,14,33,15,3,3,9,16,27,-11,12,,,Pride Park,Derby
1997/98,31,2,Aston Villa,9,33,13,6,14,40,42,-2,45,17,8,3,6,24,21,3,27,16,5,3,8,16,21,-5,18,,,Villa Park,Birmingham
1997/98,31,5,Coventry City,10,31,11,11,9,37,36,1,44,15,7,7,1,22,14,8,28,16,4,4,8,15,22,-7,16,,,Highfield Road,Coventry
1997/98,31,20,Southampton,11,32,13,4,15,41,44,-3,43,16,10,1,5,27,18,9,31,16,3,3,10,14,26,-12,12,,,The Dell,Southampton
1997/98,31,26,Leicester City,12,31,10,11,10,36,33,3,41,16,5,8,3,17,12,5,23,15,5,3,7,19,21,-2,18,,,Filbert Street,Leicester
1997/98,31,19,Sheffield Wednesday,13,32,11,7,14,46,58,-12,40,17,9,4,4,28,22,6,31,15,2,3,10,18,36,-18,9,,,Hillsborough,Sheffield
1997/98,31,22,Wimbledon,14,31,9,10,12,30,34,-4,37,17,5,5,7,16,19,-3,20,14,4,5,5,14,15,-1,17,,,Selhurst Park,London
1997/98,31,23,Newcastle United,15,31,9,9,13,28,35,-7,36,17,6,5,6,17,18,-1,23,14,3,4,7,11,17,-6,13,Q,EU_CWC,St. James' Park,Newcastle
1997/98,31,21,Tottenham Hotspur,16,32,9,8,15,33,49,-16,35,16,6,6,4,19,20,-1,24,16,3,2,11,14,29,-15,11,,,White Hart Lane,London
1997/98,31,7,Everton,17,32,8,10,14,36,47,-11,34,15,6,3,6,20,22,-2,21,17,2,7,8,16,25,-9,13,,,Goodison Park,Liverpool
1997/98,31,27,Bolton Wanderers,18,32,6,13,13,29,48,-19,31,16,5,8,3,16,16,0,23,16,1,5,10,13,32,-19,8,R,EN_D1,Macron Stadium,Bolton
1997/98,31,30,Barnsley,19,32,9,4,19,33,73,-40,31,15,6,3,6,22,29,-7,21,17,3,1,13,11,44,-33,10,R,EN_D1,Oakwell,Barnsley
1997/98,31,6,Crystal Palace,20,31,6,8,17,27,54,-27,26,14,0,4,10,8,29,-21,4,17,6,4,7,19,25,-6,22,"R,Q","EN_D1,EU_IT",Selhurst Park,London
1997/98,32,12,Manchester United,1,34,20,7,7,64,25,39,67,17,12,3,2,38,8,30,39,17,8,4,5,26,17,9,28,Q,EU_CL,Old Trafford,Manchester
1997/98,32,1,Arsenal,2,31,18,9,4,52,27,25,63,16,12,2,2,33,10,23,38,15,6,7,2,19,17,2,25,Q,EU_CL,Highbury,London
1997/98,32,10,Liverpool,3,32,15,10,7,55,35,20,55,16,10,2,4,31,15,16,32,16,5,8,3,24,20,4,23,Q,EU_UC,Anfield,Liverpool
1997/98,32,4,Chelsea,4,33,17,3,13,63,38,25,54,15,10,2,3,30,12,18,32,18,7,1,10,33,26,7,22,Q,EU_CWC,Stamford Bridge,London
1997/98,32,9,Leeds United,5,34,16,6,12,50,37,13,54,17,9,3,5,27,17,10,30,17,7,3,7,23,20,3,24,Q,EU_UC,Elland Road,Leeds
1997/98,32,3,Blackburn Rovers,6,32,14,9,9,53,44,9,51,16,10,3,3,38,22,16,33,16,4,6,6,15,22,-7,18,Q,EU_UC,Ewood Park,Blackburn
1997/98,32,25,West Ham United,7,32,14,6,12,44,40,4,48,16,11,4,1,32,10,22,37,16,3,2,11,12,30,-18,11,Q,EU_UC,Boleyn Ground,London
1997/98,32,2,Aston Villa,8,34,14,6,14,42,43,-1,48,17,8,3,6,24,21,3,27,17,6,3,8,18,22,-4,21,,,Villa Park,Birmingham
1997/98,32,28,Derby County,9,32,13,7,12,44,41,3,46,16,10,3,3,28,14,14,33,16,3,4,9,16,27,-11,13,,,Pride Park,Derby
1997/98,32,26,Leicester City,10,32,11,11,10,39,33,6,44,16,5,8,3,17,12,5,23,16,6,3,7,22,21,1,21,,,Filbert Street,Leicester
1997/98,32,5,Coventry City,11,32,11,11,10,38,38,0,44,16,7,7,2,23,16,7,28,16,4,4,8,15,22,-7,16,,,Highfield Road,Coventry
1997/98,32,20,Southampton,12,33,13,4,16,41,45,-4,43,17,10,1,6,27,19,8,31,16,3,3,10,14,26,-12,12,,,The Dell,Southampton
1997/98,32,22,Wimbledon,13,32,10,10,12,31,34,-3,40,17,5,5,7,16,19,-3,20,15,5,5,5,15,15,0,20,,,Selhurst Park,London
1997/98,32,19,Sheffield Wednesday,14,33,11,7,15,47,60,-13,40,17,9,4,4,28,22,6,31,16,2,3,11,19,38,-19,9,,,Hillsborough,Sheffield
1997/98,32,7,Everton,15,33,9,10,14,38,47,-9,37,16,7,3,6,22,22,0,24,17,2,7,8,16,25,-9,13,,,Goodison Park,Liverpool
1997/98,32,23,Newcastle United,16,32,9,9,14,29,38,-9,36,17,6,5,6,17,18,-1,23,15,3,4,8,12,20,-8,13,Q,EU_CWC,St. James' Park,Newcastle
1997/98,32,21,Tottenham Hotspur,17,33,9,8,16,33,51,-18,35,16,6,6,4,19,20,-1,24,17,3,2,12,14,31,-17,11,,,White Hart Lane,London
1997/98,32,27,Bolton Wanderers,18,33,7,13,13,31,49,-18,34,17,6,8,3,18,17,1,26,16,1,5,10,13,32,-19,8,R,EN_D1,Macron Stadium,Bolton
1997/98,32,30,Barnsley,19,33,10,4,19,35,74,-39,34,16,7,3,6,24,30,-6,24,17,3,1,13,11,44,-33,10,R,EN_D1,Oakwell,Barnsley
1997/98,32,6,Crystal Palace,20,32,6,8,18,27,57,-30,26,15,0,4,11,8,32,-24,4,17,6,4,7,19,25,-6,22,"R,Q","EN_D1,EU_IT",Selhurst Park,London
1997/98,33,12,Manchester United,1,34,20,7,7,64,25,39,67,17,12,3,2,38,8,30,39,17,8,4,5,26,17,9,28,Q,EU_CL,Old Trafford,Manchester
1997/98,33,1,Arsenal,2,32,19,9,4,56,28,28,66,16,12,2,2,33,10,23,38,16,7,7,2,23,18,5,28,Q,EU_CL,Highbury,London
1997/98,33,10,Liverpool,3,33,16,10,7,57,36,21,58,17,11,2,4,33,16,17,35,16,5,8,3,24,20,4,23,Q,EU_UC,Anfield,Liverpool
1997/98,33,4,Chelsea,4,33,17,3,13,63,38,25,54,15,10,2,3,30,12,18,32,18,7,1,10,33,26,7,22,Q,EU_CWC,Stamford Bridge,London
1997/98,33,9,Leeds United,5,34,16,6,12,50,37,13,54,17,9,3,5,27,17,10,30,17,7,3,7,23,20,3,24,Q,EU_UC,Elland Road,Leeds
1997/98,33,3,Blackburn Rovers,6,33,14,9,10,54,48,6,51,17,10,3,4,39,26,13,33,16,4,6,6,15,22,-7,18,Q,EU_UC,Ewood Park,Blackburn
1997/98,33,28,Derby County,7,33,14,7,12,48,41,7,49,17,11,3,3,32,14,18,36,16,3,4,9,16,27,-11,13,Q,EU_UC,Pride Park,Derby
1997/98,33,25,West Ham United,8,33,14,7,12,45,41,4,49,16,11,4,1,32,10,22,37,17,3,3,11,13,31,-18,12,,,Boleyn Ground,London
1997/98,33,2,Aston Villa,9,34,14,6,14,42,43,-1,48,17,8,3,6,24,21,3,27,17,6,3,8,18,22,-4,21,,,Villa Park,Birmingham
1997/98,33,26,Leicester City,10,33,11,12,10,42,36,6,45,17,5,9,3,20,15,5,24,16,6,3,7,22,21,1,21,,,Filbert Street,Leicester
1997/98,33,5,Coventry City,11,33,11,12,10,39,39,0,45,16,7,7,2,23,16,7,28,17,4,5,8,16,23,-7,17,,,Highfield Road,Coventry
1997/98,33,20,Southampton,12,34,13,5,16,44,48,-4,44,17,10,1,6,27,19,8,31,17,3,4,10,17,29,-12,13,,,The Dell,Southampton
1997/98,33,22,Wimbledon,13,33,10,11,12,31,34,-3,41,18,5,6,7,16,19,-3,21,15,5,5,5,15,15,0,20,,,Selhurst Park,London
1997/98,33,19,Sheffield Wednesday,14,34,11,8,15,48,61,-13,41,18,9,5,4,29,23,6,32,16,2,3,11,19,38,-19,9,,,Hillsborough,Sheffield
1997/98,33,23,Newcastle United,15,33,10,9,14,31,39,-8,39,18,7,5,6,19,19,0,26,15,3,4,8,12,20,-8,13,Q,EU_CWC,St. James' Park,Newcastle
1997/98,33,7,Everton,16,34,9,11,14,38,47,-9,38,16,7,3,6,22,22,0,24,18,2,8,8,16,25,-9,14,,,Goodison Park,Liverpool
1997/98,33,21,Tottenham Hotspur,17,34,9,9,16,34,52,-18,36,17,6,7,4,20,21,-1,25,17,3,2,12,14,31,-17,11,,,White Hart Lane,London
1997/98,33,27,Bolton Wanderers,18,34,7,13,14,31,53,-22,34,17,6,8,3,18,17,1,26,17,1,5,11,13,36,-23,8,R,EN_D1,Macron Stadium,Bolton
1997/98,33,30,Barnsley,19,34,10,4,20,36,76,-40,34,16,7,3,6,24,30,-6,24,18,3,1,14,12,46,-34,10,R,EN_D1,Oakwell,Barnsley
1997/98,33,6,Crystal Palace,20,33,6,8,19,28,59,-31,26,15,0,4,11,8,32,-24,4,18,6,4,8,20,27,-7,22,"R,Q","EN_D1,EU_IT",Selhurst Park,London
1997/98,34,1,Arsenal,1,33,20,9,4,61,28,33,69,17,13,2,2,38,10,28,41,16,7,7,2,23,18,5,28,Q,EU_CL,Highbury,London
1997/98,34,12,Manchester United,2,35,20,8,7,65,26,39,68,18,12,4,2,39,9,30,40,17,8,4,5,26,17,9,28,Q,EU_CL,Old Trafford,Manchester
1997/98,34,10,Liverpool,3,34,16,11,7,58,37,21,59,17,11,2,4,33,16,17,35,17,5,9,3,25,21,4,24,Q,EU_UC,Anfield,Liverpool
1997/98,34,4,Chelsea,4,34,18,3,13,64,38,26,57,16,11,2,3,31,12,19,35,18,7,1,10,33,26,7,22,Q,EU_CWC,Stamford Bridge,London
1997/98,34,9,Leeds United,5,35,17,6,12,53,39,14,57,17,9,3,5,27,17,10,30,18,8,3,7,26,22,4,27,Q,EU_UC,Elland Road,Leeds
1997/98,34,25,West Ham United,6,34,15,7,12,47,42,5,52,17,12,4,1,34,11,23,40,17,3,3,11,13,31,-18,12,Q,EU_UC,Boleyn Ground,London
1997/98,34,3,Blackburn Rovers,7,34,14,9,11,55,50,5,51,17,10,3,4,39,26,13,33,17,4,6,7,16,24,-8,18,Q,EU_UC,Ewood Park,Blackburn
1997/98,34,2,Aston Villa,8,35,15,6,14,44,44,0,51,17,8,3,6,24,21,3,27,18,7,3,8,20,23,-3,24,,,Villa Park,Birmingham
1997/98,34,28,Derby County,9,34,14,7,13,49,44,5,49,17,11,3,3,32,14,18,36,17,3,4,10,17,30,-13,13,,,Pride Park,Derby
1997/98,34,26,Leicester City,10,34,11,13,10,43,37,6,46,17,5,9,3,20,15,5,24,17,6,4,7,23,22,1,22,,,Filbert Street,Leicester
1997/98,34,5,Coventry City,11,34,11,13,10,40,40,0,46,17,7,8,2,24,17,7,29,17,4,5,8,16,23,-7,17,,,Highfield Road,Coventry
1997/98,34,20,Southampton,12,35,13,5,17,45,50,-5,44,18,10,1,7,28,21,7,31,17,3,4,10,17,29,-12,13,,,The Dell,Southampton
1997/98,34,22,Wimbledon,13,34,10,11,13,31,39,-8,41,18,5,6,7,16,19,-3,21,16,5,5,6,15,20,-5,20,,,Selhurst Park,London
1997/98,34,19,Sheffield Wednesday,14,35,11,8,16,48,62,-14,41,18,9,5,4,29,23,6,32,17,2,3,12,19,39,-20,9,,,Hillsborough,Sheffield
1997/98,34,23,Newcastle United,15,34,10,10,14,32,40,-8,40,18,7,5,6,19,19,0,26,16,3,5,8,13,21,-8,14,Q,EU_CWC,St. James' Park,Newcastle
1997/98,34,7,Everton,16,35,9,12,14,39,48,-9,39,17,7,4,6,23,23,0,25,18,2,8,8,16,25,-9,14,,,Goodison Park,Liverpool
1997/98,34,21,Tottenham Hotspur,17,35,9,10,16,35,53,-18,37,17,6,7,4,20,21,-1,25,18,3,3,12,15,32,-17,12,,,White Hart Lane,London
1997/98,34,30,Barnsley,18,35,10,5,20,37,77,-40,35,17,7,4,6,25,31,-6,25,18,3,1,14,12,46,-34,10,R,EN_D1,Oakwell,Barnsley
1997/98,34,27,Bolton Wanderers,19,35,7,13,15,33,56,-23,34,18,6,8,4,20,20,0,26,17,1,5,11,13,36,-23,8,R,EN_D1,Macron Stadium,Bolton
1997/98,34,6,Crystal Palace,20,34,7,8,19,31,60,-29,29,16,1,4,11,11,33,-22,7,18,6,4,8,20,27,-7,22,"R,Q","EN_D1,EU_IT",Selhurst Park,London
1997/98,35,1,Arsenal,1,34,21,9,4,63,28,35,72,17,13,2,2,38,10,28,41,17,8,7,2,25,18,7,31,Q,EU_CL,Highbury,London
1997/98,35,12,Manchester United,2,36,21,8,7,68,26,42,71,18,12,4,2,39,9,30,40,18,9,4,5,29,17,12,31,Q,EU_CL,Old Trafford,Manchester
1997/98,35,4,Chelsea,3,35,19,3,13,68,39,29,60,17,12,2,3,35,13,22,38,18,7,1,10,33,26,7,22,"Q,Q","EU_UC,EU_CWC",Stamford Bridge,London
1997/98,35,10,Liverpool,4,35,16,11,8,59,41,18,59,17,11,2,4,33,16,17,35,18,5,9,4,26,25,1,24,,,Anfield,Liverpool
1997/98,35,9,Leeds United,5,36,17,7,12,56,42,14,58,18,9,4,5,30,20,10,31,18,8,3,7,26,22,4,27,Q,EU_UC,Elland Road,Leeds
1997/98,35,3,Blackburn Rovers,6,35,14,10,11,55,50,5,52,18,10,4,4,39,26,13,34,17,4,6,7,16,24,-8,18,Q,EU_UC,Ewood Park,Blackburn
1997/98,35,25,West Ham United,7,35,15,7,13,49,46,3,52,18,12,4,2,36,15,21,40,17,3,3,11,13,31,-18,12,Q,EU_UC,Boleyn Ground,London
1997/98,35,2,Aston Villa,8,36,15,6,15,45,47,-2,51,18,8,3,7,25,24,1,27,18,7,3,8,20,23,-3,24,,,Villa Park,Birmingham
1997/98,35,26,Leicester City,9,35,12,13,10,47,37,10,49,17,5,9,3,20,15,5,24,18,7,4,7,27,22,5,25,,,Filbert Street,Leicester
1997/98,35,28,Derby County,10,35,14,7,14,49,48,1,49,18,11,3,4,32,18,14,36,17,3,4,10,17,30,-13,13,,,Pride Park,Derby
1997/98,35,5,Coventry City,11,35,11,14,10,43,43,0,47,17,7,8,2,24,17,7,29,18,4,6,8,19,26,-7,18,,,Highfield Road,Coventry
1997/98,35,20,Southampton,12,36,14,5,17,49,52,-3,47,18,10,1,7,28,21,7,31,18,4,4,10,21,31,-10,16,,,The Dell,Southampton
1997/98,35,19,Sheffield Wednesday,13,36,12,8,16,51,63,-12,44,18,9,5,4,29,23,6,32,18,3,3,12,22,40,-18,12,,,Hillsborough,Sheffield
1997/98,35,22,Wimbledon,14,35,10,12,13,31,39,-8,42,18,5,6,7,16,19,-3,21,17,5,6,6,15,20,-5,21,,,Selhurst Park,London
1997/98,35,23,Newcastle United,15,35,10,10,15,32,42,-10,40,18,7,5,6,19,19,0,26,17,3,5,9,13,23,-10,14,Q,EU_CWC,St. James' Park,Newcastle
1997/98,35,21,Tottenham Hotspur,16,36,10,10,16,37,53,-16,40,18,7,7,4,22,21,1,28,18,3,3,12,15,32,-17,12,,,White Hart Lane,London
1997/98,35,7,Everton,17,36,9,12,15,40,51,-11,39,18,7,4,7,24,26,-2,25,18,2,8,8,16,25,-9,14,,,Goodison Park,Liverpool
1997/98,35,27,Bolton Wanderers,18,36,8,13,15,36,57,-21,37,18,6,8,4,20,20,0,26,18,2,5,11,16,37,-21,11,R,EN_D1,Macron Stadium,Bolton
1997/98,35,30,Barnsley,19,36,10,5,21,37,79,-42,35,18,7,4,7,25,33,-8,25,18,3,1,14,12,46,-34,10,R,EN_D1,Oakwell,Barnsley
1997/98,35,6,Crystal Palace,20,35,7,8,20,31,63,-32,29,17,1,4,12,11,36,-25,7,18,6,4,8,20,27,-7,22,"R,Q","EN_D1,EU_IT",Selhurst Park,London
1997/98,36,1,Arsenal,1,35,22,9,4,64,28,36,75,18,14,2,2,39,10,29,44,17,8,7,2,25,18,7,31,Q,EU_CL,Highbury,London
1997/98,36,12,Manchester United,2,36,21,8,7,68,26,42,71,18,12,4,2,39,9,30,40,18,9,4,5,29,17,12,31,Q,EU_CL,Old Trafford,Manchester
1997/98,36,4,Chelsea,3,36,19,3,14,68,40,28,60,18,12,2,4,35,14,21,38,18,7,1,10,33,26,7,22,"Q,Q","EU_UC,EU_CWC",Stamford Bridge,London
1997/98,36,10,Liverpool,4,35,16,11,8,59,41,18,59,17,11,2,4,33,16,17,35,18,5,9,4,26,25,1,24,,,Anfield,Liverpool
1997/98,36,9,Leeds United,5,36,17,7,12,56,42,14,58,18,9,4,5,30,20,10,31,18,8,3,7,26,22,4,27,Q,EU_UC,Elland Road,Leeds
1997/98,36,3,Blackburn Rovers,6,36,15,10,11,56,50,6,55,18,10,4,4,39,26,13,34,18,5,6,7,17,24,-7,21,Q,EU_UC,Ewood Park,Blackburn
1997/98,36,25,West Ham United,7,35,15,7,13,49,46,3,52,18,12,4,2,36,15,21,40,17,3,3,11,13,31,-18,12,Q,EU_UC,Boleyn Ground,London
1997/98,36,2,Aston Villa,8,36,15,6,15,45,47,-2,51,18,8,3,7,25,24,1,27,18,7,3,8,20,23,-3,24,,,Villa Park,Birmingham
1997/98,36,26,Leicester City,9,36,12,14,10,47,37,10,50,18,5,10,3,20,15,5,25,18,7,4,7,27,22,5,25,,,Filbert Street,Leicester
1997/98,36,28,Derby County,10,36,14,7,15,49,49,0,49,18,11,3,4,32,18,14,36,18,3,4,11,17,31,-14,13,,,Pride Park,Derby
1997/98,36,5,Coventry City,11,36,11,15,10,43,43,0,48,18,7,9,2,24,17,7,30,18,4,6,8,19,26,-7,18,,,Highfield Road,Coventry
1997/98,36,20,Southampton,12,36,14,5,17,49,52,-3,47,18,10,1,7,28,21,7,31,18,4,4,10,21,31,-10,16,,,The Dell,Southampton
1997/98,36,19,Sheffield Wednesday,13,36,12,8,16,51,63,-12,44,18,9,5,4,29,23,6,32,18,3,3,12,22,40,-18,12,,,Hillsborough,Sheffield
1997/98,36,22,Wimbledon,14,36,10,13,13,31,39,-8,43,18,5,6,7,16,19,-3,21,18,5,7,6,15,20,-5,22,,,Selhurst Park,London
1997/98,36,23,Newcastle United,15,36,10,11,15,32,42,-10,41,18,7,5,6,19,19,0,26,18,3,6,9,13,23,-10,15,Q,EU_CWC,St. James' Park,Newcastle
1997/98,36,21,Tottenham Hotspur,16,36,10,10,16,37,53,-16,40,18,7,7,4,22,21,1,28,18,3,3,12,15,32,-17,12,,,White Hart Lane,London
1997/98,36,7,Everton,17,36,9,12,15,40,51,-11,39,18,7,4,7,24,26,-2,25,18,2,8,8,16,25,-9,14,,,Goodison Park,Liverpool
1997/98,36,27,Bolton Wanderers,18,36,8,13,15,36,57,-21,37,18,6,8,4,20,20,0,26,18,2,5,11,16,37,-21,11,R,EN_D1,Macron Stadium,Bolton
1997/98,36,30,Barnsley,19,36,10,5,21,37,79,-42,35,18,7,4,7,25,33,-8,25,18,3,1,14,12,46,-34,10,R,EN_D1,Oakwell,Barnsley
1997/98,36,6,Crystal Palace,20,35,7,8,20,31,63,-32,29,17,1,4,12,11,36,-25,7,18,6,4,8,20,27,-7,22,"R,Q","EN_D1,EU_IT",Selhurst Park,London
1997/98,37,1,Arsenal,1,37,23,9,5,68,32,36,78,19,15,2,2,43,10,33,47,18,8,7,3,25,22,3,31,Q,EU_CL,Highbury,London
1997/98,37,12,Manchester United,2,37,22,8,7,71,26,45,74,19,13,4,2,42,9,33,43,18,9,4,5,29,17,12,31,Q,EU_CL,Old Trafford,Manchester
1997/98,37,10,Liverpool,3,37,18,11,8,68,41,27,65,19,13,2,4,42,16,26,41,18,5,9,4,26,25,1,24,Q,EU_UC,Anfield,Liverpool
1997/98,37,4,Chelsea,4,37,19,3,15,69,43,26,60,18,12,2,4,35,14,21,38,19,7,1,11,34,29,5,22,Q,EU_CWC,Stamford Bridge,London
1997/98,37,9,Leeds United,5,37,17,7,13,56,45,11,58,18,9,4,5,30,20,10,31,19,8,3,8,26,25,1,27,Q,EU_UC,Elland Road,Leeds
1997/98,37,3,Blackburn Rovers,6,37,15,10,12,56,52,4,55,18,10,4,4,39,26,13,34,19,5,6,8,17,26,-9,21,Q,EU_UC,Ewood Park,Blackburn
1997/98,37,2,Aston Villa,7,37,16,6,15,48,48,0,54,18,8,3,7,25,24,1,27,19,8,3,8,23,24,-1,27,Q,EU_UC,Villa Park,Birmingham
1997/98,37,26,Leicester City,8,37,13,14,10,48,37,11,53,19,6,10,3,21,15,6,28,18,7,4,7,27,22,5,25,,,Filbert Street,Leicester
1997/98,37,25,West Ham United,9,37,15,8,14,52,54,-2,53,18,12,4,2,36,15,21,40,19,3,4,12,16,39,-23,13,,,Boleyn Ground,London
1997/98,37,28,Derby County,10,37,15,7,15,51,49,2,52,18,11,3,4,32,18,14,36,19,4,4,11,19,31,-12,16,,,Pride Park,Derby
1997/98,37,5,Coventry City,11,37,12,15,10,45,43,2,51,19,8,9,2,26,17,9,33,18,4,6,8,19,26,-7,18,,,Highfield Road,Coventry
1997/98,37,20,Southampton,12,37,14,5,18,49,54,-5,47,19,10,1,8,28,23,5,31,18,4,4,10,21,31,-10,16,,,The Dell,Southampton
1997/98,37,23,Newcastle United,13,37,11,11,15,35,43,-8,44,19,8,5,6,22,20,2,29,18,3,6,9,13,23,-10,15,Q,EU_CWC,St. James' Park,Newcastle
1997/98,37,19,Sheffield Wednesday,14,37,12,8,17,52,66,-14,44,19,9,5,5,30,26,4,32,18,3,3,12,22,40,-18,12,,,Hillsborough,Sheffield
1997/98,37,21,Tottenham Hotspur,15,37,11,10,16,43,55,-12,43,18,7,7,4,22,21,1,28,19,4,3,12,21,34,-13,15,,,White Hart Lane,London
1997/98,37,22,Wimbledon,16,37,10,13,14,33,45,-12,43,19,5,6,8,18,25,-7,21,18,5,7,6,15,20,-5,22,,,Selhurst Park,London
1997/98,37,27,Bolton Wanderers,17,37,9,13,15,41,59,-18,40,19,7,8,4,25,22,3,29,18,2,5,11,16,37,-21,11,,,Macron Stadium,Bolton
1997/98,37,7,Everton,18,37,9,12,16,40,55,-15,39,18,7,4,7,24,26,-2,25,19,2,8,9,16,29,-13,14,R,EN_D1,Goodison Park,Liverpool
1997/98,37,30,Barnsley,19,37,10,5,22,37,80,-43,35,18,7,4,7,25,33,-8,25,19,3,1,15,12,47,-35,10,R,EN_D1,Oakwell,Barnsley
1997/98,37,6,Crystal Palace,20,37,7,9,21,36,71,-35,30,18,1,5,12,14,39,-25,8,19,6,4,9,22,32,-10,22,"R,Q","EN_D1,EU_IT",Selhurst Park,London
1997/98,38,1,Arsenal,1,38,23,9,6,68,33,35,78,19,15,2,2,43,10,33,47,19,8,7,4,25,23,2,31,Q,EU_CL,Highbury,London
1997/98,38,12,Manchester United,2,38,23,8,7,73,26,47,77,19,13,4,2,42,9,33,43,19,10,4,5,31,17,14,34,Q,EU_CL,Old Trafford,Manchester
1997/98,38,10,Liverpool,3,38,18,11,9,68,42,26,65,19,13,2,4,42,16,26,41,19,5,9,5,26,26,0,24,Q,EU_UC,Anfield,Liverpool
1997/98,38,4,Chelsea,4,38,20,3,15,71,43,28,63,19,13,2,4,37,14,23,41,19,7,1,11,34,29,5,22,Q,EU_CWC,Stamford Bridge,London
1997/98,38,9,Leeds United,5,38,17,8,13,57,46,11,59,19,9,5,5,31,21,10,32,19,8,3,8,26,25,1,27,Q,EU_UC,Elland Road,Leeds
1997/98,38,3,Blackburn Rovers,6,38,16,10,12,57,52,5,58,19,11,4,4,40,26,14,37,19,5,6,8,17,26,-9,21,Q,EU_UC,Ewood Park,Blackburn
1997/98,38,2,Aston Villa,7,38,17,6,15,49,48,1,57,19,9,3,7,26,24,2,30,19,8,3,8,23,24,-1,27,Q,EU_UC,Villa Park,Birmingham
1997/98,38,25,West Ham United,8,38,16,8,14,56,57,-1,56,19,13,4,2,40,18,22,43,19,3,4,12,16,39,-23,13,,,Boleyn Ground,London
1997/98,38,28,Derby County,9,38,16,7,15,52,49,3,55,19,12,3,4,33,18,15,39,19,4,4,11,19,31,-12,16,,,Pride Park,Derby
1997/98,38,26,Leicester City,10,38,13,14,11,51,41,10,53,19,6,10,3,21,15,6,28,19,7,4,8,30,26,4,25,,,Filbert Street,Leicester
1997/98,38,5,Coventry City,11,38,12,16,10,46,44,2,52,19,8,9,2,26,17,9,33,19,4,7,8,20,27,-7,19,,,Highfield Road,Coventry
1997/98,38,20,Southampton,12,38,14,6,18,50,55,-5,48,19,10,1,8,28,23,5,31,19,4,5,10,22,32,-10,17,,,The Dell,Southampton
1997/98,38,23,Newcastle United,13,38,11,11,16,35,44,-9,44,19,8,5,6,22,20,2,29,19,3,6,10,13,24,-11,15,Q,EU_CWC,St. James' Park,Newcastle
1997/98,38,21,Tottenham Hotspur,14,38,11,11,16,44,56,-12,44,19,7,8,4,23,22,1,29,19,4,3,12,21,34,-13,15,,,White Hart Lane,London
1997/98,38,22,Wimbledon,15,38,10,14,14,34,46,-12,44,19,5,6,8,18,25,-7,21,19,5,8,6,16,21,-5,23,,,Selhurst Park,London
1997/98,38,19,Sheffield Wednesday,16,38,12,8,18,52,67,-15,44,19,9,5,5,30,26,4,32,19,3,3,13,22,41,-19,12,,,Hillsborough,Sheffield
1997/98,38,7,Everton,17,38,9,13,16,41,56,-15,40,19,7,5,7,25,27,-2,26,19,2,8,9,16,29,-13,14,,,Goodison Park,Liverpool
1997/98,38,27,Bolton Wanderers,18,38,9,13,16,41,61,-20,40,19,7,8,4,25,22,3,29,19,2,5,12,16,39,-23,11,R,EN_D1,Macron Stadium,Bolton
1997/98,38,30,Barnsley,19,38,10,5,23,37,82,-45,35,19,7,4,8,25,35,-10,25,19,3,1,15,12,47,-35,10,R,EN_D1,Oakwell,Barnsley
1997/98,38,6,Crystal Palace,20,38,8,9,21,37,71,-34,33,19,2,5,12,15,39,-24,11,19,6,4,9,22,32,-10,22,"R,Q","EN_D1,EU_IT",Selhurst Park,London
