season,match_week,team_id,team_name,position,played,won,drawn,lost,goals_for,goals_against,goal_difference,points,home_played,home_won,home_drawn,home_lost,home_goals_for,home_goals_against,home_goal_difference,home_points,away_played,away_won,away_drawn,away_lost,away_goals_for,away_goals_against,away_goal_difference,away_points,annotation_types,annotation_destinations,stadium_name,stadium_city
1999/00,1,2,Aston Villa,1,2,2,0,0,4,0,4,6,1,1,0,0,3,0,3,3,1,1,0,0,1,0,1,3,"Q,Q","EU_CL,EU_IT",Villa Park,Birmingham
1999/00,1,1,Arsenal,2,2,2,0,0,4,2,2,6,1,1,0,0,2,1,1,3,1,1,0,0,2,1,1,3,Q,EU_CL,Highbury,London
1999/00,1,12,Manchester United,3,2,1,1,0,5,1,4,4,1,1,0,0,4,0,4,3,1,0,1,0,1,1,0,1,Q,EU_CL,Old Trafford,Manchester
1999/00,1,9,Leeds United,4,2,1,1,0,3,0,3,4,1,0,1,0,0,0,0,1,1,1,0,0,3,0,3,3,Q,EU_UC,Elland Road,Leeds
1999/00,1,4,Chelsea,5,1,1,0,0,4,0,4,3,1,1,0,0,4,0,4,3,0,0,0,0,0,0,0,0,Q,EU_UC,Stamford Bridge,London
1999/00,1,21,Tottenham Hotspur,6,2,1,0,1,3,2,1,3,1,1,0,0,3,1,2,3,1,0,0,1,0,1,-1,0,,,White Hart Lane,London
1999/00,1,10,Liverpool,7,1,1,0,0,2,1,1,3,0,0,0,0,0,0,0,0,1,1,0,0,2,1,1,3,,,Anfield,Liverpool
1999/00,1,32,Bradford City,8,1,1,0,0,1,0,1,3,0,0,0,0,0,0,0,0,1,1,0,0,1,0,1,3,Q,EU_IT,Valley Parade,Bradford
1999/00,1,25,West Ham United,9,1,1,0,0,1,0,1,3,1,1,0,0,1,0,1,3,0,0,0,0,0,0,0,0,,,Boleyn Ground,London
1999/00,1,22,Wimbledon,10,2,1,0,1,5,5,0,3,1,0,0,1,2,3,-1,0,1,1,0,0,3,2,1,3,,,Selhurst Park,London
1999/00,1,13,Middlesbrough,11,2,1,0,1,3,3,0,3,1,0,0,1,0,1,-1,0,1,1,0,0,3,2,1,3,,,Riverside Stadium,Middlesbrough
1999/00,1,26,Leicester City,12,2,1,0,1,2,2,0,3,1,1,0,0,1,0,1,3,1,0,0,1,1,2,-1,0,Q,EU_UC,Filbert Street,Leicester
1999/00,1,29,Sunderland,13,2,1,0,1,2,4,-2,3,1,1,0,0,2,0,2,3,1,0,0,1,0,4,-4,0,,,Stadium of Light,Sunderland
1999/00,1,20,Southampton,14,2,1,0,1,1,3,-2,3,1,0,0,1,0,3,-3,0,1,1,0,0,1,0,1,3,,,The Dell,Southampton
1999/00,1,28,Derby County,15,2,0,1,1,1,2,-1,1,1,0,0,1,1,2,-1,0,1,0,1,0,0,0,0,1,,,Pride Park,Derby
1999/00,1,7,Everton,16,2,0,1,1,1,4,-3,1,1,0,1,0,1,1,0,1,1,0,0,1,0,3,-3,0,,,Goodison Park,Liverpool
1999/00,1,5,Coventry City,17,2,0,0,2,0,2,-2,0,1,0,0,1,0,1,-1,0,1,0,0,1,0,1,-1,0,,,Highfield Road,Coventry
1999/00,1,33,Watford,18,2,0,0,2,2,5,-3,0,1,0,0,1,2,3,-1,0,1,0,0,1,0,2,-2,0,R,EN_D1,Vicarage Road,Watford
1999/00,1,23,Newcastle United,19,2,0,0,2,1,4,-3,0,1,0,0,1,0,1,-1,0,1,0,0,1,1,3,-2,0,R,EN_D1,St. James' Park,Newcastle
1999/00,1,19,Sheffield Wednesday,20,2,0,0,2,1,6,-5,0,1,0,0,1,1,2,-1,0,1,0,0,1,0,4,-4,0,R,EN_D1,Hillsborough,Sheffield
1999/00,2,12,Manchester United,1,3,2,1,0,7,1,6,7,2,2,0,0,6,0,6,6,1,0,1,0,1,1,0,1,Q,EU_CL,Old Trafford,Manchester
1999/00,2,2,Aston Villa,2,3,2,1,0,6,2,4,7,2,1,1,0,5,2,3,4,1,1,0,0,1,0,1,3,"Q,Q","EU_CL,EU_IT",Villa Park,Birmingham
1999/00,2,1,Arsenal,3,3,2,1,0,4,2,2,7,1,1,0,0,2,1,1,3,2,1,1,0,2,1,1,4,Q,EU_CL,Highbury,London
1999/00,2,13,Middlesbrough,4,3,2,0,1,6,4,2,6,1,0,0,1,0,1,-1,0,2,2,0,0,6,3,3,6,Q,EU_UC,Riverside Stadium,Middlesbrough
1999/00,2,21,Tottenham Hotspur,5,3,2,0,1,6,4,2,6,2,2,0,0,6,3,3,6,1,0,0,1,0,1,-1,0,Q,EU_UC,White Hart Lane,London
1999/00,2,20,Southampton,6,3,2,0,1,5,5,0,6,2,1,0,1,4,5,-1,3,1,1,0,0,1,0,1,3,,,The Dell,Southampton
1999/00,2,4,Chelsea,7,2,1,1,0,6,2,4,4,1,1,0,0,4,0,4,3,1,0,1,0,2,2,0,1,,,Stamford Bridge,London
1999/00,2,9,Leeds United,8,3,1,1,1,3,2,1,4,1,0,1,0,0,0,0,1,2,1,0,1,3,2,1,3,,,Elland Road,Leeds
1999/00,2,25,West Ham United,9,2,1,1,0,3,2,1,4,1,1,0,0,1,0,1,3,1,0,1,0,2,2,0,1,,,Boleyn Ground,London
1999/00,2,32,Bradford City,10,2,1,1,0,2,1,1,4,1,0,1,0,1,1,0,1,1,1,0,0,1,0,1,3,Q,EU_IT,Valley Parade,Bradford
1999/00,2,22,Wimbledon,11,3,1,1,1,6,6,0,4,2,0,1,1,3,4,-1,1,1,1,0,0,3,2,1,3,,,Selhurst Park,London
1999/00,2,26,Leicester City,12,3,1,1,1,4,4,0,4,2,1,1,0,3,2,1,4,1,0,0,1,1,2,-1,0,Q,EU_UC,Filbert Street,Leicester
1999/00,2,29,Sunderland,13,3,1,1,1,2,4,-2,4,2,1,1,0,2,0,2,4,1,0,0,1,0,4,-4,0,,,Stadium of Light,Sunderland
1999/00,2,10,Liverpool,14,2,1,0,1,2,2,0,3,1,0,0,1,0,1,-1,0,1,1,0,0,2,1,1,3,,,Anfield,Liverpool
1999/00,2,33,Watford,15,3,1,0,2,3,5,-2,3,1,0,0,1,2,3,-1,0,2,1,0,1,1,2,-1,3,,,Vicarage Road,Watford
1999/00,2,5,Coventry City,16,3,0,1,2,1,3,-2,1,1,0,0,1,0,1,-1,0,2,0,1,1,1,2,-1,1,,,Highfield Road,Coventry
1999/00,2,28,Derby County,17,3,0,1,2,2,5,-3,1,2,0,0,2,2,5,-3,0,1,0,1,0,0,0,0,1,,,Pride Park,Derby
1999/00,2,7,Everton,18,3,0,1,2,3,7,-4,1,1,0,1,0,1,1,0,1,2,0,0,2,2,6,-4,0,R,EN_D1,Goodison Park,Liverpool
1999/00,2,19,Sheffield Wednesday,19,3,0,1,2,2,7,-5,1,1,0,0,1,1,2,-1,0,2,0,1,1,1,5,-4,1,R,EN_D1,Hillsborough,Sheffield
1999/00,2,23,Newcastle United,20,3,0,0,3,3,8,-5,0,1,0,0,1,0,1,-1,0,2,0,0,2,3,7,-4,0,R,EN_D1,St. James' Park,Newcastle
1999/00,3,12,Manchester United,1,5,4,1,0,11,3,8,13,2,2,0,0,6,0,6,6,3,2,1,0,5,3,2,7,Q,EU_CL,Old Trafford,Manchester
1999/00,3,2,Aston Villa,2,5,3,1,1,7,3,4,10,2,1,1,0,5,2,3,4,3,2,0,1,2,1,1,6,"Q,Q","EU_CL,EU_IT",Villa Park,Birmingham
1999/00,3,1,Arsenal,3,5,3,1,1,7,4,3,10,3,2,0,1,5,3,2,6,2,1,1,0,2,1,1,4,Q,EU_CL,Highbury,London
1999/00,3,21,Tottenham Hotspur,4,4,3,0,1,8,5,3,9,2,2,0,0,6,3,3,6,2,1,0,1,2,2,0,3,Q,EU_UC,White Hart Lane,London
1999/00,3,13,Middlesbrough,5,5,3,0,2,7,7,0,9,3,1,0,2,1,4,-3,3,2,2,0,0,6,3,3,6,Q,EU_UC,Riverside Stadium,Middlesbrough
1999/00,3,4,Chelsea,6,3,2,1,0,7,2,5,7,2,2,0,0,5,0,5,6,1,0,1,0,2,2,0,1,,,Stamford Bridge,London
1999/00,3,7,Everton,7,5,2,1,2,11,8,3,7,3,2,1,0,9,2,7,7,2,0,0,2,2,6,-4,0,,,Goodison Park,Liverpool
1999/00,3,26,Leicester City,8,5,2,1,2,8,6,2,7,2,1,1,0,3,2,1,4,3,1,0,2,5,4,1,3,Q,EU_UC,Filbert Street,Leicester
1999/00,3,25,West Ham United,9,3,2,1,0,5,3,2,7,2,2,0,0,3,1,2,6,1,0,1,0,2,2,0,1,,,Boleyn Ground,London
1999/00,3,9,Leeds United,10,5,2,1,2,6,5,1,7,3,1,1,1,3,3,0,4,2,1,0,1,3,2,1,3,,,Elland Road,Leeds
1999/00,3,29,Sunderland,11,5,2,1,2,5,7,-2,7,2,1,1,0,2,0,2,4,3,1,0,2,3,7,-4,3,,,Stadium of Light,Sunderland
1999/00,3,10,Liverpool,12,4,2,0,2,4,4,0,6,1,0,0,1,0,1,-1,0,3,2,0,1,4,3,1,6,,,Anfield,Liverpool
1999/00,3,33,Watford,13,5,2,0,3,4,6,-2,6,3,1,0,2,3,4,-1,3,2,1,0,1,1,2,-1,3,,,Vicarage Road,Watford
1999/00,3,20,Southampton,14,4,2,0,2,6,9,-3,6,2,1,0,1,4,5,-1,3,2,1,0,1,2,4,-2,3,,,The Dell,Southampton
1999/00,3,22,Wimbledon,15,5,1,2,2,9,13,-4,5,2,0,1,1,3,4,-1,1,3,1,1,1,6,9,-3,4,,,Selhurst Park,London
1999/00,3,5,Coventry City,16,5,1,1,3,4,5,-1,4,3,1,0,2,3,3,0,3,2,0,1,1,1,2,-1,1,,,Highfield Road,Coventry
1999/00,3,32,Bradford City,17,4,1,1,2,2,4,-2,4,1,0,1,0,1,1,0,1,3,1,0,2,1,3,-2,3,Q,EU_IT,Valley Parade,Bradford
1999/00,3,28,Derby County,18,5,1,1,3,4,7,-3,4,2,0,0,2,2,5,-3,0,3,1,1,1,2,2,0,4,R,EN_D1,Pride Park,Derby
1999/00,3,23,Newcastle United,19,5,0,1,4,7,13,-6,1,3,0,1,2,4,6,-2,1,2,0,0,2,3,7,-4,0,R,EN_D1,St. James' Park,Newcastle
1999/00,3,19,Sheffield Wednesday,20,5,0,1,4,3,11,-8,1,3,0,0,3,2,6,-4,0,2,0,1,1,1,5,-4,1,R,EN_D1,Hillsborough,Sheffield
1999/00,4,12,Manchester United,1,6,5,1,0,16,4,12,16,3,3,0,0,11,1,10,9,3,2,1,0,5,3,2,7,Q,EU_CL,Old Trafford,Manchester
1999/00,4,2,Aston Villa,2,6,4,1,1,8,3,5,13,3,2,1,0,6,2,4,7,3,2,0,1,2,1,1,6,"Q,Q","EU_CL,EU_IT",Villa Park,Birmingham
1999/00,4,4,Chelsea,3,4,3,1,0,8,2,6,10,2,2,0,0,5,0,5,6,2,1,1,0,3,2,1,4,Q,EU_CL,Stamford Bridge,London
1999/00,4,25,West Ham United,4,4,3,1,0,8,3,5,10,2,2,0,0,3,1,2,6,2,1,1,0,5,2,3,4,Q,EU_UC,Boleyn Ground,London
1999/00,4,26,Leicester City,5,6,3,1,2,9,6,3,10,3,2,1,0,4,2,2,7,3,1,0,2,5,4,1,3,"Q,Q","EU_UC,EU_UC",Filbert Street,Leicester
1999/00,4,9,Leeds United,6,6,3,1,2,8,6,2,10,3,1,1,1,3,3,0,4,3,2,0,1,5,3,2,6,,,Elland Road,Leeds
1999/00,4,1,Arsenal,7,6,3,1,2,7,6,1,10,3,2,0,1,5,3,2,6,3,1,1,1,2,3,-1,4,,,Highbury,London
1999/00,4,21,Tottenham Hotspur,8,5,3,0,2,9,7,2,9,3,2,0,1,7,5,2,6,2,1,0,1,2,2,0,3,,,White Hart Lane,London
1999/00,4,10,Liverpool,9,5,3,0,2,6,4,2,9,2,1,0,1,2,1,1,3,3,2,0,1,4,3,1,6,,,Anfield,Liverpool
1999/00,4,20,Southampton,10,5,3,0,2,8,9,-1,9,3,2,0,1,6,5,1,6,2,1,0,1,2,4,-2,3,,,The Dell,Southampton
1999/00,4,13,Middlesbrough,11,6,3,0,3,7,8,-1,9,3,1,0,2,1,4,-3,3,3,2,0,1,6,4,2,6,,,Riverside Stadium,Middlesbrough
1999/00,4,29,Sunderland,12,6,2,2,2,6,8,-2,8,3,1,2,0,3,1,2,5,3,1,0,2,3,7,-4,3,,,Stadium of Light,Sunderland
1999/00,4,7,Everton,13,6,2,1,3,11,9,2,7,3,2,1,0,9,2,7,7,3,0,0,3,2,7,-5,0,,,Goodison Park,Liverpool
1999/00,4,28,Derby County,14,6,2,1,3,5,7,-2,7,3,1,0,2,3,5,-2,3,3,1,1,1,2,2,0,4,,,Pride Park,Derby
1999/00,4,33,Watford,15,6,2,0,4,4,7,-3,6,3,1,0,2,3,4,-1,3,3,1,0,2,1,3,-2,3,,,Vicarage Road,Watford
1999/00,4,5,Coventry City,16,6,1,2,3,5,6,-1,5,3,1,0,2,3,3,0,3,3,0,2,1,2,3,-1,2,,,Highfield Road,Coventry
1999/00,4,22,Wimbledon,17,6,1,2,3,9,14,-5,5,3,0,1,2,3,5,-2,1,3,1,1,1,6,9,-3,4,,,Selhurst Park,London
1999/00,4,32,Bradford City,18,5,1,1,3,2,7,-5,4,2,0,1,1,1,4,-3,1,3,1,0,2,1,3,-2,3,"R,Q","EN_D1,EU_IT",Valley Parade,Bradford
1999/00,4,23,Newcastle United,19,6,0,1,5,8,18,-10,1,3,0,1,2,4,6,-2,1,3,0,0,3,4,12,-8,0,R,EN_D1,St. James' Park,Newcastle
1999/00,4,19,Sheffield Wednesday,20,6,0,1,5,3,13,-10,1,3,0,0,3,2,6,-4,0,3,0,1,2,1,7,-6,1,R,EN_D1,Hillsborough,Sheffield
1999/00,5,12,Manchester United,1,7,6,1,0,19,6,13,19,3,3,0,0,11,1,10,9,4,3,1,0,8,5,3,10,Q,EU_CL,Old Trafford,Manchester
1999/00,5,4,Chelsea,2,5,4,1,0,9,2,7,13,3,3,0,0,6,0,6,9,2,1,1,0,3,2,1,4,Q,EU_CL,Stamford Bridge,London
1999/00,5,25,West Ham United,3,5,4,1,0,9,3,6,13,3,3,0,0,4,1,3,9,2,1,1,0,5,2,3,4,Q,EU_CL,Boleyn Ground,London
1999/00,5,9,Leeds United,4,7,4,1,2,12,9,3,13,3,1,1,1,3,3,0,4,4,3,0,1,9,6,3,9,Q,EU_UC,Elland Road,Leeds
1999/00,5,1,Arsenal,5,7,4,1,2,10,7,3,13,4,3,0,1,8,4,4,9,3,1,1,1,2,3,-1,4,Q,EU_UC,Highbury,London
1999/00,5,2,Aston Villa,6,7,4,1,2,9,6,3,13,3,2,1,0,6,2,4,7,4,2,0,2,3,4,-1,6,Q,EU_IT,Villa Park,Birmingham
1999/00,5,13,Middlesbrough,7,7,4,0,3,10,10,0,12,4,2,0,2,4,6,-2,6,3,2,0,1,6,4,2,6,,,Riverside Stadium,Middlesbrough
1999/00,5,29,Sunderland,8,7,3,2,2,8,8,0,11,4,2,2,0,5,1,4,8,3,1,0,2,3,7,-4,3,,,Stadium of Light,Sunderland
1999/00,5,7,Everton,9,7,3,1,3,13,9,4,10,3,2,1,0,9,2,7,7,4,1,0,3,4,7,-3,3,,,Goodison Park,Liverpool
1999/00,5,21,Tottenham Hotspur,10,6,3,1,2,10,8,2,10,3,2,0,1,7,5,2,6,3,1,1,1,3,3,0,4,,,White Hart Lane,London
1999/00,5,26,Leicester City,11,7,3,1,3,9,8,1,10,3,2,1,0,4,2,2,7,4,1,0,3,5,6,-1,3,Q,EU_UC,Filbert Street,Leicester
1999/00,5,10,Liverpool,12,6,3,0,3,8,7,1,9,3,1,0,2,4,4,0,3,3,2,0,1,4,3,1,6,,,Anfield,Liverpool
1999/00,5,20,Southampton,13,6,3,0,3,10,12,-2,9,3,2,0,1,6,5,1,6,3,1,0,2,4,7,-3,3,,,The Dell,Southampton
1999/00,5,28,Derby County,14,7,2,2,3,7,9,-2,8,3,1,0,2,3,5,-2,3,4,1,2,1,4,4,0,5,,,Pride Park,Derby
1999/00,5,33,Watford,15,7,2,0,5,4,8,-4,6,3,1,0,2,3,4,-1,3,4,1,0,3,1,4,-3,3,,,Vicarage Road,Watford
1999/00,5,22,Wimbledon,16,7,1,3,3,11,16,-5,6,4,0,2,2,5,7,-2,2,3,1,1,1,6,9,-3,4,,,Selhurst Park,London
1999/00,5,5,Coventry City,17,7,1,2,4,8,10,-2,5,4,1,0,3,6,7,-1,3,3,0,2,1,2,3,-1,2,,,Highfield Road,Coventry
1999/00,5,32,Bradford City,18,6,1,2,3,3,8,-5,5,3,0,2,1,2,5,-3,2,3,1,0,2,1,3,-2,3,"R,Q","EN_D1,EU_IT",Valley Parade,Bradford
1999/00,5,23,Newcastle United,19,7,0,1,6,8,19,-11,1,3,0,1,2,4,6,-2,1,4,0,0,4,4,13,-9,0,R,EN_D1,St. James' Park,Newcastle
1999/00,5,19,Sheffield Wednesday,20,7,0,1,6,3,15,-12,1,4,0,0,4,2,8,-6,0,3,0,1,2,1,7,-6,1,R,EN_D1,Hillsborough,Sheffield
1999/00,6,12,Manchester United,1,8,6,2,0,20,7,13,20,4,3,1,0,12,2,10,10,4,3,1,0,8,5,3,10,Q,EU_CL,Old Trafford,Manchester
1999/00,6,9,Leeds United,2,8,5,1,2,14,9,5,16,4,2,1,1,5,3,2,7,4,3,0,1,9,6,3,9,Q,EU_CL,Elland Road,Leeds
1999/00,6,1,Arsenal,3,8,5,1,2,11,7,4,16,4,3,0,1,8,4,4,9,4,2,1,1,3,3,0,7,Q,EU_CL,Highbury,London
1999/00,6,2,Aston Villa,4,8,5,1,2,10,6,4,16,4,3,1,0,7,2,5,10,4,2,0,2,3,4,-1,6,"Q,Q","EU_UC,EU_IT",Villa Park,Birmingham
1999/00,6,29,Sunderland,5,8,4,2,2,13,8,5,14,4,2,2,0,5,1,4,8,4,2,0,2,8,7,1,6,Q,EU_UC,Stadium of Light,Sunderland
1999/00,6,4,Chelsea,6,6,4,1,1,9,3,6,13,3,3,0,0,6,0,6,9,3,1,1,1,3,3,0,4,,,Stamford Bridge,London
1999/00,6,7,Everton,7,8,4,1,3,14,9,5,13,4,3,1,0,10,2,8,10,4,1,0,3,4,7,-3,3,,,Goodison Park,Liverpool
1999/00,6,25,West Ham United,8,6,4,1,1,9,4,5,13,3,3,0,0,4,1,3,9,3,1,1,1,5,3,2,4,,,Boleyn Ground,London
1999/00,6,21,Tottenham Hotspur,9,7,4,1,2,13,10,3,13,4,3,0,1,10,7,3,9,3,1,1,1,3,3,0,4,,,White Hart Lane,London
1999/00,6,13,Middlesbrough,10,8,4,0,4,10,12,-2,12,4,2,0,2,4,6,-2,6,4,2,0,2,6,6,0,6,,,Riverside Stadium,Middlesbrough
1999/00,6,26,Leicester City,11,8,3,2,3,11,10,1,11,4,2,2,0,6,4,2,8,4,1,0,3,5,6,-1,3,Q,EU_UC,Filbert Street,Leicester
1999/00,6,10,Liverpool,12,7,3,1,3,10,9,1,10,3,1,0,2,4,4,0,3,4,2,1,1,6,5,1,7,,,Anfield,Liverpool
1999/00,6,20,Southampton,13,7,3,0,4,10,13,-3,9,4,2,0,2,6,6,0,6,3,1,0,2,4,7,-3,3,,,The Dell,Southampton
1999/00,6,33,Watford,14,8,3,0,5,5,8,-3,9,4,2,0,2,4,4,0,6,4,1,0,3,1,4,-3,3,,,Vicarage Road,Watford
1999/00,6,28,Derby County,15,8,2,2,4,7,14,-7,8,4,1,0,3,3,10,-7,3,4,1,2,1,4,4,0,5,,,Pride Park,Derby
1999/00,6,22,Wimbledon,16,8,1,4,3,12,17,-5,7,4,0,2,2,5,7,-2,2,4,1,2,1,7,10,-3,5,,,Selhurst Park,London
1999/00,6,5,Coventry City,17,8,1,2,5,10,13,-3,5,4,1,0,3,6,7,-1,3,4,0,2,2,4,6,-2,2,,,Highfield Road,Coventry
1999/00,6,32,Bradford City,18,7,1,2,4,3,9,-6,5,3,0,2,1,2,5,-3,2,4,1,0,3,1,4,-3,3,"R,Q","EN_D1,EU_IT",Valley Parade,Bradford
1999/00,6,23,Newcastle United,19,8,1,1,6,16,19,-3,4,4,1,1,2,12,6,6,4,4,0,0,4,4,13,-9,0,R,EN_D1,St. James' Park,Newcastle
1999/00,6,19,Sheffield Wednesday,20,8,0,1,7,3,23,-20,1,4,0,0,4,2,8,-6,0,4,0,1,3,1,15,-14,1,R,EN_D1,Hillsborough,Sheffield
1999/00,7,12,Manchester United,1,9,6,3,0,23,10,13,21,5,3,2,0,15,5,10,11,4,3,1,0,8,5,3,10,Q,EU_CL,Old Trafford,Manchester
1999/00,7,9,Leeds United,2,9,6,1,2,17,11,6,19,5,3,1,1,8,5,3,10,4,3,0,1,9,6,3,9,Q,EU_CL,Elland Road,Leeds
1999/00,7,1,Arsenal,3,9,6,1,2,12,7,5,19,5,4,0,1,9,4,5,12,4,2,1,1,3,3,0,7,Q,EU_CL,Highbury,London
1999/00,7,29,Sunderland,4,9,5,2,2,14,8,6,17,5,3,2,0,6,1,5,11,4,2,0,2,8,7,1,6,Q,EU_UC,Stadium of Light,Sunderland
1999/00,7,4,Chelsea,5,7,5,1,1,10,3,7,16,3,3,0,0,6,0,6,9,4,2,1,1,4,3,1,7,Q,EU_UC,Stamford Bridge,London
1999/00,7,7,Everton,6,9,5,1,3,15,9,6,16,4,3,1,0,10,2,8,10,5,2,0,3,5,7,-2,6,,,Goodison Park,Liverpool
1999/00,7,2,Aston Villa,7,9,5,1,3,11,9,2,16,4,3,1,0,7,2,5,10,5,2,0,3,4,7,-3,6,Q,EU_IT,Villa Park,Birmingham
1999/00,7,26,Leicester City,8,9,4,2,3,14,11,3,14,5,3,2,0,9,5,4,11,4,1,0,3,5,6,-1,3,Q,EU_UC,Filbert Street,Leicester
1999/00,7,21,Tottenham Hotspur,9,8,4,2,2,14,11,3,14,4,3,0,1,10,7,3,9,4,1,2,1,4,4,0,5,,,White Hart Lane,London
1999/00,7,25,West Ham United,10,7,4,1,2,9,5,4,13,3,3,0,0,4,1,3,9,4,1,1,2,5,4,1,4,,,Boleyn Ground,London
1999/00,7,13,Middlesbrough,11,9,4,0,5,10,13,-3,12,5,2,0,3,4,7,-3,6,4,2,0,2,6,6,0,6,,,Riverside Stadium,Middlesbrough
1999/00,7,10,Liverpool,12,8,3,1,4,10,10,0,10,4,1,0,3,4,5,-1,3,4,2,1,1,6,5,1,7,,,Anfield,Liverpool
1999/00,7,20,Southampton,13,8,3,1,4,13,16,-3,10,4,2,0,2,6,6,0,6,4,1,1,2,7,10,-3,4,,,The Dell,Southampton
1999/00,7,33,Watford,14,9,3,0,6,5,9,-4,9,4,2,0,2,4,4,0,6,5,1,0,4,1,5,-4,3,,,Vicarage Road,Watford
1999/00,7,5,Coventry City,15,9,2,2,5,11,13,-2,8,5,2,0,3,7,7,0,6,4,0,2,2,4,6,-2,2,,,Highfield Road,Coventry
1999/00,7,22,Wimbledon,16,9,1,5,3,13,18,-5,8,5,0,3,2,6,8,-2,3,4,1,2,1,7,10,-3,5,,,Selhurst Park,London
1999/00,7,32,Bradford City,17,8,2,2,4,4,9,-5,8,3,0,2,1,2,5,-3,2,5,2,0,3,2,4,-2,6,Q,EU_IT,Valley Parade,Bradford
1999/00,7,28,Derby County,18,9,2,2,5,7,15,-8,8,5,1,0,4,3,11,-8,3,4,1,2,1,4,4,0,5,R,EN_D1,Pride Park,Derby
1999/00,7,23,Newcastle United,19,9,1,1,7,18,22,-4,4,4,1,1,2,12,6,6,4,5,0,0,5,6,16,-10,0,R,EN_D1,St. James' Park,Newcastle
1999/00,7,19,Sheffield Wednesday,20,9,0,1,8,3,24,-21,1,4,0,0,4,2,8,-6,0,5,0,1,4,1,16,-15,1,R,EN_D1,Hillsborough,Sheffield
1999/00,8,9,Leeds United,1,10,7,1,2,19,12,7,22,5,3,1,1,8,5,3,10,5,4,0,1,11,7,4,12,Q,EU_CL,Elland Road,Leeds
1999/00,8,12,Manchester United,2,10,6,3,1,23,15,8,21,5,3,2,0,15,5,10,11,5,3,1,1,8,10,-2,10,Q,EU_CL,Old Trafford,Manchester
1999/00,8,29,Sunderland,3,10,6,2,2,18,8,10,20,5,3,2,0,6,1,5,11,5,3,0,2,12,7,5,9,Q,EU_CL,Stadium of Light,Sunderland
1999/00,8,4,Chelsea,4,8,6,1,1,15,3,12,19,4,4,0,0,11,0,11,12,4,2,1,1,4,3,1,7,Q,EU_UC,Stamford Bridge,London
1999/00,8,1,Arsenal,5,10,6,1,3,13,9,4,19,5,4,0,1,9,4,5,12,5,2,1,2,4,5,-1,7,Q,EU_UC,Highbury,London
1999/00,8,7,Everton,6,10,5,2,3,16,10,6,17,5,3,2,0,11,3,8,11,5,2,0,3,5,7,-2,6,,,Goodison Park,Liverpool
1999/00,8,26,Leicester City,7,10,5,2,3,17,13,4,17,5,3,2,0,9,5,4,11,5,2,0,3,8,8,0,6,Q,EU_UC,Filbert Street,Leicester
1999/00,8,2,Aston Villa,8,10,5,2,3,11,9,2,17,5,3,2,0,7,2,5,11,5,2,0,3,4,7,-3,6,Q,EU_IT,Villa Park,Birmingham
1999/00,8,25,West Ham United,9,8,5,1,2,11,6,5,16,4,4,0,0,6,2,4,12,4,1,1,2,5,4,1,4,,,Boleyn Ground,London
1999/00,8,21,Tottenham Hotspur,10,9,4,2,3,16,14,2,14,5,3,0,2,12,10,2,9,4,1,2,1,4,4,0,5,,,White Hart Lane,London
1999/00,8,13,Middlesbrough,11,10,4,0,6,11,15,-4,12,5,2,0,3,4,7,-3,6,5,2,0,3,7,8,-1,6,,,Riverside Stadium,Middlesbrough
1999/00,8,10,Liverpool,12,9,3,2,4,10,10,0,11,4,1,0,3,4,5,-1,3,5,2,2,1,6,5,1,8,,,Anfield,Liverpool
1999/00,8,20,Southampton,13,9,3,2,4,16,19,-3,11,5,2,1,2,9,9,0,7,4,1,1,2,7,10,-3,4,,,The Dell,Southampton
1999/00,8,5,Coventry City,14,10,2,3,5,12,14,-2,9,5,2,0,3,7,7,0,6,5,0,3,2,5,7,-2,3,,,Highfield Road,Coventry
1999/00,8,33,Watford,15,10,3,0,7,6,11,-5,9,5,2,0,3,5,6,-1,6,5,1,0,4,1,5,-4,3,,,Vicarage Road,Watford
1999/00,8,28,Derby County,16,10,2,3,5,10,18,-8,9,5,1,0,4,3,11,-8,3,5,1,3,1,7,7,0,6,,,Pride Park,Derby
1999/00,8,22,Wimbledon,17,10,1,5,4,14,23,-9,8,5,0,3,2,6,8,-2,3,5,1,2,2,8,15,-7,5,,,Selhurst Park,London
1999/00,8,32,Bradford City,18,9,2,2,5,4,13,-9,8,4,0,2,2,2,9,-7,2,5,2,0,3,2,4,-2,6,"R,Q","EN_D1,EU_IT",Valley Parade,Bradford
1999/00,8,23,Newcastle United,19,10,2,1,7,20,23,-3,7,5,2,1,2,14,7,7,7,5,0,0,5,6,16,-10,0,R,EN_D1,St. James' Park,Newcastle
1999/00,8,19,Sheffield Wednesday,20,10,1,1,8,8,25,-17,4,5,1,0,4,7,9,-2,3,5,0,1,4,1,16,-15,1,R,EN_D1,Hillsborough,Sheffield
1999/00,9,9,Leeds United,1,11,8,1,2,21,12,9,25,6,4,1,1,10,5,5,13,5,4,0,1,11,7,4,12,Q,EU_CL,Elland Road,Leeds
1999/00,9,12,Manchester United,2,11,7,3,1,27,16,11,24,6,4,2,0,19,6,13,14,5,3,1,1,8,10,-2,10,Q,EU_CL,Old Trafford,Manchester
1999/00,9,29,Sunderland,3,11,7,2,2,20,9,11,23,6,4,2,0,8,2,6,14,5,3,0,2,12,7,5,9,Q,EU_CL,Stadium of Light,Sunderland
1999/00,9,1,Arsenal,4,11,7,1,3,17,10,7,22,6,5,0,1,13,5,8,15,5,2,1,2,4,5,-1,7,Q,EU_UC,Highbury,London
1999/00,9,26,Leicester City,5,11,6,2,3,19,14,5,20,6,4,2,0,11,6,5,14,5,2,0,3,8,8,0,6,"Q,Q","EU_UC,EU_UC",Filbert Street,Leicester
1999/00,9,4,Chelsea,6,9,6,1,2,15,4,11,19,4,4,0,0,11,0,11,12,5,2,1,2,4,4,0,7,,,Stamford Bridge,London
1999/00,9,7,Everton,7,11,5,2,4,17,14,3,17,5,3,2,0,11,3,8,11,6,2,0,4,6,11,-5,6,,,Goodison Park,Liverpool
1999/00,9,21,Tottenham Hotspur,8,10,5,2,3,17,14,3,17,5,3,0,2,12,10,2,9,5,2,2,1,5,4,1,8,,,White Hart Lane,London
1999/00,9,2,Aston Villa,9,11,5,2,4,12,11,1,17,5,3,2,0,7,2,5,11,6,2,0,4,5,9,-4,6,Q,EU_IT,Villa Park,Birmingham
1999/00,9,25,West Ham United,10,9,5,1,3,11,8,3,16,4,4,0,0,6,2,4,12,5,1,1,3,5,6,-1,4,,,Boleyn Ground,London
1999/00,9,13,Middlesbrough,11,11,5,0,6,13,15,-2,15,6,3,0,3,6,7,-1,9,5,2,0,3,7,8,-1,6,,,Riverside Stadium,Middlesbrough
1999/00,9,10,Liverpool,12,10,4,2,4,11,10,1,14,5,2,0,3,5,5,0,6,5,2,2,1,6,5,1,8,,,Anfield,Liverpool
1999/00,9,5,Coventry City,13,11,3,3,5,16,15,1,12,6,3,0,3,11,8,3,9,5,0,3,2,5,7,-2,3,,,Highfield Road,Coventry
1999/00,9,20,Southampton,14,10,3,2,5,17,21,-4,11,5,2,1,2,9,9,0,7,5,1,1,3,8,12,-4,4,,,The Dell,Southampton
1999/00,9,22,Wimbledon,15,11,2,5,4,17,25,-8,11,6,1,3,2,9,10,-1,6,5,1,2,2,8,15,-7,5,,,Selhurst Park,London
1999/00,9,33,Watford,16,11,3,0,8,7,15,-8,9,5,2,0,3,5,6,-1,6,6,1,0,5,2,9,-7,3,,,Vicarage Road,Watford
1999/00,9,28,Derby County,17,11,2,3,6,10,19,-9,9,6,1,0,5,3,12,-9,3,5,1,3,1,7,7,0,6,,,Pride Park,Derby
1999/00,9,32,Bradford City,18,10,2,2,6,6,16,-10,8,4,0,2,2,2,9,-7,2,6,2,0,4,4,7,-3,6,"R,Q","EN_D1,EU_IT",Valley Parade,Bradford
1999/00,9,23,Newcastle United,19,11,2,1,8,21,27,-6,7,5,2,1,2,14,7,7,7,6,0,0,6,7,20,-13,0,R,EN_D1,St. James' Park,Newcastle
1999/00,9,19,Sheffield Wednesday,20,11,1,1,9,8,27,-19,4,5,1,0,4,7,9,-2,3,6,0,1,5,1,18,-17,1,R,EN_D1,Hillsborough,Sheffield
1999/00,10,9,Leeds United,1,12,8,2,2,25,16,9,26,6,4,1,1,10,5,5,13,6,4,1,1,15,11,4,13,Q,EU_CL,Elland Road,Leeds
1999/00,10,1,Arsenal,2,12,8,1,3,20,12,8,25,6,5,0,1,13,5,8,15,6,3,1,2,7,7,0,10,Q,EU_CL,Highbury,London
1999/00,10,29,Sunderland,3,12,7,3,2,21,10,11,24,6,4,2,0,8,2,6,14,6,3,1,2,13,8,5,10,Q,EU_CL,Stadium of Light,Sunderland
1999/00,10,12,Manchester United,4,12,7,3,2,28,19,9,24,6,4,2,0,19,6,13,14,6,3,1,2,9,13,-4,10,Q,EU_UC,Old Trafford,Manchester
1999/00,10,21,Tottenham Hotspur,5,11,6,2,3,20,15,5,20,6,4,0,2,15,11,4,12,5,2,2,1,5,4,1,8,Q,EU_UC,White Hart Lane,London
1999/00,10,26,Leicester City,6,12,6,2,4,20,17,3,20,6,4,2,0,11,6,5,14,6,2,0,4,9,11,-2,6,Q,EU_UC,Filbert Street,Leicester
1999/00,10,4,Chelsea,7,10,6,1,3,17,7,10,19,5,4,0,1,13,3,10,12,5,2,1,2,4,4,0,7,,,Stamford Bridge,London
1999/00,10,7,Everton,8,12,5,3,4,21,18,3,18,6,3,3,0,15,7,8,12,6,2,0,4,6,11,-5,6,,,Goodison Park,Liverpool
1999/00,10,10,Liverpool,9,12,5,3,4,13,11,2,18,6,3,0,3,6,5,1,9,6,2,3,1,7,6,1,9,,,Anfield,Liverpool
1999/00,10,2,Aston Villa,10,12,5,3,4,13,12,1,18,6,3,3,0,8,3,5,12,6,2,0,4,5,9,-4,6,Q,EU_IT,Villa Park,Birmingham
1999/00,10,13,Middlesbrough,11,12,6,0,6,16,16,0,18,6,3,0,3,6,7,-1,9,6,3,0,3,10,9,1,9,,,Riverside Stadium,Middlesbrough
1999/00,10,25,West Ham United,12,11,5,2,4,12,10,2,17,5,4,1,0,7,3,4,13,6,1,1,4,5,7,-2,4,,,Boleyn Ground,London
1999/00,10,5,Coventry City,13,12,3,4,5,16,15,1,13,6,3,0,3,11,8,3,9,6,0,4,2,5,7,-2,4,,,Highfield Road,Coventry
1999/00,10,20,Southampton,14,11,3,3,5,18,22,-4,12,6,2,2,2,10,10,0,8,5,1,1,3,8,12,-4,4,,,The Dell,Southampton
1999/00,10,22,Wimbledon,15,12,2,6,4,18,26,-8,12,6,1,3,2,9,10,-1,6,6,1,3,2,9,16,-7,6,,,Selhurst Park,London
1999/00,10,32,Bradford City,16,11,3,2,6,9,17,-8,11,5,1,2,2,5,10,-5,5,6,2,0,4,4,7,-3,6,Q,EU_IT,Valley Parade,Bradford
1999/00,10,23,Newcastle United,17,12,3,1,8,23,27,-4,10,6,3,1,2,16,7,9,10,6,0,0,6,7,20,-13,0,,,St. James' Park,Newcastle
1999/00,10,33,Watford,18,12,3,0,9,8,18,-10,9,6,2,0,4,6,9,-3,6,6,1,0,5,2,9,-7,3,R,EN_D1,Vicarage Road,Watford
1999/00,10,28,Derby County,19,12,2,3,7,10,21,-11,9,6,1,0,5,3,12,-9,3,6,1,3,2,7,9,-2,6,R,EN_D1,Pride Park,Derby
1999/00,10,19,Sheffield Wednesday,20,12,1,2,9,8,27,-19,5,6,1,1,4,7,9,-2,4,6,0,1,5,1,18,-17,1,R,EN_D1,Hillsborough,Sheffield
1999/00,11,9,Leeds United,1,13,9,2,2,26,16,10,29,7,5,1,1,11,5,6,16,6,4,1,1,15,11,4,13,Q,EU_CL,Elland Road,Leeds
1999/00,11,12,Manchester United,2,13,8,3,2,31,19,12,27,7,5,2,0,22,6,16,17,6,3,1,2,9,13,-4,10,Q,EU_CL,Old Trafford,Manchester
1999/00,11,29,Sunderland,3,13,8,3,2,23,11,12,27,7,5,2,0,10,3,7,17,6,3,1,2,13,8,5,10,Q,EU_CL,Stadium of Light,Sunderland
1999/00,11,1,Arsenal,4,13,8,2,3,20,12,8,26,7,5,1,1,13,5,8,16,6,3,1,2,7,7,0,10,Q,EU_UC,Highbury,London
1999/00,11,26,Leicester City,5,13,7,2,4,23,17,6,23,7,5,2,0,14,6,8,17,6,2,0,4,9,11,-2,6,"Q,Q","EU_UC,EU_UC",Filbert Street,Leicester
1999/00,11,10,Liverpool,6,13,6,3,4,16,12,4,21,7,4,0,3,9,6,3,12,6,2,3,1,7,6,1,9,,,Anfield,Liverpool
1999/00,11,13,Middlesbrough,7,13,7,0,6,18,17,1,21,7,4,0,3,8,8,0,12,6,3,0,3,10,9,1,9,,,Riverside Stadium,Middlesbrough
1999/00,11,21,Tottenham Hotspur,8,12,6,2,4,21,17,4,20,6,4,0,2,15,11,4,12,6,2,2,2,6,6,0,8,,,White Hart Lane,London
1999/00,11,4,Chelsea,9,11,6,1,4,18,10,8,19,5,4,0,1,13,3,10,12,6,2,1,3,5,7,-2,7,,,Stamford Bridge,London
1999/00,11,7,Everton,10,13,5,3,5,22,20,2,18,6,3,3,0,15,7,8,12,7,2,0,5,7,13,-6,6,,,Goodison Park,Liverpool
1999/00,11,2,Aston Villa,11,13,5,3,5,13,15,-2,18,6,3,3,0,8,3,5,12,7,2,0,5,5,12,-7,6,Q,EU_IT,Villa Park,Birmingham
1999/00,11,25,West Ham United,12,12,5,2,5,12,11,1,17,5,4,1,0,7,3,4,13,7,1,1,5,5,8,-3,4,,,Boleyn Ground,London
1999/00,11,5,Coventry City,13,13,4,4,5,20,15,5,16,7,4,0,3,15,8,7,12,6,0,4,2,5,7,-2,4,,,Highfield Road,Coventry
1999/00,11,20,Southampton,14,12,3,4,5,19,23,-4,13,6,2,2,2,10,10,0,8,6,1,2,3,9,13,-4,5,,,The Dell,Southampton
1999/00,11,22,Wimbledon,15,13,2,7,4,19,27,-8,13,7,1,4,2,10,11,-1,7,6,1,3,2,9,16,-7,6,,,Selhurst Park,London
1999/00,11,28,Derby County,16,13,3,3,7,13,22,-9,12,7,2,0,5,6,13,-7,6,6,1,3,2,7,9,-2,6,,,Pride Park,Derby
1999/00,11,23,Newcastle United,17,13,3,2,8,23,27,-4,11,6,3,1,2,16,7,9,10,7,0,1,6,7,20,-13,1,,,St. James' Park,Newcastle
1999/00,11,32,Bradford City,18,12,3,2,7,10,20,-10,11,5,1,2,2,5,10,-5,5,7,2,0,5,5,10,-5,6,"R,Q","EN_D1,EU_IT",Valley Parade,Bradford
1999/00,11,33,Watford,19,13,3,0,10,8,22,-14,9,6,2,0,4,6,9,-3,6,7,1,0,6,2,13,-11,3,R,EN_D1,Vicarage Road,Watford
1999/00,11,19,Sheffield Wednesday,20,13,1,2,10,8,30,-22,5,6,1,1,4,7,9,-2,4,7,0,1,6,1,21,-20,1,R,EN_D1,Hillsborough,Sheffield
1999/00,12,12,Manchester United,1,14,9,3,2,33,19,14,30,8,6,2,0,24,6,18,20,6,3,1,2,9,13,-4,10,Q,EU_CL,Old Trafford,Manchester
1999/00,12,9,Leeds United,2,14,9,2,3,26,18,8,29,7,5,1,1,11,5,6,16,7,4,1,2,15,13,2,13,Q,EU_CL,Elland Road,Leeds
1999/00,12,29,Sunderland,3,14,8,4,2,24,12,12,28,7,5,2,0,10,3,7,17,7,3,2,2,14,9,5,11,Q,EU_CL,Stadium of Light,Sunderland
1999/00,12,1,Arsenal,4,14,8,2,4,21,14,7,26,7,5,1,1,13,5,8,16,7,3,1,3,8,9,-1,10,Q,EU_UC,Highbury,London
1999/00,12,10,Liverpool,5,14,7,3,4,18,12,6,24,8,5,0,3,11,6,5,15,6,2,3,1,7,6,1,9,Q,EU_UC,Anfield,Liverpool
1999/00,12,21,Tottenham Hotspur,6,13,7,2,4,23,18,5,23,7,5,0,2,17,12,5,15,6,2,2,2,6,6,0,8,,,White Hart Lane,London
1999/00,12,26,Leicester City,7,14,7,2,5,23,19,4,23,7,5,2,0,14,6,8,17,7,2,0,5,9,13,-4,6,Q,EU_UC,Filbert Street,Leicester
1999/00,12,13,Middlesbrough,8,14,7,1,6,19,18,1,22,8,4,1,3,9,9,0,13,6,3,0,3,10,9,1,9,,,Riverside Stadium,Middlesbrough
1999/00,12,4,Chelsea,9,12,6,2,4,18,10,8,20,6,4,1,1,13,3,10,13,6,2,1,3,5,7,-2,7,,,Stamford Bridge,London
1999/00,12,7,Everton,10,14,5,4,5,23,21,2,19,6,3,3,0,15,7,8,12,8,2,1,5,8,14,-6,7,,,Goodison Park,Liverpool
1999/00,12,25,West Ham United,11,13,5,3,5,12,11,1,18,5,4,1,0,7,3,4,13,8,1,2,5,5,8,-3,5,,,Boleyn Ground,London
1999/00,12,2,Aston Villa,12,14,5,3,6,13,16,-3,18,7,3,3,1,8,4,4,12,7,2,0,5,5,12,-7,6,Q,EU_IT,Villa Park,Birmingham
1999/00,12,5,Coventry City,13,14,4,5,5,21,16,5,17,7,4,0,3,15,8,7,12,7,0,5,2,6,8,-2,5,,,Highfield Road,Coventry
1999/00,12,20,Southampton,14,13,4,4,5,20,23,-3,16,6,2,2,2,10,10,0,8,7,2,2,3,10,13,-3,8,,,The Dell,Southampton
1999/00,12,22,Wimbledon,15,14,3,7,4,21,27,-6,16,8,2,4,2,12,11,1,10,6,1,3,2,9,16,-7,6,,,Selhurst Park,London
1999/00,12,23,Newcastle United,16,14,3,3,8,24,28,-4,12,7,3,2,2,17,8,9,11,7,0,1,6,7,20,-13,1,,,St. James' Park,Newcastle
1999/00,12,32,Bradford City,17,13,3,3,7,11,21,-10,12,6,1,3,2,6,11,-5,6,7,2,0,5,5,10,-5,6,Q,EU_IT,Valley Parade,Bradford
1999/00,12,28,Derby County,18,14,3,3,8,13,24,-11,12,7,2,0,5,6,13,-7,6,7,1,3,3,7,11,-4,6,R,EN_D1,Pride Park,Derby
1999/00,12,33,Watford,19,14,3,1,10,10,24,-14,10,6,2,0,4,6,9,-3,6,8,1,1,6,4,15,-11,4,R,EN_D1,Vicarage Road,Watford
1999/00,12,19,Sheffield Wednesday,20,14,1,3,10,10,32,-22,6,7,1,2,4,9,11,-2,5,7,0,1,6,1,21,-20,1,R,EN_D1,Hillsborough,Sheffield
1999/00,13,12,Manchester United,1,15,10,3,2,35,20,15,33,8,6,2,0,24,6,18,20,7,4,1,2,11,14,-3,13,Q,EU_CL,Old Trafford,Manchester
1999/00,13,9,Leeds United,2,15,10,2,3,28,19,9,32,8,6,1,1,13,6,7,19,7,4,1,2,15,13,2,13,Q,EU_CL,Elland Road,Leeds
1999/00,13,1,Arsenal,3,15,9,2,4,26,15,11,29,8,6,1,1,18,6,12,19,7,3,1,3,8,9,-1,10,Q,EU_CL,Highbury,London
1999/00,13,29,Sunderland,4,15,8,4,3,24,14,10,28,8,5,2,1,10,5,5,17,7,3,2,2,14,9,5,11,Q,EU_UC,Stadium of Light,Sunderland
1999/00,13,10,Liverpool,5,15,8,3,4,20,12,8,27,8,5,0,3,11,6,5,15,7,3,3,1,9,6,3,12,Q,EU_UC,Anfield,Liverpool
1999/00,13,21,Tottenham Hotspur,6,14,8,2,4,24,18,6,26,7,5,0,2,17,12,5,15,7,3,2,2,7,6,1,11,,,White Hart Lane,London
1999/00,13,26,Leicester City,7,15,8,2,5,25,20,5,26,8,6,2,0,16,7,9,20,7,2,0,5,9,13,-4,6,Q,EU_UC,Filbert Street,Leicester
1999/00,13,13,Middlesbrough,8,15,7,1,7,20,23,-3,22,8,4,1,3,9,9,0,13,7,3,0,4,11,14,-3,9,,,Riverside Stadium,Middlesbrough
1999/00,13,4,Chelsea,9,13,6,3,4,19,11,8,21,6,4,1,1,13,3,10,13,7,2,2,3,6,8,-2,8,,,Stamford Bridge,London
1999/00,13,25,West Ham United,10,14,6,3,5,16,14,2,21,6,5,1,0,11,6,5,16,8,1,2,5,5,8,-3,5,,,Boleyn Ground,London
1999/00,13,5,Coventry City,11,15,5,5,5,23,17,6,20,8,5,0,3,17,9,8,15,7,0,5,2,6,8,-2,5,,,Highfield Road,Coventry
1999/00,13,7,Everton,12,15,5,5,5,24,22,2,20,7,3,4,0,16,8,8,13,8,2,1,5,8,14,-6,7,,,Goodison Park,Liverpool
1999/00,13,2,Aston Villa,13,15,5,3,7,14,18,-4,18,7,3,3,1,8,4,4,12,8,2,0,6,6,14,-8,6,Q,EU_IT,Villa Park,Birmingham
1999/00,13,20,Southampton,14,14,4,4,6,20,24,-4,16,7,2,2,3,10,11,-1,8,7,2,2,3,10,13,-3,8,,,The Dell,Southampton
1999/00,13,22,Wimbledon,15,15,3,7,5,22,29,-7,16,8,2,4,2,12,11,1,10,7,1,3,3,10,18,-8,6,,,Selhurst Park,London
1999/00,13,23,Newcastle United,16,15,3,4,8,25,29,-4,13,7,3,2,2,17,8,9,11,8,0,2,6,8,21,-13,2,,,St. James' Park,Newcastle
1999/00,13,32,Bradford City,17,14,3,3,8,12,23,-11,12,6,1,3,2,6,11,-5,6,8,2,0,6,6,12,-6,6,Q,EU_IT,Valley Parade,Bradford
1999/00,13,28,Derby County,18,15,3,3,9,14,26,-12,12,8,2,0,6,7,15,-8,6,7,1,3,3,7,11,-4,6,R,EN_D1,Pride Park,Derby
1999/00,13,33,Watford,19,15,3,2,10,11,25,-14,11,7,2,1,4,7,10,-3,7,8,1,1,6,4,15,-11,4,R,EN_D1,Vicarage Road,Watford
1999/00,13,19,Sheffield Wednesday,20,15,1,3,11,13,36,-23,6,7,1,2,4,9,11,-2,5,8,0,1,7,4,25,-21,1,R,EN_D1,Hillsborough,Sheffield
1999/00,14,9,Leeds United,1,16,11,2,3,29,19,10,35,9,7,1,1,14,6,8,22,7,4,1,2,15,13,2,13,Q,EU_CL,Elland Road,Leeds
1999/00,14,12,Manchester United,2,15,10,3,2,35,20,15,33,8,6,2,0,24,6,18,20,7,4,1,2,11,14,-3,13,Q,EU_CL,Old Trafford,Manchester
1999/00,14,1,Arsenal,3,16,10,2,4,28,16,12,32,9,7,1,1,20,7,13,22,7,3,1,3,8,9,-1,10,Q,EU_CL,Highbury,London
1999/00,14,29,Sunderland,4,16,9,4,3,27,16,11,31,8,5,2,1,10,5,5,17,8,4,2,2,17,11,6,14,Q,EU_UC,Stadium of Light,Sunderland
1999/00,14,26,Leicester City,5,16,9,2,5,26,20,6,29,8,6,2,0,16,7,9,20,8,3,0,5,10,13,-3,9,"Q,Q","EU_UC,EU_UC",Filbert Street,Leicester
1999/00,14,10,Liverpool,6,16,8,3,5,20,13,7,27,8,5,0,3,11,6,5,15,8,3,3,2,9,7,2,12,,,Anfield,Liverpool
1999/00,14,21,Tottenham Hotspur,7,15,8,2,5,25,20,5,26,7,5,0,2,17,12,5,15,8,3,2,3,8,8,0,11,,,White Hart Lane,London
1999/00,14,4,Chelsea,8,14,7,3,4,20,11,9,24,7,5,1,1,14,3,11,16,7,2,2,3,6,8,-2,8,,,Stamford Bridge,London
1999/00,14,25,West Ham United,9,15,7,3,5,17,14,3,24,7,6,1,0,12,6,6,19,8,1,2,5,5,8,-3,5,,,Boleyn Ground,London
1999/00,14,13,Middlesbrough,10,16,7,2,7,20,23,-3,23,9,4,2,3,9,9,0,14,7,3,0,4,11,14,-3,9,,,Riverside Stadium,Middlesbrough
1999/00,14,7,Everton,11,16,5,6,5,24,22,2,21,8,3,5,0,16,8,8,14,8,2,1,5,8,14,-6,7,,,Goodison Park,Liverpool
1999/00,14,5,Coventry City,12,16,5,5,6,23,18,5,20,9,5,0,4,17,10,7,15,7,0,5,2,6,8,-2,5,,,Highfield Road,Coventry
1999/00,14,2,Aston Villa,13,16,5,4,7,14,18,-4,19,7,3,3,1,8,4,4,12,9,2,1,6,6,14,-8,7,Q,EU_IT,Villa Park,Birmingham
1999/00,14,22,Wimbledon,14,16,3,8,5,22,29,-7,17,8,2,4,2,12,11,1,10,8,1,4,3,10,18,-8,7,,,Selhurst Park,London
1999/00,14,23,Newcastle United,15,16,4,4,8,27,30,-3,16,8,4,2,2,19,9,10,14,8,0,2,6,8,21,-13,2,,,St. James' Park,Newcastle
1999/00,14,20,Southampton,16,15,4,4,7,20,25,-5,16,7,2,2,3,10,11,-1,8,8,2,2,4,10,14,-4,8,,,The Dell,Southampton
1999/00,14,32,Bradford City,17,15,3,3,9,12,24,-12,12,6,1,3,2,6,11,-5,6,9,2,0,7,6,13,-7,6,Q,EU_IT,Valley Parade,Bradford
1999/00,14,28,Derby County,18,16,3,3,10,15,28,-13,12,8,2,0,6,7,15,-8,6,8,1,3,4,8,13,-5,6,R,EN_D1,Pride Park,Derby
1999/00,14,33,Watford,19,16,3,2,11,13,28,-15,11,8,2,1,5,9,13,-4,7,8,1,1,6,4,15,-11,4,R,EN_D1,Vicarage Road,Watford
1999/00,14,19,Sheffield Wednesday,20,15,1,3,11,13,36,-23,6,7,1,2,4,9,11,-2,5,8,0,1,7,4,25,-21,1,R,EN_D1,Hillsborough,Sheffield
1999/00,15,9,Leeds United,1,17,12,2,3,30,19,11,38,9,7,1,1,14,6,8,22,8,5,1,2,16,13,3,16,Q,EU_CL,Elland Road,Leeds
1999/00,15,12,Manchester United,2,16,11,3,2,40,21,19,36,9,7,2,0,29,7,22,23,7,4,1,2,11,14,-3,13,Q,EU_CL,Old Trafford,Manchester
1999/00,15,1,Arsenal,3,17,11,2,4,31,16,15,35,9,7,1,1,20,7,13,22,8,4,1,3,11,9,2,13,Q,EU_CL,Highbury,London
1999/00,15,29,Sunderland,4,17,10,4,3,31,17,14,34,9,6,2,1,14,6,8,20,8,4,2,2,17,11,6,14,Q,EU_UC,Stadium of Light,Sunderland
1999/00,15,10,Liverpool,5,17,9,3,5,24,14,10,30,9,6,0,3,15,7,8,18,8,3,3,2,9,7,2,12,Q,EU_UC,Anfield,Liverpool
1999/00,15,26,Leicester City,6,17,9,2,6,26,23,3,29,9,6,2,1,16,10,6,20,8,3,0,5,10,13,-3,9,Q,EU_UC,Filbert Street,Leicester
1999/00,15,21,Tottenham Hotspur,7,16,8,3,5,25,20,5,27,8,5,1,2,17,12,5,16,8,3,2,3,8,8,0,11,,,White Hart Lane,London
1999/00,15,25,West Ham United,8,16,7,4,5,17,14,3,25,7,6,1,0,12,6,6,19,9,1,3,5,5,8,-3,6,,,Boleyn Ground,London
1999/00,15,4,Chelsea,9,15,7,3,5,21,15,6,24,7,5,1,1,14,3,11,16,8,2,2,4,7,12,-5,8,,,Stamford Bridge,London
1999/00,15,13,Middlesbrough,10,17,7,3,7,21,24,-3,24,9,4,2,3,9,9,0,14,8,3,1,4,12,15,-3,10,,,Riverside Stadium,Middlesbrough
1999/00,15,5,Coventry City,11,17,5,6,6,23,18,5,21,9,5,0,4,17,10,7,15,8,0,6,2,6,8,-2,6,,,Highfield Road,Coventry
1999/00,15,7,Everton,12,17,5,6,6,25,27,-2,21,8,3,5,0,16,8,8,14,9,2,1,6,9,19,-10,7,,,Goodison Park,Liverpool
1999/00,15,22,Wimbledon,13,17,4,8,5,27,29,-2,20,9,3,4,2,17,11,6,13,8,1,4,3,10,18,-8,7,,,Selhurst Park,London
1999/00,15,23,Newcastle United,14,17,5,4,8,28,30,-2,19,8,4,2,2,19,9,10,14,9,1,2,6,9,21,-12,5,,,St. James' Park,Newcastle
1999/00,15,2,Aston Villa,15,17,5,4,8,14,19,-5,19,8,3,3,2,8,5,3,12,9,2,1,6,6,14,-8,7,Q,EU_IT,Villa Park,Birmingham
1999/00,15,20,Southampton,16,16,4,5,7,20,25,-5,17,8,2,3,3,10,11,-1,9,8,2,2,4,10,14,-4,8,,,The Dell,Southampton
1999/00,15,32,Bradford City,17,16,3,4,9,13,25,-12,13,7,1,4,2,7,12,-5,7,9,2,0,7,6,13,-7,6,Q,EU_IT,Valley Parade,Bradford
1999/00,15,28,Derby County,18,17,3,3,11,15,29,-14,12,9,2,0,7,7,16,-9,6,8,1,3,4,8,13,-5,6,R,EN_D1,Pride Park,Derby
1999/00,15,33,Watford,19,17,3,2,12,13,33,-20,11,8,2,1,5,9,13,-4,7,9,1,1,7,4,20,-16,4,R,EN_D1,Vicarage Road,Watford
1999/00,15,19,Sheffield Wednesday,20,16,1,3,12,14,40,-26,6,7,1,2,4,9,11,-2,5,9,0,1,8,5,29,-24,1,R,EN_D1,Hillsborough,Sheffield
1999/00,16,9,Leeds United,1,18,13,2,3,32,19,13,41,9,7,1,1,14,6,8,22,9,6,1,2,18,13,5,19,Q,EU_CL,Elland Road,Leeds
1999/00,16,12,Manchester United,2,17,12,3,2,44,23,21,39,9,7,2,0,29,7,22,23,8,5,1,2,15,16,-1,16,Q,EU_CL,Old Trafford,Manchester
1999/00,16,29,Sunderland,3,18,11,4,3,33,17,16,37,10,7,2,1,16,6,10,23,8,4,2,2,17,11,6,14,Q,EU_CL,Stadium of Light,Sunderland
1999/00,16,1,Arsenal,4,18,11,3,4,32,17,15,36,10,7,2,1,21,8,13,23,8,4,1,3,11,9,2,13,Q,EU_UC,Highbury,London
1999/00,16,10,Liverpool,5,18,10,3,5,26,14,12,33,10,7,0,3,17,7,10,21,8,3,3,2,9,7,2,12,Q,EU_UC,Anfield,Liverpool
1999/00,16,26,Leicester City,6,18,9,2,7,26,24,2,29,10,6,2,2,16,11,5,20,8,3,0,5,10,13,-3,9,Q,EU_UC,Filbert Street,Leicester
1999/00,16,21,Tottenham Hotspur,7,17,8,3,6,26,22,4,27,8,5,1,2,17,12,5,16,9,3,2,4,9,10,-1,11,,,White Hart Lane,London
1999/00,16,13,Middlesbrough,8,18,8,3,7,23,25,-2,27,10,5,2,3,11,10,1,17,8,3,1,4,12,15,-3,10,,,Riverside Stadium,Middlesbrough
1999/00,16,25,West Ham United,9,17,7,4,6,19,18,1,25,8,6,1,1,14,10,4,19,9,1,3,5,5,8,-3,6,,,Boleyn Ground,London
1999/00,16,4,Chelsea,10,16,7,3,6,21,17,4,24,8,5,1,2,14,5,9,16,8,2,2,4,7,12,-5,8,,,Stamford Bridge,London
1999/00,16,7,Everton,11,18,6,6,6,28,28,0,24,8,3,5,0,16,8,8,14,10,3,1,6,12,20,-8,10,,,Goodison Park,Liverpool
1999/00,16,2,Aston Villa,12,18,6,4,8,16,20,-4,22,9,4,3,2,10,6,4,15,9,2,1,6,6,14,-8,7,Q,EU_IT,Villa Park,Birmingham
1999/00,16,5,Coventry City,13,18,5,6,7,23,20,3,21,9,5,0,4,17,10,7,15,9,0,6,3,6,10,-4,6,,,Highfield Road,Coventry
1999/00,16,22,Wimbledon,14,18,4,9,5,28,30,-2,21,9,3,4,2,17,11,6,13,9,1,5,3,11,19,-8,8,,,Selhurst Park,London
1999/00,16,23,Newcastle United,15,18,5,4,9,28,32,-4,19,8,4,2,2,19,9,10,14,10,1,2,7,9,23,-14,5,,,St. James' Park,Newcastle
1999/00,16,20,Southampton,16,17,4,5,8,20,27,-7,17,8,2,3,3,10,11,-1,9,9,2,2,5,10,16,-6,8,,,The Dell,Southampton
1999/00,16,32,Bradford City,17,17,4,4,9,15,25,-10,16,8,2,4,2,9,12,-3,10,9,2,0,7,6,13,-7,6,Q,EU_IT,Valley Parade,Bradford
1999/00,16,28,Derby County,18,18,4,3,11,16,29,-13,15,9,2,0,7,7,16,-9,6,9,2,3,4,9,13,-4,9,R,EN_D1,Pride Park,Derby
1999/00,16,33,Watford,19,18,3,2,13,14,36,-22,11,9,2,1,6,10,16,-6,7,9,1,1,7,4,20,-16,4,R,EN_D1,Vicarage Road,Watford
1999/00,16,19,Sheffield Wednesday,20,17,1,3,13,15,42,-27,6,7,1,2,4,9,11,-2,5,10,0,1,9,6,31,-25,1,R,EN_D1,Hillsborough,Sheffield
1999/00,17,9,Leeds United,1,19,14,2,3,34,20,14,44,10,8,1,1,16,7,9,25,9,6,1,2,18,13,5,19,Q,EU_CL,Elland Road,Leeds
1999/00,17,12,Manchester United,2,18,13,3,2,48,23,25,42,10,8,2,0,33,7,26,26,8,5,1,2,15,16,-1,16,Q,EU_CL,Old Trafford,Manchester
1999/00,17,29,Sunderland,3,19,11,4,4,33,22,11,37,10,7,2,1,16,6,10,23,9,4,2,3,17,16,1,14,Q,EU_CL,Stadium of Light,Sunderland
1999/00,17,1,Arsenal,4,19,11,3,5,34,20,14,36,10,7,2,1,21,8,13,23,9,4,1,4,13,12,1,13,Q,EU_UC,Highbury,London
1999/00,17,10,Liverpool,5,19,10,4,5,28,16,12,34,10,7,0,3,17,7,10,21,9,3,4,2,11,9,2,13,Q,EU_UC,Anfield,Liverpool
1999/00,17,21,Tottenham Hotspur,6,18,9,3,6,30,22,8,30,9,6,1,2,21,12,9,19,9,3,2,4,9,10,-1,11,,,White Hart Lane,London
1999/00,17,26,Leicester City,7,19,9,2,8,27,26,1,29,10,6,2,2,16,11,5,20,9,3,0,6,11,15,-4,9,Q,EU_UC,Filbert Street,Leicester
1999/00,17,7,Everton,8,19,7,6,6,33,28,5,27,9,4,5,0,21,8,13,17,10,3,1,6,12,20,-8,10,,,Goodison Park,Liverpool
1999/00,17,4,Chelsea,9,17,8,3,6,23,18,5,27,8,5,1,2,14,5,9,16,9,3,2,4,9,13,-4,11,,,Stamford Bridge,London
1999/00,17,13,Middlesbrough,10,19,8,3,8,23,26,-3,27,10,5,2,3,11,10,1,17,9,3,1,5,12,16,-4,10,,,Riverside Stadium,Middlesbrough
1999/00,17,25,West Ham United,11,18,7,5,6,21,20,1,26,8,6,1,1,14,10,4,19,10,1,4,5,7,10,-3,7,,,Boleyn Ground,London
1999/00,17,2,Aston Villa,12,19,7,4,8,18,20,-2,25,9,4,3,2,10,6,4,15,10,3,1,6,8,14,-6,10,Q,EU_IT,Villa Park,Birmingham
1999/00,17,5,Coventry City,13,19,6,6,7,26,22,4,24,10,6,0,4,20,12,8,18,9,0,6,3,6,10,-4,6,,,Highfield Road,Coventry
1999/00,17,22,Wimbledon,14,19,4,10,5,30,32,-2,22,10,3,5,2,19,13,6,14,9,1,5,3,11,19,-8,8,,,Selhurst Park,London
1999/00,17,23,Newcastle United,15,19,5,5,9,30,34,-4,20,9,4,3,2,21,11,10,15,10,1,2,7,9,23,-14,5,,,St. James' Park,Newcastle
1999/00,17,20,Southampton,16,18,4,5,9,21,29,-8,17,9,2,3,4,11,13,-2,9,9,2,2,5,10,16,-6,8,,,The Dell,Southampton
1999/00,17,32,Bradford City,17,18,4,4,10,15,29,-14,16,8,2,4,2,9,12,-3,10,10,2,0,8,6,17,-11,6,Q,EU_IT,Valley Parade,Bradford
1999/00,17,28,Derby County,18,19,4,3,12,16,31,-15,15,10,2,0,8,7,18,-11,6,9,2,3,4,9,13,-4,9,R,EN_D1,Pride Park,Derby
1999/00,17,33,Watford,19,19,3,2,14,14,40,-26,11,9,2,1,6,10,16,-6,7,10,1,1,8,4,24,-20,4,R,EN_D1,Vicarage Road,Watford
1999/00,17,19,Sheffield Wednesday,20,18,2,3,13,16,42,-26,9,8,2,2,4,10,11,-1,8,10,0,1,9,6,31,-25,1,R,EN_D1,Hillsborough,Sheffield
1999/00,18,9,Leeds United,1,20,14,2,4,34,22,12,44,10,8,1,1,16,7,9,25,10,6,1,3,18,15,3,19,Q,EU_CL,Elland Road,Leeds
1999/00,18,12,Manchester United,2,19,13,4,2,50,25,25,43,10,8,2,0,33,7,26,26,9,5,2,2,17,18,-1,17,Q,EU_CL,Old Trafford,Manchester
1999/00,18,1,Arsenal,3,20,12,3,5,36,20,16,39,11,8,2,1,23,8,15,26,9,4,1,4,13,12,1,13,Q,EU_CL,Highbury,London
1999/00,18,29,Sunderland,4,20,11,5,4,35,24,11,38,11,7,3,1,18,8,10,24,9,4,2,3,17,16,1,14,Q,EU_UC,Stadium of Light,Sunderland
1999/00,18,10,Liverpool,5,20,11,4,5,31,17,14,37,11,8,0,3,20,8,12,24,9,3,4,2,11,9,2,13,Q,EU_UC,Anfield,Liverpool
1999/00,18,21,Tottenham Hotspur,6,19,9,4,6,31,23,8,31,9,6,1,2,21,12,9,19,10,3,3,4,10,11,-1,12,,,White Hart Lane,London
1999/00,18,4,Chelsea,7,18,9,3,6,26,18,8,30,9,6,1,2,17,5,12,19,9,3,2,4,9,13,-4,11,,,Stamford Bridge,London
1999/00,18,26,Leicester City,8,20,9,2,9,28,28,0,29,11,6,2,3,17,13,4,20,9,3,0,6,11,15,-4,9,Q,EU_UC,Filbert Street,Leicester
1999/00,18,7,Everton,9,20,7,7,6,33,28,5,28,9,4,5,0,21,8,13,17,11,3,2,6,12,20,-8,11,,,Goodison Park,Liverpool
1999/00,18,25,West Ham United,10,19,7,6,6,22,21,1,27,9,6,2,1,15,11,4,20,10,1,4,5,7,10,-3,7,,,Boleyn Ground,London
1999/00,18,13,Middlesbrough,11,19,8,3,8,23,26,-3,27,10,5,2,3,11,10,1,17,9,3,1,5,12,16,-4,10,,,Riverside Stadium,Middlesbrough
1999/00,18,2,Aston Villa,12,20,7,5,8,19,21,-2,26,10,4,4,2,11,7,4,16,10,3,1,6,8,14,-6,10,Q,EU_IT,Villa Park,Birmingham
1999/00,18,5,Coventry City,13,19,6,6,7,26,22,4,24,10,6,0,4,20,12,8,18,9,0,6,3,6,10,-4,6,,,Highfield Road,Coventry
1999/00,18,23,Newcastle United,14,20,6,5,9,32,35,-3,23,9,4,3,2,21,11,10,15,11,2,2,7,11,24,-13,8,,,St. James' Park,Newcastle
1999/00,18,22,Wimbledon,15,20,4,10,6,31,35,-4,22,10,3,5,2,19,13,6,14,10,1,5,4,12,22,-10,8,,,Selhurst Park,London
1999/00,18,20,Southampton,16,19,4,5,10,23,32,-9,17,9,2,3,4,11,13,-2,9,10,2,2,6,12,19,-7,8,,,The Dell,Southampton
1999/00,18,32,Bradford City,17,19,4,5,10,15,29,-14,17,9,2,5,2,9,12,-3,11,10,2,0,8,6,17,-11,6,Q,EU_IT,Valley Parade,Bradford
1999/00,18,28,Derby County,18,20,4,4,12,17,32,-15,16,10,2,0,8,7,18,-11,6,10,2,4,4,10,14,-4,10,R,EN_D1,Pride Park,Derby
1999/00,18,33,Watford,19,20,4,2,14,17,42,-25,14,10,3,1,6,13,18,-5,10,10,1,1,8,4,24,-20,4,R,EN_D1,Vicarage Road,Watford
1999/00,18,19,Sheffield Wednesday,20,19,2,3,14,16,45,-29,9,8,2,2,4,10,11,-1,8,11,0,1,10,6,34,-28,1,R,EN_D1,Hillsborough,Sheffield
1999/00,19,9,Leeds United,1,21,14,2,5,35,24,11,44,11,8,1,2,17,9,8,25,10,6,1,3,18,15,3,19,Q,EU_CL,Elland Road,Leeds
1999/00,19,12,Manchester United,2,19,13,4,2,50,25,25,43,10,8,2,0,33,7,26,26,9,5,2,2,17,18,-1,17,Q,EU_CL,Old Trafford,Manchester
1999/00,19,1,Arsenal,3,21,12,4,5,37,21,16,40,11,8,2,1,23,8,15,26,10,4,2,4,14,13,1,14,Q,EU_CL,Highbury,London
1999/00,19,29,Sunderland,4,21,11,5,5,35,25,10,38,11,7,3,1,18,8,10,24,10,4,2,4,17,17,0,14,Q,EU_UC,Stadium of Light,Sunderland
1999/00,19,10,Liverpool,5,21,11,4,6,31,18,13,37,11,8,0,3,20,8,12,24,10,3,4,3,11,10,1,13,Q,EU_UC,Anfield,Liverpool
1999/00,19,4,Chelsea,6,21,10,5,6,30,21,9,35,10,7,1,2,18,5,13,22,11,3,4,4,12,16,-4,13,,,Stamford Bridge,London
1999/00,19,21,Tottenham Hotspur,7,21,10,4,7,32,24,8,34,10,7,1,2,22,12,10,22,11,3,3,5,10,12,-2,12,,,White Hart Lane,London
1999/00,19,26,Leicester City,8,21,9,3,9,30,30,0,30,11,6,2,3,17,13,4,20,10,3,1,6,13,17,-4,10,Q,EU_UC,Filbert Street,Leicester
1999/00,19,7,Everton,9,21,7,8,6,35,30,5,29,10,4,6,0,23,10,13,18,11,3,2,6,12,20,-8,11,,,Goodison Park,Liverpool
1999/00,19,2,Aston Villa,10,21,8,5,8,21,22,-1,29,10,4,4,2,11,7,4,16,11,4,1,6,10,15,-5,13,Q,EU_IT,Villa Park,Birmingham
1999/00,19,25,West Ham United,11,20,7,7,6,24,23,1,28,9,6,2,1,15,11,4,20,11,1,5,5,9,12,-3,8,,,Boleyn Ground,London
1999/00,19,13,Middlesbrough,12,19,8,3,8,23,26,-3,27,10,5,2,3,11,10,1,17,9,3,1,5,12,16,-4,10,,,Riverside Stadium,Middlesbrough
1999/00,19,5,Coventry City,13,20,6,7,7,28,24,4,25,11,6,1,4,22,14,8,19,9,0,6,3,6,10,-4,6,,,Highfield Road,Coventry
1999/00,19,22,Wimbledon,14,21,5,10,6,32,35,-3,25,11,4,5,2,20,13,7,17,10,1,5,4,12,22,-10,8,,,Selhurst Park,London
1999/00,19,23,Newcastle United,15,21,6,6,9,34,37,-3,24,10,4,4,2,23,13,10,16,11,2,2,7,11,24,-13,8,,,St. James' Park,Newcastle
1999/00,19,20,Southampton,16,20,5,5,10,24,32,-8,20,10,3,3,4,12,13,-1,12,10,2,2,6,12,19,-7,8,,,The Dell,Southampton
1999/00,19,28,Derby County,17,21,5,4,12,19,32,-13,19,11,3,0,8,9,18,-9,9,10,2,4,4,10,14,-4,10,,,Pride Park,Derby
1999/00,19,32,Bradford City,18,21,4,6,11,16,31,-15,18,10,2,6,2,10,13,-3,12,11,2,0,9,6,18,-12,6,"R,Q","EN_D1,EU_IT",Valley Parade,Bradford
1999/00,19,33,Watford,19,21,4,2,15,17,44,-27,14,10,3,1,6,13,18,-5,10,11,1,1,9,4,26,-22,4,R,EN_D1,Vicarage Road,Watford
1999/00,19,19,Sheffield Wednesday,20,20,2,4,14,17,46,-29,10,9,2,3,4,11,12,-1,9,11,0,1,10,6,34,-28,1,R,EN_D1,Hillsborough,Sheffield
1999/00,20,9,Leeds United,1,21,14,2,5,35,24,11,44,11,8,1,2,17,9,8,25,10,6,1,3,18,15,3,19,Q,EU_CL,Elland Road,Leeds
1999/00,20,12,Manchester United,2,19,13,4,2,50,25,25,43,10,8,2,0,33,7,26,26,9,5,2,2,17,18,-1,17,Q,EU_CL,Old Trafford,Manchester
1999/00,20,1,Arsenal,3,22,13,4,5,41,22,19,43,12,9,2,1,27,9,18,29,10,4,2,4,14,13,1,14,Q,EU_CL,Highbury,London
1999/00,20,10,Liverpool,4,22,12,4,6,34,20,14,40,11,8,0,3,20,8,12,24,11,4,4,3,14,12,2,16,Q,EU_UC,Anfield,Liverpool
1999/00,20,29,Sunderland,5,22,11,5,6,36,29,7,38,11,7,3,1,18,8,10,24,11,4,2,5,18,21,-3,14,Q,EU_UC,Stadium of Light,Sunderland
1999/00,20,4,Chelsea,6,22,10,6,6,31,22,9,36,11,7,2,2,19,6,13,23,11,3,4,4,12,16,-4,13,,,Stamford Bridge,London
1999/00,20,21,Tottenham Hotspur,7,22,10,5,7,34,26,8,35,10,7,1,2,22,12,10,22,12,3,4,5,12,14,-2,13,,,White Hart Lane,London
1999/00,20,26,Leicester City,8,22,9,4,9,31,31,0,31,11,6,2,3,17,13,4,20,11,3,2,6,14,18,-4,11,Q,EU_UC,Filbert Street,Leicester
1999/00,20,7,Everton,9,22,7,9,6,37,32,5,30,11,4,7,0,25,12,13,19,11,3,2,6,12,20,-8,11,,,Goodison Park,Liverpool
1999/00,20,2,Aston Villa,10,22,8,6,8,22,23,-1,30,10,4,4,2,11,7,4,16,12,4,2,6,11,16,-5,14,Q,EU_IT,Villa Park,Birmingham
1999/00,20,25,West Ham United,11,21,7,8,6,25,24,1,29,10,6,3,1,16,12,4,21,11,1,5,5,9,12,-3,8,,,Boleyn Ground,London
1999/00,20,5,Coventry City,12,21,7,7,7,30,24,6,28,12,7,1,4,24,14,10,22,9,0,6,3,6,10,-4,6,,,Highfield Road,Coventry
1999/00,20,23,Newcastle United,13,22,7,6,9,39,37,2,27,11,5,4,2,28,13,15,19,11,2,2,7,11,24,-13,8,,,St. James' Park,Newcastle
1999/00,20,13,Middlesbrough,14,20,8,3,9,24,30,-6,27,11,5,2,4,12,14,-2,17,9,3,1,5,12,16,-4,10,,,Riverside Stadium,Middlesbrough
1999/00,20,22,Wimbledon,15,22,5,10,7,32,37,-5,25,11,4,5,2,20,13,7,17,11,1,5,5,12,24,-12,8,,,Selhurst Park,London
1999/00,20,28,Derby County,16,22,6,4,12,23,33,-10,22,11,3,0,8,9,18,-9,9,11,3,4,4,14,15,-1,13,,,Pride Park,Derby
1999/00,20,20,Southampton,17,21,5,5,11,24,37,-13,20,10,3,3,4,12,13,-1,12,11,2,2,7,12,24,-12,8,,,The Dell,Southampton
1999/00,20,32,Bradford City,18,22,4,6,12,16,33,-17,18,10,2,6,2,10,13,-3,12,12,2,0,10,6,20,-14,6,"R,Q","EN_D1,EU_IT",Valley Parade,Bradford
1999/00,20,33,Watford,19,22,4,2,16,19,47,-28,14,11,3,1,7,15,21,-6,10,11,1,1,9,4,26,-22,4,R,EN_D1,Vicarage Road,Watford
1999/00,20,19,Sheffield Wednesday,20,21,3,4,14,19,46,-27,13,10,3,3,4,13,12,1,12,11,0,1,10,6,34,-28,1,R,EN_D1,Hillsborough,Sheffield
1999/00,21,12,Manchester United,1,22,15,5,2,53,26,27,50,12,9,3,0,35,8,27,30,10,6,2,2,18,18,0,20,Q,EU_CL,Old Trafford,Manchester
1999/00,21,9,Leeds United,2,22,15,2,5,37,25,12,47,11,8,1,2,17,9,8,25,11,7,1,3,20,16,4,22,Q,EU_CL,Elland Road,Leeds
1999/00,21,1,Arsenal,3,23,13,5,5,42,23,19,44,12,9,2,1,27,9,18,29,11,4,3,4,15,14,1,15,Q,EU_CL,Highbury,London
1999/00,21,10,Liverpool,4,23,12,5,6,34,20,14,41,12,8,1,3,20,8,12,25,11,4,4,3,14,12,2,16,Q,EU_UC,Anfield,Liverpool
1999/00,21,29,Sunderland,5,23,11,5,7,37,31,6,38,12,7,3,2,19,10,9,24,11,4,2,5,18,21,-3,14,Q,EU_UC,Stadium of Light,Sunderland
1999/00,21,4,Chelsea,6,23,10,7,6,31,22,9,37,11,7,2,2,19,6,13,23,12,3,5,4,12,16,-4,14,,,Stamford Bridge,London
1999/00,21,21,Tottenham Hotspur,7,23,10,5,8,34,27,7,35,11,7,1,3,22,13,9,22,12,3,4,5,12,14,-2,13,,,White Hart Lane,London
1999/00,21,25,West Ham United,8,22,8,8,6,28,25,3,32,10,6,3,1,16,12,4,21,12,2,5,5,12,13,-1,11,,,Boleyn Ground,London
1999/00,21,2,Aston Villa,9,23,8,7,8,22,23,-1,31,11,4,5,2,11,7,4,17,12,4,2,6,11,16,-5,14,Q,EU_IT,Villa Park,Birmingham
1999/00,21,26,Leicester City,10,23,9,4,10,32,34,-2,31,12,6,2,4,18,16,2,20,11,3,2,6,14,18,-4,11,Q,EU_UC,Filbert Street,Leicester
1999/00,21,7,Everton,11,23,7,9,7,37,34,3,30,11,4,7,0,25,12,13,19,12,3,2,7,12,22,-10,11,,,Goodison Park,Liverpool
1999/00,21,5,Coventry City,12,22,7,8,7,30,24,6,29,12,7,1,4,24,14,10,22,10,0,7,3,6,10,-4,7,,,Highfield Road,Coventry
1999/00,21,22,Wimbledon,13,23,6,10,7,34,37,-3,28,12,5,5,2,22,13,9,20,11,1,5,5,12,24,-12,8,,,Selhurst Park,London
1999/00,21,13,Middlesbrough,14,22,8,4,10,24,31,-7,28,11,5,2,4,12,14,-2,17,11,3,2,6,12,17,-5,11,,,Riverside Stadium,Middlesbrough
1999/00,21,23,Newcastle United,15,23,7,6,10,39,39,0,27,11,5,4,2,28,13,15,19,12,2,2,8,11,26,-15,8,,,St. James' Park,Newcastle
1999/00,21,28,Derby County,16,23,6,5,12,23,33,-10,23,12,3,1,8,9,18,-9,10,11,3,4,4,14,15,-1,13,,,Pride Park,Derby
1999/00,21,20,Southampton,17,22,6,5,11,26,37,-11,23,11,4,3,4,14,13,1,15,11,2,2,7,12,24,-12,8,,,The Dell,Southampton
1999/00,21,32,Bradford City,18,23,5,6,12,19,35,-16,21,11,3,6,2,13,15,-2,15,12,2,0,10,6,20,-14,6,"R,Q","EN_D1,EU_IT",Valley Parade,Bradford
1999/00,21,19,Sheffield Wednesday,19,23,4,4,15,20,47,-27,16,11,3,3,5,13,13,0,12,12,1,1,10,7,34,-27,4,R,EN_D1,Hillsborough,Sheffield
1999/00,21,33,Watford,20,23,4,2,17,21,50,-29,14,11,3,1,7,15,21,-6,10,12,1,1,10,6,29,-23,4,R,EN_D1,Vicarage Road,Watford
1999/00,22,12,Manchester United,1,23,16,5,2,56,28,28,53,13,10,3,0,38,10,28,33,10,6,2,2,18,18,0,20,Q,EU_CL,Old Trafford,Manchester
1999/00,22,9,Leeds United,2,23,15,2,6,38,28,10,47,11,8,1,2,17,9,8,25,12,7,1,4,21,19,2,22,Q,EU_CL,Elland Road,Leeds
1999/00,22,1,Arsenal,3,24,13,5,6,43,25,18,44,12,9,2,1,27,9,18,29,12,4,3,5,16,16,0,15,Q,EU_CL,Highbury,London
1999/00,22,10,Liverpool,4,24,13,5,6,37,21,16,44,13,9,1,3,23,9,14,28,11,4,4,3,14,12,2,16,Q,EU_UC,Anfield,Liverpool
1999/00,22,4,Chelsea,5,24,11,7,6,32,22,10,40,11,7,2,2,19,6,13,23,13,4,5,4,13,16,-3,17,Q,EU_UC,Stamford Bridge,London
1999/00,22,29,Sunderland,6,24,11,6,7,39,33,6,39,13,7,4,2,21,12,9,25,11,4,2,5,18,21,-3,14,,,Stadium of Light,Sunderland
1999/00,22,21,Tottenham Hotspur,7,24,10,5,9,34,28,6,35,12,7,1,4,22,14,8,22,12,3,4,5,12,14,-2,13,,,White Hart Lane,London
1999/00,22,2,Aston Villa,8,24,9,7,8,26,23,3,34,12,5,5,2,15,7,8,20,12,4,2,6,11,16,-5,14,Q,EU_IT,Villa Park,Birmingham
1999/00,22,26,Leicester City,9,24,10,4,10,34,35,-1,34,13,7,2,4,20,17,3,23,11,3,2,6,14,18,-4,11,Q,EU_UC,Filbert Street,Leicester
1999/00,22,7,Everton,10,24,8,9,7,40,34,6,33,11,4,7,0,25,12,13,19,13,4,2,7,15,22,-7,14,,,Goodison Park,Liverpool
1999/00,22,25,West Ham United,11,23,8,8,7,29,27,2,32,10,6,3,1,16,12,4,21,13,2,5,6,13,15,-2,11,,,Boleyn Ground,London
1999/00,22,5,Coventry City,12,23,7,8,8,32,27,5,29,12,7,1,4,24,14,10,22,11,0,7,4,8,13,-5,7,,,Highfield Road,Coventry
1999/00,22,23,Newcastle United,13,24,7,7,10,41,41,0,28,11,5,4,2,28,13,15,19,13,2,3,8,13,28,-15,9,,,St. James' Park,Newcastle
1999/00,22,22,Wimbledon,14,24,6,10,8,34,40,-6,28,13,5,5,3,22,16,6,20,11,1,5,5,12,24,-12,8,,,Selhurst Park,London
1999/00,22,13,Middlesbrough,15,23,8,4,11,25,33,-8,28,11,5,2,4,12,14,-2,17,12,3,2,7,13,19,-6,11,,,Riverside Stadium,Middlesbrough
1999/00,22,20,Southampton,16,23,7,5,11,28,38,-10,26,12,5,3,4,16,14,2,18,11,2,2,7,12,24,-12,8,,,The Dell,Southampton
1999/00,22,28,Derby County,17,24,6,6,12,26,36,-10,24,13,3,2,8,12,21,-9,11,11,3,4,4,14,15,-1,13,,,Pride Park,Derby
1999/00,22,32,Bradford City,18,24,6,6,12,21,36,-15,24,12,4,6,2,15,16,-1,18,12,2,0,10,6,20,-14,6,"R,Q","EN_D1,EU_IT",Valley Parade,Bradford
1999/00,22,19,Sheffield Wednesday,19,24,4,5,15,23,50,-27,17,11,3,3,5,13,13,0,12,13,1,2,10,10,37,-27,5,R,EN_D1,Hillsborough,Sheffield
1999/00,22,33,Watford,20,24,4,2,18,21,54,-33,14,11,3,1,7,15,21,-6,10,13,1,1,11,6,33,-27,4,R,EN_D1,Vicarage Road,Watford
1999/00,23,12,Manchester United,1,25,17,5,3,57,31,26,56,13,10,3,0,38,10,28,33,12,7,2,3,19,21,-2,23,Q,EU_CL,Old Trafford,Manchester
1999/00,23,9,Leeds United,2,25,16,2,7,39,29,10,50,13,9,1,3,18,10,8,28,12,7,1,4,21,19,2,22,Q,EU_CL,Elland Road,Leeds
1999/00,23,10,Liverpool,3,25,14,5,6,38,21,17,47,13,9,1,3,23,9,14,28,12,5,4,3,15,12,3,19,Q,EU_CL,Anfield,Liverpool
1999/00,23,1,Arsenal,4,25,13,5,7,43,26,17,44,13,9,2,2,27,10,17,29,12,4,3,5,16,16,0,15,Q,EU_UC,Highbury,London
1999/00,23,4,Chelsea,5,25,12,7,6,35,23,12,43,12,8,2,2,22,7,15,26,13,4,5,4,13,16,-3,17,Q,EU_UC,Stamford Bridge,London
1999/00,23,29,Sunderland,6,25,11,6,8,41,36,5,39,13,7,4,2,21,12,9,25,12,4,2,6,20,24,-4,14,,,Stadium of Light,Sunderland
1999/00,23,2,Aston Villa,7,25,10,7,8,30,23,7,37,12,5,5,2,15,7,8,20,13,5,2,6,15,16,-1,17,Q,EU_IT,Villa Park,Birmingham
1999/00,23,7,Everton,8,25,9,9,7,42,35,7,36,12,5,7,0,27,13,14,22,13,4,2,7,15,22,-7,14,,,Goodison Park,Liverpool
1999/00,23,21,Tottenham Hotspur,9,25,10,5,10,34,29,5,35,12,7,1,4,22,14,8,22,13,3,4,6,12,15,-3,13,,,White Hart Lane,London
1999/00,23,25,West Ham United,10,24,9,8,7,34,31,3,35,11,7,3,1,21,16,5,24,13,2,5,6,13,15,-2,11,,,Boleyn Ground,London
1999/00,23,26,Leicester City,11,25,10,5,10,35,36,-1,35,13,7,2,4,20,17,3,23,12,3,3,6,15,19,-4,12,Q,EU_UC,Filbert Street,Leicester
1999/00,23,5,Coventry City,12,25,8,8,9,35,31,4,32,13,8,1,4,27,16,11,25,12,0,7,5,8,15,-7,7,,,Highfield Road,Coventry
1999/00,23,23,Newcastle United,13,25,8,7,10,44,41,3,31,12,6,4,2,31,13,18,22,13,2,3,8,13,28,-15,9,,,St. James' Park,Newcastle
1999/00,23,13,Middlesbrough,14,25,9,4,12,27,37,-10,31,13,6,2,5,14,18,-4,20,12,3,2,7,13,19,-6,11,,,Riverside Stadium,Middlesbrough
1999/00,23,20,Southampton,15,24,8,5,11,29,38,-9,29,12,5,3,4,16,14,2,18,12,3,2,7,13,24,-11,11,,,The Dell,Southampton
1999/00,23,22,Wimbledon,16,25,6,10,9,35,43,-8,28,13,5,5,3,22,16,6,20,12,1,5,6,13,27,-14,8,,,Selhurst Park,London
1999/00,23,28,Derby County,17,25,6,6,13,27,38,-11,24,13,3,2,8,12,21,-9,11,12,3,4,5,15,17,-2,13,,,Pride Park,Derby
1999/00,23,32,Bradford City,18,25,6,6,13,25,41,-16,24,12,4,6,2,15,16,-1,18,13,2,0,11,10,25,-15,6,"R,Q","EN_D1,EU_IT",Valley Parade,Bradford
1999/00,23,19,Sheffield Wednesday,19,25,4,5,16,23,51,-28,17,12,3,3,6,13,14,-1,12,13,1,2,10,10,37,-27,5,R,EN_D1,Hillsborough,Sheffield
1999/00,23,33,Watford,20,25,4,3,18,22,55,-33,15,12,3,2,7,16,22,-6,11,13,1,1,11,6,33,-27,4,R,EN_D1,Vicarage Road,Watford
1999/00,24,12,Manchester United,1,26,17,6,3,59,33,26,57,13,10,3,0,38,10,28,33,13,7,3,3,21,23,-2,24,Q,EU_CL,Old Trafford,Manchester
1999/00,24,9,Leeds United,2,26,16,3,7,39,29,10,51,13,9,1,3,18,10,8,28,13,7,2,4,21,19,2,23,Q,EU_CL,Elland Road,Leeds
1999/00,24,1,Arsenal,3,26,14,5,7,46,27,19,47,14,10,2,2,30,11,19,32,12,4,3,5,16,16,0,15,Q,EU_CL,Highbury,London
1999/00,24,10,Liverpool,4,25,14,5,6,38,21,17,47,13,9,1,3,23,9,14,28,12,5,4,3,15,12,3,19,Q,EU_UC,Anfield,Liverpool
1999/00,24,4,Chelsea,5,26,13,7,6,37,24,13,46,13,9,2,2,24,8,16,29,13,4,5,4,13,16,-3,17,Q,EU_UC,Stamford Bridge,London
1999/00,24,29,Sunderland,6,26,11,7,8,42,37,5,40,14,7,5,2,22,13,9,26,12,4,2,6,20,24,-4,14,,,Stadium of Light,Sunderland
1999/00,24,7,Everton,7,26,10,9,7,46,35,11,39,12,5,7,0,27,13,14,22,14,5,2,7,19,22,-3,17,,,Goodison Park,Liverpool
1999/00,24,2,Aston Villa,8,26,10,8,8,31,24,7,38,12,5,5,2,15,7,8,20,14,5,3,6,16,17,-1,18,Q,EU_IT,Villa Park,Birmingham
1999/00,24,21,Tottenham Hotspur,9,26,11,5,10,35,29,6,38,12,7,1,4,22,14,8,22,14,4,4,6,13,15,-2,16,,,White Hart Lane,London
1999/00,24,26,Leicester City,10,25,10,5,10,35,36,-1,35,13,7,2,4,20,17,3,23,12,3,3,6,15,19,-4,12,Q,EU_UC,Filbert Street,Leicester
1999/00,24,25,West Ham United,11,25,9,8,8,34,35,-1,35,12,7,3,2,21,20,1,24,13,2,5,6,13,15,-2,11,,,Boleyn Ground,London
1999/00,24,23,Newcastle United,12,26,9,7,10,46,41,5,34,12,6,4,2,31,13,18,22,14,3,3,8,15,28,-13,12,,,St. James' Park,Newcastle
1999/00,24,5,Coventry City,13,26,8,8,10,35,32,3,32,14,8,1,5,27,17,10,25,12,0,7,5,8,15,-7,7,,,Highfield Road,Coventry
1999/00,24,13,Middlesbrough,14,26,9,5,12,27,37,-10,32,14,6,3,5,14,18,-4,21,12,3,2,7,13,19,-6,11,,,Riverside Stadium,Middlesbrough
1999/00,24,22,Wimbledon,15,26,6,11,9,37,45,-8,29,14,5,6,3,24,18,6,21,12,1,5,6,13,27,-14,8,,,Selhurst Park,London
1999/00,24,20,Southampton,16,25,8,5,12,30,41,-11,29,12,5,3,4,16,14,2,18,13,3,2,8,14,27,-13,11,,,The Dell,Southampton
1999/00,24,28,Derby County,17,26,6,7,13,28,39,-11,25,13,3,2,8,12,21,-9,11,13,3,5,5,16,18,-2,14,,,Pride Park,Derby
1999/00,24,32,Bradford City,18,26,6,7,13,26,42,-16,25,13,4,7,2,16,17,-1,19,13,2,0,11,10,25,-15,6,"R,Q","EN_D1,EU_IT",Valley Parade,Bradford
1999/00,24,19,Sheffield Wednesday,19,26,4,5,17,23,53,-30,17,13,3,3,7,13,16,-3,12,13,1,2,10,10,37,-27,5,R,EN_D1,Hillsborough,Sheffield
1999/00,24,33,Watford,20,26,4,3,19,23,57,-34,15,12,3,2,7,16,22,-6,11,14,1,1,12,7,35,-28,4,R,EN_D1,Vicarage Road,Watford
1999/00,25,12,Manchester United,1,27,17,7,3,60,34,26,58,14,10,4,0,39,11,28,34,13,7,3,3,21,23,-2,24,Q,EU_CL,Old Trafford,Manchester
1999/00,25,9,Leeds United,2,27,17,3,7,42,29,13,54,14,10,1,3,21,10,11,31,13,7,2,4,21,19,2,23,Q,EU_CL,Elland Road,Leeds
1999/00,25,4,Chelsea,3,27,14,7,6,38,24,14,49,13,9,2,2,24,8,16,29,14,5,5,4,14,16,-2,20,Q,EU_CL,Stamford Bridge,London
1999/00,25,1,Arsenal,4,27,14,6,7,47,28,19,48,14,10,2,2,30,11,19,32,13,4,4,5,17,17,0,16,Q,EU_UC,Highbury,London
1999/00,25,10,Liverpool,5,26,14,6,6,39,22,17,48,13,9,1,3,23,9,14,28,13,5,5,3,16,13,3,20,Q,EU_UC,Anfield,Liverpool
1999/00,25,25,West Ham United,6,27,11,8,8,38,36,2,41,13,8,3,2,23,20,3,27,14,3,5,6,15,16,-1,14,,,Boleyn Ground,London
1999/00,25,7,Everton,7,27,10,10,7,47,36,11,40,13,5,8,0,28,14,14,23,14,5,2,7,19,22,-3,17,,,Goodison Park,Liverpool
1999/00,25,29,Sunderland,8,27,11,7,9,44,42,2,40,14,7,5,2,22,13,9,26,13,4,2,7,22,29,-7,14,,,Stadium of Light,Sunderland
1999/00,25,2,Aston Villa,9,27,10,9,8,32,25,7,39,13,5,6,2,16,8,8,21,14,5,3,6,16,17,-1,18,Q,EU_IT,Villa Park,Birmingham
1999/00,25,21,Tottenham Hotspur,10,27,11,6,10,36,30,6,39,13,7,2,4,23,15,8,23,14,4,4,6,13,15,-2,16,,,White Hart Lane,London
1999/00,25,26,Leicester City,11,26,11,5,10,40,38,2,38,14,8,2,4,25,19,6,26,12,3,3,6,15,19,-4,12,Q,EU_UC,Filbert Street,Leicester
1999/00,25,23,Newcastle United,12,27,9,7,11,46,42,4,34,13,6,4,3,31,14,17,22,14,3,3,8,15,28,-13,12,,,St. James' Park,Newcastle
1999/00,25,13,Middlesbrough,13,27,9,6,12,28,38,-10,33,14,6,3,5,14,18,-4,21,13,3,3,7,14,20,-6,12,,,Riverside Stadium,Middlesbrough
1999/00,25,5,Coventry City,14,27,8,8,11,35,35,0,32,14,8,1,5,27,17,10,25,13,0,7,6,8,18,-10,7,,,Highfield Road,Coventry
1999/00,25,20,Southampton,15,27,8,6,13,31,44,-13,30,13,5,4,4,17,15,2,19,14,3,2,9,14,29,-15,11,,,The Dell,Southampton
1999/00,25,22,Wimbledon,16,27,6,11,10,37,49,-12,29,14,5,6,3,24,18,6,21,13,1,5,7,13,31,-18,8,,,Selhurst Park,London
1999/00,25,28,Derby County,17,27,7,7,13,32,39,-7,28,14,4,2,8,16,21,-5,14,13,3,5,5,16,18,-2,14,,,Pride Park,Derby
1999/00,25,32,Bradford City,18,27,6,8,13,27,43,-16,26,13,4,7,2,16,17,-1,19,14,2,1,11,11,26,-15,7,"R,Q","EN_D1,EU_IT",Valley Parade,Bradford
1999/00,25,19,Sheffield Wednesday,19,27,4,6,17,24,54,-30,18,13,3,3,7,13,16,-3,12,14,1,3,10,11,38,-27,6,R,EN_D1,Hillsborough,Sheffield
1999/00,25,33,Watford,20,27,4,3,20,24,59,-35,15,13,3,2,8,17,24,-7,11,14,1,1,12,7,35,-28,4,R,EN_D1,Vicarage Road,Watford
1999/00,26,12,Manchester United,1,28,18,7,3,63,35,28,61,15,11,4,0,42,12,30,37,13,7,3,3,21,23,-2,24,Q,EU_CL,Old Trafford,Manchester
1999/00,26,9,Leeds United,2,28,18,3,7,44,30,14,57,14,10,1,3,21,10,11,31,14,8,2,4,23,20,3,26,Q,EU_CL,Elland Road,Leeds
1999/00,26,10,Liverpool,3,28,14,8,6,40,23,17,50,15,9,3,3,24,10,14,30,13,5,5,3,16,13,3,20,Q,EU_CL,Anfield,Liverpool
1999/00,26,4,Chelsea,4,28,14,8,6,39,25,14,50,14,9,3,2,25,9,16,30,14,5,5,4,14,16,-2,20,Q,EU_UC,Stamford Bridge,London
1999/00,26,1,Arsenal,5,28,14,6,8,48,30,18,48,14,10,2,2,30,11,19,32,14,4,4,6,18,19,-1,16,Q,EU_UC,Highbury,London
1999/00,26,2,Aston Villa,6,29,11,10,8,33,25,8,43,14,6,6,2,17,8,9,24,15,5,4,6,16,17,-1,19,Q,EU_IT,Villa Park,Birmingham
1999/00,26,21,Tottenham Hotspur,7,28,12,6,10,43,32,11,42,14,8,2,4,30,17,13,26,14,4,4,6,13,15,-2,16,,,White Hart Lane,London
1999/00,26,7,Everton,8,29,10,11,8,48,38,10,41,13,5,8,0,28,14,14,23,16,5,3,8,20,24,-4,18,,,Goodison Park,Liverpool
1999/00,26,29,Sunderland,9,28,11,8,9,45,43,2,41,14,7,5,2,22,13,9,26,14,4,3,7,23,30,-7,15,,,Stadium of Light,Sunderland
1999/00,26,25,West Ham United,10,28,11,8,9,39,39,0,41,13,8,3,2,23,20,3,27,15,3,5,7,16,19,-3,14,,,Boleyn Ground,London
1999/00,26,26,Leicester City,11,27,11,5,11,41,40,1,38,14,8,2,4,25,19,6,26,13,3,3,7,16,21,-5,12,Q,EU_UC,Filbert Street,Leicester
1999/00,26,23,Newcastle United,12,28,10,7,11,47,42,5,37,14,7,4,3,32,14,18,25,14,3,3,8,15,28,-13,12,,,St. James' Park,Newcastle
1999/00,26,13,Middlesbrough,13,28,10,6,12,30,39,-9,36,15,7,3,5,16,19,-3,24,13,3,3,7,14,20,-6,12,,,Riverside Stadium,Middlesbrough
1999/00,26,5,Coventry City,14,29,9,8,12,36,36,0,35,15,9,1,5,28,17,11,28,14,0,7,7,8,19,-11,7,,,Highfield Road,Coventry
1999/00,26,22,Wimbledon,15,28,7,11,10,39,50,-11,32,15,6,6,3,26,19,7,24,13,1,5,7,13,31,-18,8,,,Selhurst Park,London
1999/00,26,20,Southampton,16,28,8,6,14,33,51,-18,30,13,5,4,4,17,15,2,19,15,3,2,10,16,36,-20,11,,,The Dell,Southampton
1999/00,26,28,Derby County,17,28,7,7,14,33,42,-9,28,14,4,2,8,16,21,-5,14,14,3,5,6,17,21,-4,14,,,Pride Park,Derby
1999/00,26,32,Bradford City,18,28,6,8,14,28,45,-17,26,14,4,7,3,17,19,-2,19,14,2,1,11,11,26,-15,7,"R,Q","EN_D1,EU_IT",Valley Parade,Bradford
1999/00,26,19,Sheffield Wednesday,19,28,5,6,17,27,55,-28,21,14,4,3,7,16,17,-1,15,14,1,3,10,11,38,-27,6,R,EN_D1,Hillsborough,Sheffield
1999/00,26,33,Watford,20,28,4,3,21,24,60,-36,15,13,3,2,8,17,24,-7,11,15,1,1,13,7,36,-29,4,R,EN_D1,Vicarage Road,Watford
1999/00,27,12,Manchester United,1,29,19,7,3,65,35,30,64,15,11,4,0,42,12,30,37,14,8,3,3,23,23,0,27,Q,EU_CL,Old Trafford,Manchester
1999/00,27,9,Leeds United,2,29,19,3,7,48,31,17,60,15,11,1,3,25,11,14,34,14,8,2,4,23,20,3,26,Q,EU_CL,Elland Road,Leeds
1999/00,27,10,Liverpool,3,29,15,8,6,42,23,19,53,15,9,3,3,24,10,14,30,14,6,5,3,18,13,5,23,Q,EU_CL,Anfield,Liverpool
1999/00,27,1,Arsenal,4,29,15,6,8,50,31,19,51,15,11,2,2,32,12,20,35,14,4,4,6,18,19,-1,16,Q,EU_UC,Highbury,London
1999/00,27,4,Chelsea,5,29,14,9,6,39,25,14,51,14,9,3,2,25,9,16,30,15,5,6,4,14,16,-2,21,Q,EU_UC,Stamford Bridge,London
1999/00,27,2,Aston Villa,6,30,11,10,9,33,27,6,43,14,6,6,2,17,8,9,24,16,5,4,7,16,19,-3,19,Q,EU_IT,Villa Park,Birmingham
1999/00,27,21,Tottenham Hotspur,7,29,12,6,11,44,34,10,42,14,8,2,4,30,17,13,26,15,4,4,7,14,17,-3,16,,,White Hart Lane,London
1999/00,27,29,Sunderland,8,29,11,9,9,46,44,2,42,15,7,6,2,23,14,9,27,14,4,3,7,23,30,-7,15,,,Stadium of Light,Sunderland
1999/00,27,25,West Ham United,9,29,11,9,9,39,39,0,42,14,8,4,2,23,20,3,28,15,3,5,7,16,19,-3,14,,,Boleyn Ground,London
1999/00,27,7,Everton,10,30,10,11,9,48,40,8,41,14,5,8,1,28,16,12,23,16,5,3,8,20,24,-4,18,,,Goodison Park,Liverpool
1999/00,27,23,Newcastle United,11,29,11,7,11,49,42,7,40,14,7,4,3,32,14,18,25,15,4,3,8,17,28,-11,15,,,St. James' Park,Newcastle
1999/00,27,5,Coventry City,12,30,10,8,12,40,36,4,38,16,10,1,5,32,17,15,31,14,0,7,7,8,19,-11,7,,,Highfield Road,Coventry
1999/00,27,26,Leicester City,13,28,11,5,12,41,42,-1,38,15,8,2,5,25,21,4,26,13,3,3,7,16,21,-5,12,Q,EU_UC,Filbert Street,Leicester
1999/00,27,13,Middlesbrough,14,29,10,7,12,31,40,-9,37,15,7,3,5,16,19,-3,24,14,3,4,7,15,21,-6,13,,,Riverside Stadium,Middlesbrough
1999/00,27,20,Southampton,15,29,9,6,14,35,51,-16,33,14,6,4,4,19,15,4,22,15,3,2,10,16,36,-20,11,,,The Dell,Southampton
1999/00,27,22,Wimbledon,16,29,7,11,11,40,54,-14,32,15,6,6,3,26,19,7,24,14,1,5,8,14,35,-21,8,,,Selhurst Park,London
1999/00,27,28,Derby County,17,29,7,7,15,33,44,-11,28,15,4,2,9,16,23,-7,14,14,3,5,6,17,21,-4,14,,,Pride Park,Derby
1999/00,27,32,Bradford City,18,29,6,8,15,28,49,-21,26,14,4,7,3,17,19,-2,19,15,2,1,12,11,30,-19,7,"R,Q","EN_D1,EU_IT",Valley Parade,Bradford
1999/00,27,19,Sheffield Wednesday,19,29,5,6,18,27,56,-29,21,14,4,3,7,16,17,-1,15,15,1,3,11,11,39,-28,6,R,EN_D1,Hillsborough,Sheffield
1999/00,27,33,Watford,20,29,5,3,21,25,60,-35,18,14,4,2,8,18,24,-6,14,15,1,1,13,7,36,-29,4,R,EN_D1,Vicarage Road,Watford
1999/00,28,12,Manchester United,1,30,20,7,3,69,35,34,67,15,11,4,0,42,12,30,37,15,9,3,3,27,23,4,30,Q,EU_CL,Old Trafford,Manchester
1999/00,28,9,Leeds United,2,30,19,3,8,49,33,16,60,15,11,1,3,25,11,14,34,15,8,2,5,24,22,2,26,Q,EU_CL,Elland Road,Leeds
1999/00,28,10,Liverpool,3,30,16,8,6,44,24,20,56,16,10,3,3,26,11,15,33,14,6,5,3,18,13,5,23,Q,EU_CL,Anfield,Liverpool
1999/00,28,1,Arsenal,4,30,16,6,8,53,31,22,54,16,12,2,2,35,12,23,38,14,4,4,6,18,19,-1,16,Q,EU_UC,Highbury,London
1999/00,28,4,Chelsea,5,30,14,10,6,40,26,14,52,15,9,4,2,26,10,16,31,15,5,6,4,14,16,-2,21,Q,EU_UC,Stamford Bridge,London
1999/00,28,2,Aston Villa,6,31,12,10,9,35,27,8,46,15,7,6,2,19,8,11,27,16,5,4,7,16,19,-3,19,Q,EU_IT,Villa Park,Birmingham
1999/00,28,29,Sunderland,7,30,12,9,9,48,45,3,45,16,8,6,2,25,15,10,30,14,4,3,7,23,30,-7,15,,,Stadium of Light,Sunderland
1999/00,28,25,West Ham United,8,30,12,9,9,41,40,1,45,15,9,4,2,25,21,4,31,15,3,5,7,16,19,-3,14,,,Boleyn Ground,London
1999/00,28,21,Tottenham Hotspur,9,30,12,7,11,45,35,10,43,14,8,2,4,30,17,13,26,16,4,5,7,15,18,-3,17,,,White Hart Lane,London
1999/00,28,7,Everton,10,31,10,11,10,49,42,7,41,14,5,8,1,28,16,12,23,17,5,3,9,21,26,-5,18,,,Goodison Park,Liverpool
1999/00,28,26,Leicester City,11,29,12,5,12,43,43,0,41,16,9,2,5,27,22,5,29,13,3,3,7,16,21,-5,12,Q,EU_UC,Filbert Street,Leicester
1999/00,28,23,Newcastle United,12,30,11,7,12,50,44,6,40,14,7,4,3,32,14,18,25,16,4,3,9,18,30,-12,15,,,St. James' Park,Newcastle
1999/00,28,13,Middlesbrough,13,30,11,7,12,32,40,-8,40,16,8,3,5,17,19,-2,27,14,3,4,7,15,21,-6,13,,,Riverside Stadium,Middlesbrough
1999/00,28,5,Coventry City,14,31,10,8,13,40,39,1,38,16,10,1,5,32,17,15,31,15,0,7,8,8,22,-14,7,,,Highfield Road,Coventry
1999/00,28,20,Southampton,15,30,9,7,14,36,52,-16,34,14,6,4,4,19,15,4,22,16,3,3,10,17,37,-20,12,,,The Dell,Southampton
1999/00,28,22,Wimbledon,16,30,7,11,12,41,56,-15,32,15,6,6,3,26,19,7,24,15,1,5,9,15,37,-22,8,,,Selhurst Park,London
1999/00,28,28,Derby County,17,30,7,7,16,33,46,-13,28,15,4,2,9,16,23,-7,14,15,3,5,7,17,23,-6,14,,,Pride Park,Derby
1999/00,28,32,Bradford City,18,30,6,8,16,28,53,-25,26,15,4,7,4,17,23,-6,19,15,2,1,12,11,30,-19,7,"R,Q","EN_D1,EU_IT",Valley Parade,Bradford
1999/00,28,19,Sheffield Wednesday,19,30,5,6,19,27,57,-30,21,14,4,3,7,16,17,-1,15,16,1,3,12,11,40,-29,6,R,EN_D1,Hillsborough,Sheffield
1999/00,28,33,Watford,20,30,5,4,21,26,61,-35,19,15,4,3,8,19,25,-6,15,15,1,1,13,7,36,-29,4,R,EN_D1,Vicarage Road,Watford
1999/00,29,12,Manchester United,1,31,21,7,3,76,36,40,70,16,12,4,0,49,13,36,40,15,9,3,3,27,23,4,30,Q,EU_CL,Old Trafford,Manchester
1999/00,29,9,Leeds United,2,31,19,3,9,49,34,15,60,16,11,1,4,25,12,13,34,15,8,2,5,24,22,2,26,Q,EU_CL,Elland Road,Leeds
1999/00,29,10,Liverpool,3,31,17,8,6,47,24,23,59,16,10,3,3,26,11,15,33,15,7,5,3,21,13,8,26,Q,EU_CL,Anfield,Liverpool
1999/00,29,1,Arsenal,4,31,17,6,8,56,32,24,57,16,12,2,2,35,12,23,38,15,5,4,6,21,20,1,19,Q,EU_UC,Highbury,London
1999/00,29,4,Chelsea,5,31,15,10,6,41,26,15,55,15,9,4,2,26,10,16,31,16,6,6,4,15,16,-1,24,Q,EU_UC,Stamford Bridge,London
1999/00,29,2,Aston Villa,6,32,13,10,9,36,27,9,49,15,7,6,2,19,8,11,27,17,6,4,7,17,19,-2,22,Q,EU_IT,Villa Park,Birmingham
1999/00,29,29,Sunderland,7,31,13,9,9,50,46,4,48,16,8,6,2,25,15,10,30,15,5,3,7,25,31,-6,18,,,Stadium of Light,Sunderland
1999/00,29,25,West Ham United,8,31,12,9,10,42,47,-5,45,15,9,4,2,25,21,4,31,16,3,5,8,17,26,-9,14,,,Boleyn Ground,London
1999/00,29,7,Everton,9,32,11,11,10,53,44,9,44,15,6,8,1,32,18,14,26,17,5,3,9,21,26,-5,18,,,Goodison Park,Liverpool
1999/00,29,21,Tottenham Hotspur,10,31,12,7,12,47,38,9,43,15,8,2,5,32,20,12,26,16,4,5,7,15,18,-3,17,,,White Hart Lane,London
1999/00,29,23,Newcastle United,11,31,12,7,12,52,44,8,43,15,8,4,3,34,14,20,28,16,4,3,9,18,30,-12,15,,,St. James' Park,Newcastle
1999/00,29,13,Middlesbrough,12,31,12,7,12,35,42,-7,43,16,8,3,5,17,19,-2,27,15,4,4,7,18,23,-5,16,,,Riverside Stadium,Middlesbrough
1999/00,29,26,Leicester City,13,30,12,5,13,43,46,-3,41,16,9,2,5,27,22,5,29,14,3,3,8,16,24,-8,12,Q,EU_UC,Filbert Street,Leicester
1999/00,29,5,Coventry City,14,32,10,8,14,40,42,-2,38,17,10,1,6,32,20,12,31,15,0,7,8,8,22,-14,7,,,Highfield Road,Coventry
1999/00,29,20,Southampton,15,31,9,7,15,37,54,-17,34,15,6,4,5,20,17,3,22,16,3,3,10,17,37,-20,12,,,The Dell,Southampton
1999/00,29,22,Wimbledon,16,31,7,11,13,42,59,-17,32,16,6,6,4,27,22,5,24,15,1,5,9,15,37,-22,8,,,Selhurst Park,London
1999/00,29,28,Derby County,17,31,8,7,16,36,46,-10,31,16,5,2,9,19,23,-4,17,15,3,5,7,17,23,-6,14,,,Pride Park,Derby
1999/00,29,32,Bradford City,18,31,6,8,17,28,55,-27,26,15,4,7,4,17,23,-6,19,16,2,1,13,11,32,-21,7,"R,Q","EN_D1,EU_IT",Valley Parade,Bradford
1999/00,29,19,Sheffield Wednesday,19,31,5,6,20,27,58,-31,21,15,4,3,8,16,18,-2,15,16,1,3,12,11,40,-29,6,R,EN_D1,Hillsborough,Sheffield
1999/00,29,33,Watford,20,31,5,4,22,28,65,-37,19,15,4,3,8,19,25,-6,15,16,1,1,14,9,40,-31,4,R,EN_D1,Vicarage Road,Watford
1999/00,30,12,Manchester United,1,32,22,7,3,80,39,41,73,16,12,4,0,49,13,36,40,16,10,3,3,31,26,5,33,Q,EU_CL,Old Trafford,Manchester
1999/00,30,10,Liverpool,2,32,18,8,6,49,24,25,62,17,11,3,3,28,11,17,36,15,7,5,3,21,13,8,26,Q,EU_CL,Anfield,Liverpool
1999/00,30,9,Leeds United,3,32,19,3,10,49,35,14,60,16,11,1,4,25,12,13,34,16,8,2,6,24,23,1,26,Q,EU_CL,Elland Road,Leeds
1999/00,30,1,Arsenal,4,31,17,6,8,56,32,24,57,16,12,2,2,35,12,23,38,15,5,4,6,21,20,1,19,Q,EU_UC,Highbury,London
1999/00,30,4,Chelsea,5,31,15,10,6,41,26,15,55,15,9,4,2,26,10,16,31,16,6,6,4,15,16,-1,24,Q,EU_UC,Stamford Bridge,London
1999/00,30,2,Aston Villa,6,33,14,10,9,37,27,10,52,16,8,6,2,20,8,12,30,17,6,4,7,17,19,-2,22,Q,EU_IT,Villa Park,Birmingham
1999/00,30,29,Sunderland,7,32,14,9,9,52,47,5,51,17,9,6,2,27,16,11,33,15,5,3,7,25,31,-6,18,,,Stadium of Light,Sunderland
1999/00,30,7,Everton,8,33,11,12,10,54,45,9,45,15,6,8,1,32,18,14,26,18,5,4,9,22,27,-5,19,,,Goodison Park,Liverpool
1999/00,30,25,West Ham United,9,31,12,9,10,42,47,-5,45,15,9,4,2,25,21,4,31,16,3,5,8,17,26,-9,14,,,Boleyn Ground,London
1999/00,30,23,Newcastle United,10,31,12,7,12,52,44,8,43,15,8,4,3,34,14,20,28,16,4,3,9,18,30,-12,15,,,St. James' Park,Newcastle
1999/00,30,21,Tottenham Hotspur,11,32,12,7,13,47,40,7,43,15,8,2,5,32,20,12,26,17,4,5,8,15,20,-5,17,,,White Hart Lane,London
1999/00,30,13,Middlesbrough,12,32,12,7,13,38,46,-8,43,17,8,3,6,20,23,-3,27,15,4,4,7,18,23,-5,16,,,Riverside Stadium,Middlesbrough
1999/00,30,26,Leicester City,13,31,12,6,13,44,47,-3,42,17,9,3,5,28,23,5,30,14,3,3,8,16,24,-8,12,Q,EU_UC,Filbert Street,Leicester
1999/00,30,5,Coventry City,14,32,10,8,14,40,42,-2,38,17,10,1,6,32,20,12,31,15,0,7,8,8,22,-14,7,,,Highfield Road,Coventry
1999/00,30,20,Southampton,15,32,10,7,15,39,55,-16,37,15,6,4,5,20,17,3,22,17,4,3,10,19,38,-19,15,,,The Dell,Southampton
1999/00,30,28,Derby County,16,32,8,8,16,36,46,-10,32,16,5,2,9,19,23,-4,17,16,3,6,7,17,23,-6,15,,,Pride Park,Derby
1999/00,30,22,Wimbledon,17,32,7,11,14,43,61,-18,32,16,6,6,4,27,22,5,24,16,1,5,10,16,39,-23,8,,,Selhurst Park,London
1999/00,30,32,Bradford City,18,32,6,8,18,29,57,-28,26,16,4,7,5,18,25,-7,19,16,2,1,13,11,32,-21,7,"R,Q","EN_D1,EU_IT",Valley Parade,Bradford
1999/00,30,19,Sheffield Wednesday,19,31,5,6,20,27,58,-31,21,15,4,3,8,16,18,-2,15,16,1,3,12,11,40,-29,6,R,EN_D1,Hillsborough,Sheffield
1999/00,30,33,Watford,20,32,5,5,22,28,65,-37,20,16,4,4,8,19,25,-6,16,16,1,1,14,9,40,-31,4,R,EN_D1,Vicarage Road,Watford
1999/00,31,12,Manchester United,1,32,22,7,3,80,39,41,73,16,12,4,0,49,13,36,40,16,10,3,3,31,26,5,33,Q,EU_CL,Old Trafford,Manchester
1999/00,31,10,Liverpool,2,32,18,8,6,49,24,25,62,17,11,3,3,28,11,17,36,15,7,5,3,21,13,8,26,Q,EU_CL,Anfield,Liverpool
1999/00,31,9,Leeds United,3,32,19,3,10,49,35,14,60,16,11,1,4,25,12,13,34,16,8,2,6,24,23,1,26,Q,EU_CL,Elland Road,Leeds
1999/00,31,4,Chelsea,4,32,16,10,6,43,27,16,58,16,10,4,2,28,11,17,34,16,6,6,4,15,16,-1,24,Q,EU_UC,Stamford Bridge,London
1999/00,31,1,Arsenal,5,31,17,6,8,56,32,24,57,16,12,2,2,35,12,23,38,15,5,4,6,21,20,1,19,Q,EU_UC,Highbury,London
1999/00,31,2,Aston Villa,6,33,14,10,9,37,27,10,52,16,8,6,2,20,8,12,30,17,6,4,7,17,19,-2,22,Q,EU_IT,Villa Park,Birmingham
1999/00,31,29,Sunderland,7,32,14,9,9,52,47,5,51,17,9,6,2,27,16,11,33,15,5,3,7,25,31,-6,18,,,Stadium of Light,Sunderland
1999/00,31,25,West Ham United,8,32,13,9,10,44,48,-4,48,16,10,4,2,27,22,5,34,16,3,5,8,17,26,-9,14,,,Boleyn Ground,London
1999/00,31,7,Everton,9,33,11,12,10,54,45,9,45,15,6,8,1,32,18,14,26,18,5,4,9,22,27,-5,19,,,Goodison Park,Liverpool
1999/00,31,23,Newcastle United,10,32,12,7,13,53,46,7,43,15,8,4,3,34,14,20,28,17,4,3,10,19,32,-13,15,,,St. James' Park,Newcastle
1999/00,31,21,Tottenham Hotspur,11,32,12,7,13,47,40,7,43,15,8,2,5,32,20,12,26,17,4,5,8,15,20,-5,17,,,White Hart Lane,London
1999/00,31,13,Middlesbrough,12,32,12,7,13,38,46,-8,43,17,8,3,6,20,23,-3,27,15,4,4,7,18,23,-5,16,,,Riverside Stadium,Middlesbrough
1999/00,31,26,Leicester City,13,31,12,6,13,44,47,-3,42,17,9,3,5,28,23,5,30,14,3,3,8,16,24,-8,12,Q,EU_UC,Filbert Street,Leicester
1999/00,31,5,Coventry City,14,33,10,8,15,41,44,-3,38,17,10,1,6,32,20,12,31,16,0,7,9,9,24,-15,7,,,Highfield Road,Coventry
1999/00,31,20,Southampton,15,32,10,7,15,39,55,-16,37,15,6,4,5,20,17,3,22,17,4,3,10,19,38,-19,15,,,The Dell,Southampton
1999/00,31,28,Derby County,16,32,8,8,16,36,46,-10,32,16,5,2,9,19,23,-4,17,16,3,6,7,17,23,-6,15,,,Pride Park,Derby
1999/00,31,22,Wimbledon,17,33,7,11,15,43,63,-20,32,17,6,6,5,27,24,3,24,16,1,5,10,16,39,-23,8,,,Selhurst Park,London
1999/00,31,32,Bradford City,18,32,6,8,18,29,57,-28,26,16,4,7,5,18,25,-7,19,16,2,1,13,11,32,-21,7,"R,Q","EN_D1,EU_IT",Valley Parade,Bradford
1999/00,31,19,Sheffield Wednesday,19,32,6,6,20,29,58,-29,24,15,4,3,8,16,18,-2,15,17,2,3,12,13,40,-27,9,R,EN_D1,Hillsborough,Sheffield
1999/00,31,33,Watford,20,32,5,5,22,28,65,-37,20,16,4,4,8,19,25,-6,16,16,1,1,14,9,40,-31,4,R,EN_D1,Vicarage Road,Watford
1999/00,32,12,Manchester United,1,33,23,7,3,84,39,45,76,17,13,4,0,53,13,40,43,16,10,3,3,31,26,5,33,Q,EU_CL,Old Trafford,Manchester
1999/00,32,10,Liverpool,2,33,19,8,6,51,25,26,65,17,11,3,3,28,11,17,36,16,8,5,3,23,14,9,29,Q,EU_CL,Anfield,Liverpool
1999/00,32,1,Arsenal,3,32,18,6,8,60,32,28,60,16,12,2,2,35,12,23,38,16,6,4,6,25,20,5,22,Q,EU_CL,Highbury,London
1999/00,32,9,Leeds United,4,33,19,3,11,49,39,10,60,17,11,1,5,25,16,9,34,16,8,2,6,24,23,1,26,Q,EU_UC,Elland Road,Leeds
1999/00,32,4,Chelsea,5,33,16,10,7,43,28,15,58,16,10,4,2,28,11,17,34,17,6,6,5,15,17,-2,24,Q,EU_UC,Stamford Bridge,London
1999/00,32,2,Aston Villa,6,34,15,10,9,41,29,12,55,16,8,6,2,20,8,12,30,18,7,4,7,21,21,0,25,Q,EU_IT,Villa Park,Birmingham
1999/00,32,29,Sunderland,7,33,14,9,10,52,51,1,51,17,9,6,2,27,16,11,33,16,5,3,8,25,35,-10,18,,,Stadium of Light,Sunderland
1999/00,32,25,West Ham United,8,33,14,9,10,46,49,-3,51,16,10,4,2,27,22,5,34,17,4,5,8,19,27,-8,17,,,Boleyn Ground,London
1999/00,32,7,Everton,9,34,12,12,10,58,45,13,48,16,7,8,1,36,18,18,29,18,5,4,9,22,27,-5,19,,,Goodison Park,Liverpool
1999/00,32,21,Tottenham Hotspur,10,34,13,7,14,50,44,6,46,16,8,2,6,34,24,10,26,18,5,5,8,16,20,-4,20,,,White Hart Lane,London
1999/00,32,26,Leicester City,11,33,13,6,14,46,48,-2,45,18,9,3,6,28,24,4,30,15,4,3,8,18,24,-6,15,Q,EU_UC,Filbert Street,Leicester
1999/00,32,23,Newcastle United,12,33,12,7,14,53,48,5,43,16,8,4,4,34,16,18,28,17,4,3,10,19,32,-13,15,,,St. James' Park,Newcastle
1999/00,32,13,Middlesbrough,13,33,12,7,14,39,48,-9,43,17,8,3,6,20,23,-3,27,16,4,4,8,19,25,-6,16,,,Riverside Stadium,Middlesbrough
1999/00,32,5,Coventry City,14,34,11,8,15,43,45,-2,41,18,11,1,6,34,21,13,34,16,0,7,9,9,24,-15,7,,,Highfield Road,Coventry
1999/00,32,20,Southampton,15,33,11,7,15,41,55,-14,40,16,7,4,5,22,17,5,25,17,4,3,10,19,38,-19,15,,,The Dell,Southampton
1999/00,32,28,Derby County,16,33,8,8,17,37,48,-11,32,17,5,2,10,20,25,-5,17,16,3,6,7,17,23,-6,15,,,Pride Park,Derby
1999/00,32,22,Wimbledon,17,34,7,11,16,44,65,-21,32,18,6,6,6,28,26,2,24,16,1,5,10,16,39,-23,8,,,Selhurst Park,London
1999/00,32,19,Sheffield Wednesday,18,33,7,6,20,30,58,-28,27,16,5,3,8,17,18,-1,18,17,2,3,12,13,40,-27,9,R,EN_D1,Hillsborough,Sheffield
1999/00,32,32,Bradford City,19,33,6,8,19,29,61,-32,26,16,4,7,5,18,25,-7,19,17,2,1,14,11,36,-25,7,"R,Q","EN_D1,EU_IT",Valley Parade,Bradford
1999/00,32,33,Watford,20,33,5,5,23,28,67,-39,20,16,4,4,8,19,25,-6,16,17,1,1,15,9,42,-33,4,R,EN_D1,Vicarage Road,Watford
1999/00,33,12,Manchester United,1,35,25,7,3,90,42,48,82,18,14,4,0,56,15,41,46,17,11,3,3,34,27,7,36,Q,EU_CL,Old Trafford,Manchester
1999/00,33,10,Liverpool,2,34,19,9,6,51,25,26,66,17,11,3,3,28,11,17,36,17,8,6,3,23,14,9,30,Q,EU_CL,Anfield,Liverpool
1999/00,33,1,Arsenal,3,33,19,6,8,63,34,29,63,16,12,2,2,35,12,23,38,17,7,4,6,28,22,6,25,Q,EU_CL,Highbury,London
1999/00,33,9,Leeds United,4,34,19,4,11,51,41,10,61,17,11,1,5,25,16,9,34,17,8,3,6,26,25,1,27,Q,EU_UC,Elland Road,Leeds
1999/00,33,4,Chelsea,5,35,16,11,8,46,32,14,59,17,10,5,2,29,12,17,35,18,6,6,6,17,20,-3,24,Q,EU_UC,Stamford Bridge,London
1999/00,33,2,Aston Villa,6,35,15,11,9,43,31,12,56,17,8,7,2,22,10,12,31,18,7,4,7,21,21,0,25,Q,EU_IT,Villa Park,Birmingham
1999/00,33,29,Sunderland,7,35,15,9,11,54,52,2,54,18,9,6,3,27,17,10,33,17,6,3,8,27,35,-8,21,,,Stadium of Light,Sunderland
1999/00,33,25,West Ham United,8,34,15,9,10,51,49,2,54,17,11,4,2,32,22,10,37,17,4,5,8,19,27,-8,17,,,Boleyn Ground,London
1999/00,33,7,Everton,9,35,12,13,10,58,45,13,49,17,7,9,1,36,18,18,30,18,5,4,9,22,27,-5,19,,,Goodison Park,Liverpool
1999/00,33,21,Tottenham Hotspur,10,35,14,7,14,52,44,8,49,17,9,2,6,36,24,12,29,18,5,5,8,16,20,-4,20,,,White Hart Lane,London
1999/00,33,26,Leicester City,11,34,13,7,14,48,50,-2,46,18,9,3,6,28,24,4,30,16,4,4,8,20,26,-6,16,Q,EU_UC,Filbert Street,Leicester
1999/00,33,23,Newcastle United,12,34,12,8,14,55,50,5,44,17,8,5,4,36,18,18,29,17,4,3,10,19,32,-13,15,,,St. James' Park,Newcastle
1999/00,33,13,Middlesbrough,13,34,12,8,14,40,49,-9,44,17,8,3,6,20,23,-3,27,17,4,5,8,20,26,-6,17,,,Riverside Stadium,Middlesbrough
1999/00,33,5,Coventry City,14,35,11,8,16,43,50,-7,41,18,11,1,6,34,21,13,34,17,0,7,10,9,29,-20,7,,,Highfield Road,Coventry
1999/00,33,20,Southampton,15,35,11,7,17,42,60,-18,40,17,7,4,6,23,20,3,25,18,4,3,11,19,40,-21,15,,,The Dell,Southampton
1999/00,33,28,Derby County,16,35,9,9,17,43,52,-9,36,18,6,2,10,22,25,-3,20,17,3,7,7,21,27,-6,16,,,Pride Park,Derby
1999/00,33,22,Wimbledon,17,35,7,11,17,44,67,-23,32,18,6,6,6,28,26,2,24,17,1,5,11,16,41,-25,8,,,Selhurst Park,London
1999/00,33,32,Bradford City,18,35,7,9,19,34,65,-31,30,17,4,8,5,22,29,-7,20,18,3,1,14,12,36,-24,10,"R,Q","EN_D1,EU_IT",Valley Parade,Bradford
1999/00,33,19,Sheffield Wednesday,19,34,7,6,21,30,60,-30,27,17,5,3,9,17,20,-3,18,17,2,3,12,13,40,-27,9,R,EN_D1,Hillsborough,Sheffield
1999/00,33,33,Watford,20,34,5,5,24,30,70,-40,20,17,4,4,9,21,28,-7,16,17,1,1,15,9,42,-33,4,R,EN_D1,Vicarage Road,Watford
1999/00,34,12,Manchester United,1,36,26,7,3,93,44,49,85,18,14,4,0,56,15,41,46,18,12,3,3,37,29,8,39,Q,EU_CL,Old Trafford,Manchester
1999/00,34,1,Arsenal,2,34,20,6,8,64,34,30,66,16,12,2,2,35,12,23,38,18,8,4,6,29,22,7,28,Q,EU_CL,Highbury,London
1999/00,34,10,Liverpool,3,35,19,9,7,51,27,24,66,17,11,3,3,28,11,17,36,18,8,6,4,23,16,7,30,Q,EU_CL,Anfield,Liverpool
1999/00,34,9,Leeds United,4,35,20,4,11,54,41,13,64,17,11,1,5,25,16,9,34,18,9,3,6,29,25,4,30,Q,EU_UC,Elland Road,Leeds
1999/00,34,4,Chelsea,5,36,17,11,8,48,32,16,62,18,11,5,2,31,12,19,38,18,6,6,6,17,20,-3,24,Q,EU_UC,Stamford Bridge,London
1999/00,34,2,Aston Villa,6,36,15,12,9,44,32,12,57,18,8,8,2,23,11,12,32,18,7,4,7,21,21,0,25,Q,EU_IT,Villa Park,Birmingham
1999/00,34,29,Sunderland,7,36,15,10,11,55,53,2,55,18,9,6,3,27,17,10,33,18,6,4,8,28,36,-8,22,,,Stadium of Light,Sunderland
1999/00,34,25,West Ham United,8,35,15,9,11,51,50,1,54,18,11,4,3,32,23,9,37,17,4,5,8,19,27,-8,17,,,Boleyn Ground,London
1999/00,34,21,Tottenham Hotspur,9,36,14,8,14,53,45,8,50,18,9,3,6,37,25,12,30,18,5,5,8,16,20,-4,20,,,White Hart Lane,London
1999/00,34,7,Everton,10,36,12,13,11,58,46,12,49,18,7,9,2,36,19,17,30,18,5,4,9,22,27,-5,19,,,Goodison Park,Liverpool
1999/00,34,26,Leicester City,11,35,14,7,14,50,51,-1,49,18,9,3,6,28,24,4,30,17,5,4,8,22,27,-5,19,Q,EU_UC,Filbert Street,Leicester
1999/00,34,23,Newcastle United,12,35,13,8,14,57,50,7,47,18,9,5,4,38,18,20,32,17,4,3,10,19,32,-13,15,,,St. James' Park,Newcastle
1999/00,34,13,Middlesbrough,13,35,13,8,14,41,49,-8,47,17,8,3,6,20,23,-3,27,18,5,5,8,21,26,-5,20,,,Riverside Stadium,Middlesbrough
1999/00,34,5,Coventry City,14,36,11,8,17,43,52,-9,41,18,11,1,6,34,21,13,34,18,0,7,11,9,31,-22,7,,,Highfield Road,Coventry
1999/00,34,20,Southampton,15,36,11,7,18,43,62,-19,40,18,7,4,7,24,22,2,25,18,4,3,11,19,40,-21,15,,,The Dell,Southampton
1999/00,34,28,Derby County,16,36,9,10,17,44,53,-9,37,18,6,2,10,22,25,-3,20,18,3,8,7,22,28,-6,17,,,Pride Park,Derby
1999/00,34,32,Bradford City,17,36,8,9,19,37,65,-28,33,18,5,8,5,25,29,-4,23,18,3,1,14,12,36,-24,10,Q,EU_IT,Valley Parade,Bradford
1999/00,34,22,Wimbledon,18,36,7,11,18,44,70,-26,32,18,6,6,6,28,26,2,24,18,1,5,12,16,44,-28,8,R,EN_D1,Selhurst Park,London
1999/00,34,19,Sheffield Wednesday,19,35,7,6,22,30,63,-33,27,18,5,3,10,17,23,-6,18,17,2,3,12,13,40,-27,9,R,EN_D1,Hillsborough,Sheffield
1999/00,34,33,Watford,20,35,5,5,25,32,73,-41,20,18,4,4,10,23,31,-8,16,17,1,1,15,9,42,-33,4,R,EN_D1,Vicarage Road,Watford
1999/00,35,12,Manchester United,1,36,26,7,3,93,44,49,85,18,14,4,0,56,15,41,46,18,12,3,3,37,29,8,39,Q,EU_CL,Old Trafford,Manchester
1999/00,35,1,Arsenal,2,35,21,6,8,66,35,31,69,17,13,2,2,37,13,24,41,18,8,4,6,29,22,7,28,Q,EU_CL,Highbury,London
1999/00,35,9,Leeds United,3,36,21,4,11,57,42,15,67,18,12,1,5,28,17,11,37,18,9,3,6,29,25,4,30,Q,EU_CL,Elland Road,Leeds
1999/00,35,10,Liverpool,4,36,19,9,8,51,29,22,66,18,11,3,4,28,13,15,36,18,8,6,4,23,16,7,30,Q,EU_UC,Anfield,Liverpool
1999/00,35,4,Chelsea,5,36,17,11,8,48,32,16,62,18,11,5,2,31,12,19,38,18,6,6,6,17,20,-3,24,Q,EU_UC,Stamford Bridge,London
1999/00,35,2,Aston Villa,6,36,15,12,9,44,32,12,57,18,8,8,2,23,11,12,32,18,7,4,7,21,21,0,25,Q,EU_IT,Villa Park,Birmingham
1999/00,35,29,Sunderland,7,36,15,10,11,55,53,2,55,18,9,6,3,27,17,10,33,18,6,4,8,28,36,-8,22,,,Stadium of Light,Sunderland
1999/00,35,25,West Ham United,8,36,15,9,12,52,52,0,54,18,11,4,3,32,23,9,37,18,4,5,9,20,29,-9,17,,,Boleyn Ground,London
1999/00,35,26,Leicester City,9,36,15,7,14,52,51,1,52,18,9,3,6,28,24,4,30,18,6,4,8,24,27,-3,22,Q,EU_UC,Filbert Street,Leicester
1999/00,35,21,Tottenham Hotspur,10,36,14,8,14,53,45,8,50,18,9,3,6,37,25,12,30,18,5,5,8,16,20,-4,20,,,White Hart Lane,London
1999/00,35,7,Everton,11,36,12,13,11,58,46,12,49,18,7,9,2,36,19,17,30,18,5,4,9,22,27,-5,19,,,Goodison Park,Liverpool
1999/00,35,23,Newcastle United,12,36,13,9,14,59,52,7,48,18,9,5,4,38,18,20,32,18,4,4,10,21,34,-13,16,,,St. James' Park,Newcastle
1999/00,35,13,Middlesbrough,13,36,13,9,14,43,51,-8,48,18,8,4,6,22,25,-3,28,18,5,5,8,21,26,-5,20,,,Riverside Stadium,Middlesbrough
1999/00,35,5,Coventry City,14,36,11,8,17,43,52,-9,41,18,11,1,6,34,21,13,34,18,0,7,11,9,31,-22,7,,,Highfield Road,Coventry
1999/00,35,20,Southampton,15,36,11,7,18,43,62,-19,40,18,7,4,7,24,22,2,25,18,4,3,11,19,40,-21,15,,,The Dell,Southampton
1999/00,35,28,Derby County,16,36,9,10,17,44,53,-9,37,18,6,2,10,22,25,-3,20,18,3,8,7,22,28,-6,17,,,Pride Park,Derby
1999/00,35,32,Bradford City,17,36,8,9,19,37,65,-28,33,18,5,8,5,25,29,-4,23,18,3,1,14,12,36,-24,10,Q,EU_IT,Valley Parade,Bradford
1999/00,35,22,Wimbledon,18,36,7,11,18,44,70,-26,32,18,6,6,6,28,26,2,24,18,1,5,12,16,44,-28,8,R,EN_D1,Selhurst Park,London
1999/00,35,19,Sheffield Wednesday,19,35,7,6,22,30,63,-33,27,18,5,3,10,17,23,-6,18,17,2,3,12,13,40,-27,9,R,EN_D1,Hillsborough,Sheffield
1999/00,35,33,Watford,20,36,5,5,26,33,76,-43,20,18,4,4,10,23,31,-8,16,18,1,1,16,10,45,-35,4,R,EN_D1,Vicarage Road,Watford
1999/00,36,12,Manchester United,1,37,27,7,3,96,45,51,88,19,15,4,0,59,16,43,49,18,12,3,3,37,29,8,39,Q,EU_CL,Old Trafford,Manchester
1999/00,36,1,Arsenal,2,37,22,7,8,71,39,32,73,19,14,3,2,42,17,25,45,18,8,4,6,29,22,7,28,Q,EU_CL,Highbury,London
1999/00,36,9,Leeds United,3,37,21,5,11,58,43,15,68,19,12,2,5,29,18,11,38,18,9,3,6,29,25,4,30,Q,EU_CL,Elland Road,Leeds
1999/00,36,10,Liverpool,4,37,19,10,8,51,29,22,67,19,11,4,4,28,13,15,37,18,8,6,4,23,16,7,30,Q,EU_UC,Anfield,Liverpool
1999/00,36,4,Chelsea,5,37,17,11,9,49,34,15,62,18,11,5,2,31,12,19,38,19,6,6,7,18,22,-4,24,Q,EU_UC,Stamford Bridge,London
1999/00,36,2,Aston Villa,6,37,15,13,9,46,34,12,58,18,8,8,2,23,11,12,32,19,7,5,7,23,23,0,26,Q,EU_IT,Villa Park,Birmingham
1999/00,36,29,Sunderland,7,37,16,10,11,56,53,3,58,19,10,6,3,28,17,11,36,18,6,4,8,28,36,-8,22,,,Stadium of Light,Sunderland
1999/00,36,26,Leicester City,8,37,16,7,14,55,51,4,55,19,10,3,6,31,24,7,33,18,6,4,8,24,27,-3,22,Q,EU_UC,Filbert Street,Leicester
1999/00,36,25,West Ham United,9,37,15,9,13,52,53,-1,54,18,11,4,3,32,23,9,37,19,4,5,10,20,30,-10,17,,,Boleyn Ground,London
1999/00,36,7,Everton,10,37,12,14,11,59,47,12,50,18,7,9,2,36,19,17,30,19,5,5,9,23,28,-5,20,,,Goodison Park,Liverpool
1999/00,36,21,Tottenham Hotspur,11,37,14,8,15,54,48,6,50,18,9,3,6,37,25,12,30,19,5,5,9,17,23,-6,20,,,White Hart Lane,London
1999/00,36,23,Newcastle United,12,37,13,10,14,59,52,7,49,18,9,5,4,38,18,20,32,19,4,5,10,21,34,-13,17,,,St. James' Park,Newcastle
1999/00,36,13,Middlesbrough,13,37,13,10,14,44,52,-8,49,19,8,5,6,23,26,-3,29,18,5,5,8,21,26,-5,20,,,Riverside Stadium,Middlesbrough
1999/00,36,5,Coventry City,14,37,12,8,17,47,53,-6,44,19,12,1,6,38,22,16,37,18,0,7,11,9,31,-22,7,,,Highfield Road,Coventry
1999/00,36,20,Southampton,15,37,11,8,18,43,62,-19,41,18,7,4,7,24,22,2,25,19,4,4,11,19,40,-21,16,,,The Dell,Southampton
1999/00,36,28,Derby County,16,37,9,11,17,44,53,-9,38,19,6,3,10,22,25,-3,21,18,3,8,7,22,28,-6,17,,,Pride Park,Derby
1999/00,36,22,Wimbledon,17,37,7,12,18,46,72,-26,33,19,6,7,6,30,28,2,25,18,1,5,12,16,44,-28,8,,,Selhurst Park,London
1999/00,36,32,Bradford City,18,37,8,9,20,37,68,-31,33,18,5,8,5,25,29,-4,23,19,3,1,15,12,39,-27,10,"R,Q","EN_D1,EU_IT",Valley Parade,Bradford
1999/00,36,19,Sheffield Wednesday,19,37,7,7,23,34,70,-36,28,18,5,3,10,17,23,-6,18,19,2,4,13,17,47,-30,10,R,EN_D1,Hillsborough,Sheffield
1999/00,36,33,Watford,20,37,5,6,26,34,77,-43,21,18,4,4,10,23,31,-8,16,19,1,2,16,11,46,-35,5,R,EN_D1,Vicarage Road,Watford
1999/00,37,12,Manchester United,1,38,28,7,3,97,45,52,91,19,15,4,0,59,16,43,49,19,13,3,3,38,29,9,42,Q,EU_CL,Old Trafford,Manchester
1999/00,37,1,Arsenal,2,38,22,7,9,73,43,30,73,19,14,3,2,42,17,25,45,19,8,4,7,31,26,5,28,Q,EU_CL,Highbury,London
1999/00,37,9,Leeds United,3,38,21,6,11,58,43,15,69,19,12,2,5,29,18,11,38,19,9,4,6,29,25,4,31,Q,EU_CL,Elland Road,Leeds
1999/00,37,10,Liverpool,4,38,19,10,9,51,30,21,67,19,11,4,4,28,13,15,37,19,8,6,5,23,17,6,30,Q,EU_UC,Anfield,Liverpool
1999/00,37,4,Chelsea,5,38,18,11,9,53,34,19,65,19,12,5,2,35,12,23,41,19,6,6,7,18,22,-4,24,Q,EU_UC,Stamford Bridge,London
1999/00,37,2,Aston Villa,6,38,15,13,10,46,35,11,58,19,8,8,3,23,12,11,32,19,7,5,7,23,23,0,26,Q,EU_IT,Villa Park,Birmingham
1999/00,37,29,Sunderland,7,38,16,10,12,57,56,1,58,19,10,6,3,28,17,11,36,19,6,4,9,29,39,-10,22,,,Stadium of Light,Sunderland
1999/00,37,26,Leicester City,8,38,16,7,15,55,55,0,55,19,10,3,6,31,24,7,33,19,6,4,9,24,31,-7,22,Q,EU_UC,Filbert Street,Leicester
1999/00,37,25,West Ham United,9,38,15,10,13,52,53,-1,55,19,11,5,3,32,23,9,38,19,4,5,10,20,30,-10,17,,,Boleyn Ground,London
1999/00,37,21,Tottenham Hotspur,10,38,15,8,15,57,49,8,53,19,10,3,6,40,26,14,33,19,5,5,9,17,23,-6,20,,,White Hart Lane,London
1999/00,37,23,Newcastle United,11,38,14,10,14,63,54,9,52,19,10,5,4,42,20,22,35,19,4,5,10,21,34,-13,17,,,St. James' Park,Newcastle
1999/00,37,13,Middlesbrough,12,38,14,10,14,46,52,-6,52,19,8,5,6,23,26,-3,29,19,6,5,8,23,26,-3,23,,,Riverside Stadium,Middlesbrough
1999/00,37,7,Everton,13,38,12,14,12,59,49,10,50,19,7,9,3,36,21,15,30,19,5,5,9,23,28,-5,20,,,Goodison Park,Liverpool
1999/00,37,5,Coventry City,14,38,12,8,18,47,54,-7,44,19,12,1,6,38,22,16,37,19,0,7,12,9,32,-23,7,,,Highfield Road,Coventry
1999/00,37,20,Southampton,15,38,12,8,18,45,62,-17,44,19,8,4,7,26,22,4,28,19,4,4,11,19,40,-21,16,,,The Dell,Southampton
1999/00,37,28,Derby County,16,38,9,11,18,44,57,-13,38,19,6,3,10,22,25,-3,21,19,3,8,8,22,32,-10,17,,,Pride Park,Derby
1999/00,37,32,Bradford City,17,38,9,9,20,38,68,-30,36,19,6,8,5,26,29,-3,26,19,3,1,15,12,39,-27,10,Q,EU_IT,Valley Parade,Bradford
1999/00,37,22,Wimbledon,18,38,7,12,19,46,74,-28,33,19,6,7,6,30,28,2,25,19,1,5,13,16,46,-30,8,R,EN_D1,Selhurst Park,London
1999/00,37,19,Sheffield Wednesday,19,38,8,7,23,38,70,-32,31,19,6,3,10,21,23,-2,21,19,2,4,13,17,47,-30,10,R,EN_D1,Hillsborough,Sheffield
1999/00,37,33,Watford,20,38,6,6,26,35,77,-42,24,19,5,4,10,24,31,-7,19,19,1,2,16,11,46,-35,5,R,EN_D1,Vicarage Road,Watford
1999/00,38,12,Manchester United,1,38,28,7,3,97,45,52,91,19,15,4,0,59,16,43,49,19,13,3,3,38,29,9,42,Q,EU_CL,Old Trafford,Manchester
1999/00,38,1,Arsenal,2,38,22,7,9,73,43,30,73,19,14,3,2,42,17,25,45,19,8,4,7,31,26,5,28,Q,EU_CL,Highbury,London
1999/00,38,9,Leeds United,3,38,21,6,11,58,43,15,69,19,12,2,5,29,18,11,38,19,9,4,6,29,25,4,31,Q,EU_CL,Elland Road,Leeds
1999/00,38,10,Liverpool,4,38,19,10,9,51,30,21,67,19,11,4,4,28,13,15,37,19,8,6,5,23,17,6,30,Q,EU_UC,Anfield,Liverpool
1999/00,38,4,Chelsea,5,38,18,11,9,53,34,19,65,19,12,5,2,35,12,23,41,19,6,6,7,18,22,-4,24,Q,EU_UC,Stamford Bridge,London
1999/00,38,2,Aston Villa,6,38,15,13,10,46,35,11,58,19,8,8,3,23,12,11,32,19,7,5,7,23,23,0,26,Q,EU_IT,Villa Park,Birmingham
1999/00,38,29,Sunderland,7,38,16,10,12,57,56,1,58,19,10,6,3,28,17,11,36,19,6,4,9,29,39,-10,22,,,Stadium of Light,Sunderland
1999/00,38,26,Leicester City,8,38,16,7,15,55,55,0,55,19,10,3,6,31,24,7,33,19,6,4,9,24,31,-7,22,Q,EU_UC,Filbert Street,Leicester
1999/00,38,25,West Ham United,9,38,15,10,13,52,53,-1,55,19,11,5,3,32,23,9,38,19,4,5,10,20,30,-10,17,,,Boleyn Ground,London
1999/00,38,21,Tottenham Hotspur,10,38,15,8,15,57,49,8,53,19,10,3,6,40,26,14,33,19,5,5,9,17,23,-6,20,,,White Hart Lane,London
1999/00,38,23,Newcastle United,11,38,14,10,14,63,54,9,52,19,10,5,4,42,20,22,35,19,4,5,10,21,34,-13,17,,,St. James' Park,Newcastle
1999/00,38,13,Middlesbrough,12,38,14,10,14,46,52,-6,52,19,8,5,6,23,26,-3,29,19,6,5,8,23,26,-3,23,,,Riverside Stadium,Middlesbrough
1999/00,38,7,Everton,13,38,12,14,12,59,49,10,50,19,7,9,3,36,21,15,30,19,5,5,9,23,28,-5,20,,,Goodison Park,Liverpool
1999/00,38,5,Coventry City,14,38,12,8,18,47,54,-7,44,19,12,1,6,38,22,16,37,19,0,7,12,9,32,-23,7,,,Highfield Road,Coventry
1999/00,38,20,Southampton,15,38,12,8,18,45,62,-17,44,19,8,4,7,26,22,4,28,19,4,4,11,19,40,-21,16,,,The Dell,Southampton
1999/00,38,28,Derby County,16,38,9,11,18,44,57,-13,38,19,6,3,10,22,25,-3,21,19,3,8,8,22,32,-10,17,,,Pride Park,Derby
1999/00,38,32,Bradford City,17,38,9,9,20,38,68,-30,36,19,6,8,5,26,29,-3,26,19,3,1,15,12,39,-27,10,Q,EU_IT,Valley Parade,Bradford
1999/00,38,22,Wimbledon,18,38,7,12,19,46,74,-28,33,19,6,7,6,30,28,2,25,19,1,5,13,16,46,-30,8,R,EN_D1,Selhurst Park,London
1999/00,38,19,Sheffield Wednesday,19,38,8,7,23,38,70,-32,31,19,6,3,10,21,23,-2,21,19,2,4,13,17,47,-30,10,R,EN_D1,Hillsborough,Sheffield
1999/00,38,33,Watford,20,38,6,6,26,35,77,-42,24,19,5,4,10,24,31,-7,19,19,1,2,16,11,46,-35,5,R,EN_D1,Vicarage Road,Watford
