season,match_week,team_id,team_name,position,played,won,drawn,lost,goals_for,goals_against,goal_difference,points,home_played,home_won,home_drawn,home_lost,home_goals_for,home_goals_against,home_goal_difference,home_points,away_played,away_won,away_drawn,away_lost,away_goals_for,away_goals_against,away_goal_difference,away_points,annotation_types,annotation_destinations,stadium_name,stadium_city
2000/01,1,13,Middlesbrough,1,2,1,1,0,4,2,2,4,1,0,1,0,1,1,0,1,1,1,0,0,3,1,2,3,Q,EU_CL,Riverside Stadium,Middlesbrough
2000/01,1,21,Tottenham Hotspur,2,2,1,1,0,4,2,2,4,1,1,0,0,3,1,2,3,1,0,1,0,1,1,0,1,Q,EU_CL,White Hart Lane,London
2000/01,1,12,Manchester United,3,2,1,1,0,3,1,2,4,1,1,0,0,2,0,2,3,1,0,1,0,1,1,0,1,Q,EU_CL,Old Trafford,Manchester
2000/01,1,26,Leicester City,4,2,1,1,0,1,0,1,4,1,0,1,0,0,0,0,1,1,1,0,0,1,0,1,3,Q,EU_UC,Filbert Street,Leicester
2000/01,1,9,Leeds United,5,1,1,0,0,2,0,2,3,1,1,0,0,2,0,2,3,0,0,0,0,0,0,0,0,Q,EU_UC,Elland Road,Leeds
2000/01,1,31,Charlton Athletic,6,2,1,0,1,4,3,1,3,1,1,0,0,4,0,4,3,1,0,0,1,0,3,-3,0,Q,EU_UC,The Valley,London
2000/01,1,7,Everton,7,2,1,0,1,3,2,1,3,1,1,0,0,3,0,3,3,1,0,0,1,0,2,-2,0,,,Goodison Park,Liverpool
2000/01,1,1,Arsenal,8,2,1,0,1,2,1,1,3,1,1,0,0,2,0,2,3,1,0,0,1,0,1,-1,0,,,Highbury,London
2000/01,1,32,Bradford City,9,2,1,0,1,2,1,1,3,1,1,0,0,2,0,2,3,1,0,0,1,0,1,-1,0,,,Valley Parade,Bradford
2000/01,1,4,Chelsea,10,2,1,0,1,4,4,0,3,1,1,0,0,4,2,2,3,1,0,0,1,0,2,-2,0,,,Stamford Bridge,London
2000/01,1,5,Coventry City,11,2,1,0,1,3,4,-1,3,1,0,0,1,1,3,-2,0,1,1,0,0,2,1,1,3,,,Highfield Road,Coventry
2000/01,1,23,Newcastle United,12,2,1,0,1,3,4,-1,3,1,1,0,0,3,2,1,3,1,0,0,1,0,2,-2,0,Q,EU_IT,St. James' Park,Newcastle
2000/01,1,29,Sunderland,13,2,1,0,1,3,4,-1,3,1,1,0,0,1,0,1,3,1,0,0,1,2,4,-2,0,,,Stadium of Light,Sunderland
2000/01,1,10,Liverpool,14,2,1,0,1,1,2,-1,3,1,1,0,0,1,0,1,3,1,0,0,1,0,2,-2,0,,,Anfield,Liverpool
2000/01,1,11,Manchester City,15,2,1,0,1,4,6,-2,3,1,1,0,0,4,2,2,3,1,0,0,1,0,4,-4,0,,,Maine Road,Manchester
2000/01,1,2,Aston Villa,16,1,0,1,0,0,0,0,1,0,0,0,0,0,0,0,0,1,0,1,0,0,0,0,1,Q,EU_IT,Villa Park,Birmingham
2000/01,1,28,Derby County,17,2,0,1,1,4,5,-1,1,1,0,1,0,2,2,0,1,1,0,0,1,2,3,-1,0,,,Pride Park,Derby
2000/01,1,20,Southampton,18,2,0,1,1,3,4,-1,1,1,0,0,1,1,2,-1,0,1,0,1,0,2,2,0,1,R,EN_D1,The Dell,Southampton
2000/01,1,8,Ipswich Town,19,2,0,1,1,2,4,-2,1,1,0,1,0,1,1,0,1,1,0,0,1,1,3,-2,0,R,EN_D1,Portman Road,Ipswich
2000/01,1,25,West Ham United,20,2,0,0,2,2,5,-3,0,1,0,0,1,0,1,-1,0,1,0,0,1,2,4,-2,0,R,EN_D1,Boleyn Ground,London
2000/01,2,1,Arsenal,1,3,2,0,1,7,4,3,6,2,2,0,0,7,3,4,6,1,0,0,1,0,1,-1,0,Q,EU_CL,Highbury,London
2000/01,2,9,Leeds United,2,2,2,0,0,4,1,3,6,1,1,0,0,2,0,2,3,1,1,0,0,2,1,1,3,Q,EU_CL,Elland Road,Leeds
2000/01,2,23,Newcastle United,3,3,2,0,1,5,4,1,6,2,2,0,0,5,2,3,6,1,0,0,1,0,2,-2,0,"Q,Q","EU_CL,EU_IT",St. James' Park,Newcastle
2000/01,2,5,Coventry City,4,3,2,0,1,5,5,0,6,1,0,0,1,1,3,-2,0,2,2,0,0,4,2,2,6,Q,EU_UC,Highfield Road,Coventry
2000/01,2,12,Manchester United,5,3,1,2,0,5,3,2,5,1,1,0,0,2,0,2,3,2,0,2,0,3,3,0,2,Q,EU_UC,Old Trafford,Manchester
2000/01,2,26,Leicester City,6,3,1,2,0,1,0,1,5,1,0,1,0,0,0,0,1,2,1,1,0,1,0,1,4,Q,EU_UC,Filbert Street,Leicester
2000/01,2,7,Everton,7,3,1,1,1,5,4,1,4,2,1,1,0,5,2,3,4,1,0,0,1,0,2,-2,0,,,Goodison Park,Liverpool
2000/01,2,13,Middlesbrough,8,3,1,1,1,5,4,1,4,2,0,1,1,2,3,-1,1,1,1,0,0,3,1,2,3,,,Riverside Stadium,Middlesbrough
2000/01,2,32,Bradford City,9,3,1,1,1,2,1,1,4,2,1,1,0,2,0,2,4,1,0,0,1,0,1,-1,0,,,Valley Parade,Bradford
2000/01,2,4,Chelsea,10,3,1,1,1,5,5,0,4,1,1,0,0,4,2,2,3,2,0,1,1,1,3,-2,1,,,Stamford Bridge,London
2000/01,2,21,Tottenham Hotspur,11,3,1,1,1,4,4,0,4,1,1,0,0,3,1,2,3,2,0,1,1,1,3,-2,1,,,White Hart Lane,London
2000/01,2,10,Liverpool,12,3,1,1,1,4,5,-1,4,1,1,0,0,1,0,1,3,2,0,1,1,3,5,-2,1,,,Anfield,Liverpool
2000/01,2,8,Ipswich Town,13,3,1,1,1,3,4,-1,4,2,1,1,0,2,1,1,4,1,0,0,1,1,3,-2,0,,,Portman Road,Ipswich
2000/01,2,31,Charlton Athletic,14,3,1,0,2,7,8,-1,3,1,1,0,0,4,0,4,3,2,0,0,2,3,8,-5,0,,,The Valley,London
2000/01,2,29,Sunderland,15,3,1,0,2,3,5,-2,3,1,1,0,0,1,0,1,3,2,0,0,2,2,5,-3,0,,,Stadium of Light,Sunderland
2000/01,2,11,Manchester City,16,3,1,0,2,5,8,-3,3,2,1,0,1,5,4,1,3,1,0,0,1,0,4,-4,0,,,Maine Road,Manchester
2000/01,2,2,Aston Villa,17,2,0,2,0,1,1,0,2,1,0,1,0,1,1,0,1,1,0,1,0,0,0,0,1,Q,EU_IT,Villa Park,Birmingham
2000/01,2,28,Derby County,18,3,0,2,1,6,7,-1,2,1,0,1,0,2,2,0,1,2,0,1,1,4,5,-1,1,R,EN_D1,Pride Park,Derby
2000/01,2,20,Southampton,19,3,0,2,1,6,7,-1,2,2,0,1,1,4,5,-1,1,1,0,1,0,2,2,0,1,R,EN_D1,The Dell,Southampton
2000/01,2,25,West Ham United,20,3,0,1,2,4,7,-3,1,2,0,1,1,2,3,-1,1,1,0,0,1,2,4,-2,0,R,EN_D1,Boleyn Ground,London
2000/01,3,23,Newcastle United,1,4,3,0,1,7,4,3,9,2,2,0,0,5,2,3,6,2,1,0,1,2,2,0,3,"Q,Q","EU_CL,EU_IT",St. James' Park,Newcastle
2000/01,3,12,Manchester United,2,4,2,2,0,11,3,8,8,2,2,0,0,8,0,8,6,2,0,2,0,3,3,0,2,Q,EU_CL,Old Trafford,Manchester
2000/01,3,26,Leicester City,3,4,2,2,0,3,1,2,8,2,1,1,0,2,1,1,4,2,1,1,0,1,0,1,4,Q,EU_CL,Filbert Street,Leicester
2000/01,3,1,Arsenal,4,4,2,1,1,9,6,3,7,2,2,0,0,7,3,4,6,2,0,1,1,2,3,-1,1,Q,EU_UC,Highbury,London
2000/01,3,10,Liverpool,5,4,2,1,1,7,6,1,7,2,2,0,0,4,1,3,6,2,0,1,1,3,5,-2,1,Q,EU_UC,Anfield,Liverpool
2000/01,3,21,Tottenham Hotspur,6,4,2,1,1,7,6,1,7,2,2,0,0,6,3,3,6,2,0,1,1,1,3,-2,1,Q,EU_UC,White Hart Lane,London
2000/01,3,9,Leeds United,7,3,2,0,1,5,3,2,6,2,1,0,1,3,2,1,3,1,1,0,0,2,1,1,3,,,Elland Road,Leeds
2000/01,3,11,Manchester City,8,4,2,0,2,7,9,-2,6,2,1,0,1,5,4,1,3,2,1,0,1,2,5,-3,3,,,Maine Road,Manchester
2000/01,3,5,Coventry City,9,4,2,0,2,5,7,-2,6,2,0,0,2,1,5,-4,0,2,2,0,0,4,2,2,6,,,Highfield Road,Coventry
2000/01,3,13,Middlesbrough,10,4,1,2,1,8,7,1,5,2,0,1,1,2,3,-1,1,2,1,1,0,6,4,2,4,,,Riverside Stadium,Middlesbrough
2000/01,3,4,Chelsea,11,4,1,2,1,7,7,0,5,2,1,1,0,6,4,2,4,2,0,1,1,1,3,-2,1,,,Stamford Bridge,London
2000/01,3,7,Everton,12,4,1,1,2,7,7,0,4,2,1,1,0,5,2,3,4,2,0,0,2,2,5,-3,0,,,Goodison Park,Liverpool
2000/01,3,31,Charlton Athletic,13,4,1,1,2,8,9,-1,4,2,1,1,0,5,1,4,4,2,0,0,2,3,8,-5,0,,,The Valley,London
2000/01,3,8,Ipswich Town,14,4,1,1,2,4,6,-2,4,2,1,1,0,2,1,1,4,2,0,0,2,2,5,-3,0,,,Portman Road,Ipswich
2000/01,3,29,Sunderland,15,4,1,1,2,4,6,-2,4,2,1,1,0,2,1,1,4,2,0,0,2,2,5,-3,0,,,Stadium of Light,Sunderland
2000/01,3,32,Bradford City,16,4,1,1,2,2,7,-5,4,2,1,1,0,2,0,2,4,2,0,0,2,0,7,-7,0,,,Valley Parade,Bradford
2000/01,3,28,Derby County,17,4,0,3,1,9,10,-1,3,2,0,2,0,5,5,0,2,2,0,1,1,4,5,-1,1,,,Pride Park,Derby
2000/01,3,20,Southampton,18,4,0,3,1,7,8,-1,3,2,0,1,1,4,5,-1,1,2,0,2,0,3,3,0,2,R,EN_D1,The Dell,Southampton
2000/01,3,2,Aston Villa,19,3,0,2,1,2,4,-2,2,1,0,1,0,1,1,0,1,2,0,1,1,1,3,-2,1,"R,Q","EN_D1,EU_IT",Villa Park,Birmingham
2000/01,3,25,West Ham United,20,4,0,2,2,5,8,-3,2,2,0,1,1,2,3,-1,1,2,0,1,1,3,5,-2,1,R,EN_D1,Boleyn Ground,London
2000/01,4,12,Manchester United,1,5,3,2,0,14,3,11,11,3,3,0,0,11,0,11,9,2,0,2,0,3,3,0,2,Q,EU_CL,Old Trafford,Manchester
2000/01,4,26,Leicester City,2,5,3,2,0,4,1,3,11,3,2,1,0,3,1,2,7,2,1,1,0,1,0,1,4,Q,EU_CL,Filbert Street,Leicester
2000/01,4,23,Newcastle United,3,5,3,1,1,7,4,3,10,3,2,1,0,5,2,3,7,2,1,0,1,2,2,0,3,"Q,Q","EU_CL,EU_IT",St. James' Park,Newcastle
2000/01,4,10,Liverpool,4,5,3,1,1,10,8,2,10,3,3,0,0,7,3,4,9,2,0,1,1,3,5,-2,1,Q,EU_UC,Anfield,Liverpool
2000/01,4,21,Tottenham Hotspur,5,5,3,1,1,8,6,2,10,3,3,0,0,7,3,4,9,2,0,1,1,1,3,-2,1,Q,EU_UC,White Hart Lane,London
2000/01,4,1,Arsenal,6,5,2,2,1,10,7,3,8,2,2,0,0,7,3,4,6,3,0,2,1,3,4,-1,2,Q,EU_UC,Highbury,London
2000/01,4,9,Leeds United,7,4,2,1,1,5,3,2,7,2,1,0,1,3,2,1,3,2,1,1,0,2,1,1,4,,,Elland Road,Leeds
2000/01,4,7,Everton,8,5,2,1,2,9,8,1,7,2,1,1,0,5,2,3,4,3,1,0,2,4,6,-2,3,,,Goodison Park,Liverpool
2000/01,4,5,Coventry City,9,5,2,1,2,5,7,-2,7,3,0,1,2,1,5,-4,1,2,2,0,0,4,2,2,6,,,Highfield Road,Coventry
2000/01,4,4,Chelsea,10,5,1,3,1,7,7,0,6,2,1,1,0,6,4,2,4,3,0,2,1,1,3,-2,2,,,Stamford Bridge,London
2000/01,4,11,Manchester City,11,5,2,0,3,9,12,-3,6,2,1,0,1,5,4,1,3,3,1,0,2,4,8,-4,3,,,Maine Road,Manchester
2000/01,4,13,Middlesbrough,12,5,1,2,2,9,9,0,5,3,0,1,2,3,5,-2,1,2,1,1,0,6,4,2,4,,,Riverside Stadium,Middlesbrough
2000/01,4,31,Charlton Athletic,13,5,1,2,2,10,11,-1,5,2,1,1,0,5,1,4,4,3,0,1,2,5,10,-5,1,,,The Valley,London
2000/01,4,2,Aston Villa,14,4,1,2,1,4,5,-1,5,1,0,1,0,1,1,0,1,3,1,1,1,3,4,-1,4,Q,EU_IT,Villa Park,Birmingham
2000/01,4,32,Bradford City,15,5,1,2,2,3,8,-5,5,3,1,2,0,3,1,2,5,2,0,0,2,0,7,-7,0,,,Valley Parade,Bradford
2000/01,4,28,Derby County,16,5,0,4,1,11,12,-1,4,3,0,3,0,7,7,0,3,2,0,1,1,4,5,-1,1,,,Pride Park,Derby
2000/01,4,8,Ipswich Town,17,5,1,1,3,5,8,-3,4,3,1,1,1,3,3,0,4,2,0,0,2,2,5,-3,0,,,Portman Road,Ipswich
2000/01,4,29,Sunderland,18,5,1,1,3,4,9,-5,4,2,1,1,0,2,1,1,4,3,0,0,3,2,8,-6,0,R,EN_D1,Stadium of Light,Sunderland
2000/01,4,20,Southampton,19,5,0,3,2,7,9,-2,3,2,0,1,1,4,5,-1,1,3,0,2,1,3,4,-1,2,R,EN_D1,The Dell,Southampton
2000/01,4,25,West Ham United,20,5,0,2,3,5,9,-4,2,2,0,1,1,2,3,-1,1,3,0,1,2,3,6,-3,1,R,EN_D1,Boleyn Ground,London
2000/01,5,12,Manchester United,1,6,4,2,0,17,4,13,14,3,3,0,0,11,0,11,9,3,1,2,0,6,4,2,5,Q,EU_CL,Old Trafford,Manchester
2000/01,5,26,Leicester City,2,6,4,2,0,6,1,5,14,3,2,1,0,3,1,2,7,3,2,1,0,3,0,3,7,Q,EU_CL,Filbert Street,Leicester
2000/01,5,1,Arsenal,3,6,3,2,1,12,8,4,11,3,3,0,0,9,4,5,9,3,0,2,1,3,4,-1,2,Q,EU_CL,Highbury,London
2000/01,5,10,Liverpool,4,6,3,2,1,11,9,2,11,3,3,0,0,7,3,4,9,3,0,2,1,4,6,-2,2,Q,EU_UC,Anfield,Liverpool
2000/01,5,21,Tottenham Hotspur,5,6,3,1,2,8,7,1,10,3,3,0,0,7,3,4,9,3,0,1,2,1,4,-3,1,Q,EU_UC,White Hart Lane,London
2000/01,5,23,Newcastle United,6,6,3,1,2,7,6,1,10,3,2,1,0,5,2,3,7,3,1,0,2,2,4,-2,3,"Q,Q","EU_UC,EU_IT",St. James' Park,Newcastle
2000/01,5,2,Aston Villa,7,5,2,2,1,6,5,1,8,2,1,1,0,3,1,2,4,3,1,1,1,3,4,-1,4,Q,EU_IT,Villa Park,Birmingham
2000/01,5,31,Charlton Athletic,8,6,2,2,2,11,11,0,8,3,2,1,0,6,1,5,7,3,0,1,2,5,10,-5,1,,,The Valley,London
2000/01,5,9,Leeds United,9,5,2,1,2,6,5,1,7,3,1,0,2,4,4,0,3,2,1,1,0,2,1,1,4,,,Elland Road,Leeds
2000/01,5,7,Everton,10,6,2,1,3,10,11,-1,7,3,1,1,1,6,5,1,4,3,1,0,2,4,6,-2,3,,,Goodison Park,Liverpool
2000/01,5,8,Ipswich Town,11,6,2,1,3,7,9,-2,7,3,1,1,1,3,3,0,4,3,1,0,2,4,6,-2,3,,,Portman Road,Ipswich
2000/01,5,11,Manchester City,12,6,2,1,3,10,13,-3,7,3,1,1,1,6,5,1,4,3,1,0,2,4,8,-4,3,,,Maine Road,Manchester
2000/01,5,5,Coventry City,13,6,2,1,3,6,9,-3,7,3,0,1,2,1,5,-4,1,3,2,0,1,5,4,1,6,,,Highfield Road,Coventry
2000/01,5,29,Sunderland,14,6,2,1,3,6,10,-4,7,3,2,1,0,4,2,2,7,3,0,0,3,2,8,-6,0,,,Stadium of Light,Sunderland
2000/01,5,13,Middlesbrough,15,6,1,3,2,10,10,0,6,3,0,1,2,3,5,-2,1,3,1,2,0,7,5,2,5,,,Riverside Stadium,Middlesbrough
2000/01,5,20,Southampton,16,6,1,3,2,9,9,0,6,3,1,1,1,6,5,1,4,3,0,2,1,3,4,-1,2,,,The Dell,Southampton
2000/01,5,4,Chelsea,17,6,1,3,2,7,9,-2,6,3,1,1,1,6,6,0,4,3,0,2,1,1,3,-2,2,,,Stamford Bridge,London
2000/01,5,32,Bradford City,18,6,1,2,3,3,10,-7,5,3,1,2,0,3,1,2,5,3,0,0,3,0,9,-9,0,R,EN_D1,Valley Parade,Bradford
2000/01,5,28,Derby County,19,6,0,4,2,12,14,-2,4,3,0,3,0,7,7,0,3,3,0,1,2,5,7,-2,1,R,EN_D1,Pride Park,Derby
2000/01,5,25,West Ham United,20,6,0,3,3,6,10,-4,3,3,0,2,1,3,4,-1,2,3,0,1,2,3,6,-3,1,R,EN_D1,Boleyn Ground,London
2000/01,6,12,Manchester United,1,7,4,3,0,20,7,13,15,4,3,1,0,14,3,11,10,3,1,2,0,6,4,2,5,Q,EU_CL,Old Trafford,Manchester
2000/01,6,26,Leicester City,2,7,4,3,0,7,2,5,15,4,2,2,0,4,2,2,8,3,2,1,0,3,0,3,7,Q,EU_CL,Filbert Street,Leicester
2000/01,6,1,Arsenal,3,7,3,3,1,13,9,4,12,3,3,0,0,9,4,5,9,4,0,3,1,4,5,-1,3,Q,EU_CL,Highbury,London
2000/01,6,10,Liverpool,4,7,3,3,1,12,10,2,12,4,3,1,0,8,4,4,10,3,0,2,1,4,6,-2,2,Q,EU_UC,Anfield,Liverpool
2000/01,6,31,Charlton Athletic,5,7,3,2,2,12,11,1,11,3,2,1,0,6,1,5,7,4,1,1,2,6,10,-4,4,Q,EU_UC,The Valley,London
2000/01,6,21,Tottenham Hotspur,6,7,3,2,2,8,7,1,11,4,3,1,0,7,3,4,10,3,0,1,2,1,4,-3,1,Q,EU_UC,White Hart Lane,London
2000/01,6,23,Newcastle United,7,7,3,1,3,7,7,0,10,4,2,1,1,5,3,2,7,3,1,0,2,2,4,-2,3,Q,EU_IT,St. James' Park,Newcastle
2000/01,6,20,Southampton,8,7,2,3,2,10,9,1,9,3,1,1,1,6,5,1,4,4,1,2,1,4,4,0,5,,,The Dell,Southampton
2000/01,6,2,Aston Villa,9,6,2,3,1,7,6,1,9,2,1,1,0,3,1,2,4,4,1,2,1,4,5,-1,5,Q,EU_IT,Villa Park,Birmingham
2000/01,6,9,Leeds United,10,6,2,2,2,7,6,1,8,3,1,0,2,4,4,0,3,3,1,2,0,3,2,1,5,,,Elland Road,Leeds
2000/01,6,7,Everton,11,7,2,2,3,11,12,-1,8,3,1,1,1,6,5,1,4,4,1,1,2,5,7,-2,4,,,Goodison Park,Liverpool
2000/01,6,8,Ipswich Town,12,7,2,2,3,8,10,-2,8,4,1,2,1,4,4,0,5,3,1,0,2,4,6,-2,3,,,Portman Road,Ipswich
2000/01,6,11,Manchester City,13,7,2,2,3,10,13,-3,8,3,1,1,1,6,5,1,4,4,1,1,2,4,8,-4,4,,,Maine Road,Manchester
2000/01,6,29,Sunderland,14,7,2,2,3,7,11,-4,8,3,2,1,0,4,2,2,7,4,0,1,3,3,9,-6,1,,,Stadium of Light,Sunderland
2000/01,6,13,Middlesbrough,15,7,1,4,2,11,11,0,7,4,0,2,2,4,6,-2,2,3,1,2,0,7,5,2,5,,,Riverside Stadium,Middlesbrough
2000/01,6,4,Chelsea,16,7,1,4,2,10,12,-2,7,3,1,1,1,6,6,0,4,4,0,3,1,4,6,-2,3,,,Stamford Bridge,London
2000/01,6,5,Coventry City,17,7,2,1,4,6,12,-6,7,4,0,1,3,1,8,-7,1,3,2,0,1,5,4,1,6,,,Highfield Road,Coventry
2000/01,6,25,West Ham United,18,7,1,3,3,9,10,-1,6,3,0,2,1,3,4,-1,2,4,1,1,2,6,6,0,4,R,EN_D1,Boleyn Ground,London
2000/01,6,28,Derby County,19,7,0,5,2,13,15,-2,5,4,0,4,0,8,8,0,4,3,0,1,2,5,7,-2,1,R,EN_D1,Pride Park,Derby
2000/01,6,32,Bradford City,20,7,1,2,4,3,11,-8,5,4,1,2,1,3,2,1,5,3,0,0,3,0,9,-9,0,R,EN_D1,Valley Parade,Bradford
2000/01,7,26,Leicester City,1,8,4,4,0,7,2,5,16,4,2,2,0,4,2,2,8,4,2,2,0,3,0,3,8,Q,EU_CL,Filbert Street,Leicester
2000/01,7,12,Manchester United,2,8,4,3,1,20,8,12,15,4,3,1,0,14,3,11,10,4,1,2,1,6,5,1,5,Q,EU_CL,Old Trafford,Manchester
2000/01,7,1,Arsenal,3,8,4,3,1,14,9,5,15,4,4,0,0,10,4,6,12,4,0,3,1,4,5,-1,3,Q,EU_CL,Highbury,London
2000/01,7,23,Newcastle United,4,8,4,1,3,8,7,1,13,4,2,1,1,5,3,2,7,4,2,0,2,3,4,-1,6,"Q,Q","EU_UC,EU_IT",St. James' Park,Newcastle
2000/01,7,2,Aston Villa,5,7,3,3,1,11,7,4,12,3,2,1,0,7,2,5,7,4,1,2,1,4,5,-1,5,"Q,Q","EU_UC,EU_IT",Villa Park,Birmingham
2000/01,7,31,Charlton Athletic,6,8,3,3,2,14,13,1,12,4,2,2,0,8,3,5,8,4,1,1,2,6,10,-4,4,Q,EU_UC,The Valley,London
2000/01,7,10,Liverpool,7,8,3,3,2,12,13,-1,12,4,3,1,0,8,4,4,10,4,0,2,2,4,9,-5,2,,,Anfield,Liverpool
2000/01,7,9,Leeds United,8,7,3,2,2,11,9,2,11,4,2,0,2,8,7,1,6,3,1,2,0,3,2,1,5,,,Elland Road,Leeds
2000/01,7,8,Ipswich Town,9,8,3,2,3,11,10,1,11,4,1,2,1,4,4,0,5,4,2,0,2,7,6,1,6,,,Portman Road,Ipswich
2000/01,7,21,Tottenham Hotspur,10,8,3,2,3,11,11,0,11,4,3,1,0,7,3,4,10,4,0,1,3,4,8,-4,1,,,White Hart Lane,London
2000/01,7,13,Middlesbrough,11,8,2,4,2,14,12,2,10,4,0,2,2,4,6,-2,2,4,2,2,0,10,6,4,8,,,Riverside Stadium,Middlesbrough
2000/01,7,4,Chelsea,12,8,2,4,2,13,12,1,10,4,2,1,1,9,6,3,7,4,0,3,1,4,6,-2,3,,,Stamford Bridge,London
2000/01,7,20,Southampton,13,8,2,3,3,11,12,-1,9,4,1,1,2,7,8,-1,4,4,1,2,1,4,4,0,5,,,The Dell,Southampton
2000/01,7,29,Sunderland,14,8,2,3,3,7,11,-4,9,4,2,2,0,4,2,2,8,4,0,1,3,3,9,-6,1,,,Stadium of Light,Sunderland
2000/01,7,7,Everton,15,8,2,2,4,11,15,-4,8,4,1,1,2,6,8,-2,4,4,1,1,2,5,7,-2,4,,,Goodison Park,Liverpool
2000/01,7,11,Manchester City,16,8,2,2,4,10,14,-4,8,4,1,1,2,6,6,0,4,4,1,1,2,4,8,-4,4,,,Maine Road,Manchester
2000/01,7,5,Coventry City,17,8,2,2,4,8,14,-6,8,4,0,1,3,1,8,-7,1,4,2,1,1,7,6,1,7,,,Highfield Road,Coventry
2000/01,7,25,West Ham United,18,8,1,4,3,10,11,-1,7,4,0,3,1,4,5,-1,3,4,1,1,2,6,6,0,4,R,EN_D1,Boleyn Ground,London
2000/01,7,32,Bradford City,19,8,1,3,4,4,12,-8,6,4,1,2,1,3,2,1,5,4,0,1,3,1,10,-9,1,R,EN_D1,Valley Parade,Bradford
2000/01,7,28,Derby County,20,8,0,5,3,14,19,-5,5,4,0,4,0,8,8,0,4,4,0,1,3,6,11,-5,1,R,EN_D1,Pride Park,Derby
2000/01,8,12,Manchester United,1,9,5,3,1,23,8,15,18,4,3,1,0,14,3,11,10,5,2,2,1,9,5,4,8,Q,EU_CL,Old Trafford,Manchester
2000/01,8,1,Arsenal,2,9,5,3,1,15,9,6,18,5,5,0,0,11,4,7,15,4,0,3,1,4,5,-1,3,Q,EU_CL,Highbury,London
2000/01,8,23,Newcastle United,3,9,5,1,3,11,8,3,16,4,2,1,1,5,3,2,7,5,3,0,2,6,5,1,9,"Q,Q","EU_CL,EU_IT",St. James' Park,Newcastle
2000/01,8,26,Leicester City,4,9,4,4,1,7,5,2,16,5,2,2,1,4,5,-1,8,4,2,2,0,3,0,3,8,Q,EU_UC,Filbert Street,Leicester
2000/01,8,10,Liverpool,5,9,4,3,2,16,13,3,15,4,3,1,0,8,4,4,10,5,1,2,2,8,9,-1,5,Q,EU_UC,Anfield,Liverpool
2000/01,8,9,Leeds United,6,8,4,2,2,14,10,4,14,5,3,0,2,11,8,3,9,3,1,2,0,3,2,1,5,Q,EU_UC,Elland Road,Leeds
2000/01,8,2,Aston Villa,7,8,3,3,2,11,8,3,12,3,2,1,0,7,2,5,7,5,1,2,2,4,6,-2,5,Q,EU_IT,Villa Park,Birmingham
2000/01,8,8,Ipswich Town,8,9,3,3,3,12,11,1,12,5,1,3,1,5,5,0,6,4,2,0,2,7,6,1,6,,,Portman Road,Ipswich
2000/01,8,31,Charlton Athletic,9,9,3,3,3,15,16,-1,12,4,2,2,0,8,3,5,8,5,1,1,3,7,13,-6,4,,,The Valley,London
2000/01,8,29,Sunderland,10,9,3,3,3,8,11,-3,12,5,3,2,0,5,2,3,11,4,0,1,3,3,9,-6,1,,,Stadium of Light,Sunderland
2000/01,8,21,Tottenham Hotspur,11,9,3,2,4,12,13,-1,11,4,3,1,0,7,3,4,10,5,0,1,4,5,10,-5,1,,,White Hart Lane,London
2000/01,8,11,Manchester City,12,9,3,2,4,12,14,-2,11,5,2,1,2,8,6,2,7,4,1,1,2,4,8,-4,4,,,Maine Road,Manchester
2000/01,8,5,Coventry City,13,9,3,2,4,10,15,-5,11,5,1,1,3,3,9,-6,4,4,2,1,1,7,6,1,7,,,Highfield Road,Coventry
2000/01,8,13,Middlesbrough,14,9,2,4,3,15,15,0,10,5,0,2,3,5,9,-4,2,4,2,2,0,10,6,4,8,,,Riverside Stadium,Middlesbrough
2000/01,8,4,Chelsea,15,9,2,4,3,13,13,0,10,4,2,1,1,9,6,3,7,5,0,3,2,4,7,-3,3,,,Stamford Bridge,London
2000/01,8,20,Southampton,16,9,2,4,3,12,13,-1,10,4,1,1,2,7,8,-1,4,5,1,3,1,5,5,0,6,,,The Dell,Southampton
2000/01,8,7,Everton,17,9,2,3,4,12,16,-4,9,5,1,2,2,7,9,-2,5,4,1,1,2,5,7,-2,4,,,Goodison Park,Liverpool
2000/01,8,25,West Ham United,18,9,1,5,3,11,12,-1,8,4,0,3,1,4,5,-1,3,5,1,2,2,7,7,0,5,R,EN_D1,Boleyn Ground,London
2000/01,8,32,Bradford City,19,9,1,3,5,4,14,-10,6,4,1,2,1,3,2,1,5,5,0,1,4,1,12,-11,1,R,EN_D1,Valley Parade,Bradford
2000/01,8,28,Derby County,20,9,0,5,4,14,23,-9,5,5,0,4,1,8,12,-4,4,4,0,1,3,6,11,-5,1,R,EN_D1,Pride Park,Derby
2000/01,9,12,Manchester United,1,10,6,3,1,26,8,18,21,5,4,1,0,17,3,14,13,5,2,2,1,9,5,4,8,Q,EU_CL,Old Trafford,Manchester
2000/01,9,1,Arsenal,2,10,6,3,1,17,10,7,21,5,5,0,0,11,4,7,15,5,1,3,1,6,6,0,6,Q,EU_CL,Highbury,London
2000/01,9,10,Liverpool,3,10,5,3,2,17,13,4,18,5,4,1,0,9,4,5,13,5,1,2,2,8,9,-1,5,Q,EU_CL,Anfield,Liverpool
2000/01,9,23,Newcastle United,4,10,5,1,4,11,9,2,16,5,2,1,2,5,4,1,7,5,3,0,2,6,5,1,9,"Q,Q","EU_UC,EU_IT",St. James' Park,Newcastle
2000/01,9,26,Leicester City,5,10,4,4,2,7,6,1,16,5,2,2,1,4,5,-1,8,5,2,2,1,3,1,2,8,Q,EU_UC,Filbert Street,Leicester
2000/01,9,8,Ipswich Town,6,10,4,3,3,14,11,3,15,5,1,3,1,5,5,0,6,5,3,0,2,9,6,3,9,Q,EU_UC,Portman Road,Ipswich
2000/01,9,31,Charlton Athletic,7,10,4,3,3,16,16,0,15,5,3,2,0,9,3,6,11,5,1,1,3,7,13,-6,4,,,The Valley,London
2000/01,9,21,Tottenham Hotspur,8,10,4,2,4,15,14,1,14,5,4,1,0,10,4,6,13,5,0,1,4,5,10,-5,1,,,White Hart Lane,London
2000/01,9,9,Leeds United,9,9,4,2,3,14,13,1,14,5,3,0,2,11,8,3,9,4,1,2,1,3,5,-2,5,,,Elland Road,Leeds
2000/01,9,11,Manchester City,10,10,4,2,4,14,14,0,14,5,2,1,2,8,6,2,7,5,2,1,2,6,8,-2,7,,,Maine Road,Manchester
2000/01,9,4,Chelsea,11,10,3,4,3,19,14,5,13,5,3,1,1,15,7,8,10,5,0,3,2,4,7,-3,3,,,Stamford Bridge,London
2000/01,9,2,Aston Villa,12,9,3,4,2,11,8,3,13,4,2,2,0,7,2,5,8,5,1,2,2,4,6,-2,5,Q,EU_IT,Villa Park,Birmingham
2000/01,9,29,Sunderland,13,10,3,4,3,8,11,-3,13,5,3,2,0,5,2,3,11,5,0,2,3,3,9,-6,2,,,Stadium of Light,Sunderland
2000/01,9,7,Everton,14,10,3,3,4,13,16,-3,12,5,1,2,2,7,9,-2,5,5,2,1,2,6,7,-1,7,,,Goodison Park,Liverpool
2000/01,9,5,Coventry City,15,10,3,2,5,11,21,-10,11,5,1,1,3,3,9,-6,4,5,2,1,2,8,12,-4,7,,,Highfield Road,Coventry
2000/01,9,13,Middlesbrough,16,10,2,4,4,15,16,-1,10,5,0,2,3,5,9,-4,2,5,2,2,1,10,7,3,8,,,Riverside Stadium,Middlesbrough
2000/01,9,20,Southampton,17,10,2,4,4,12,15,-3,10,5,1,1,3,7,10,-3,4,5,1,3,1,5,5,0,6,,,The Dell,Southampton
2000/01,9,25,West Ham United,18,10,1,5,4,12,14,-2,8,5,0,3,2,5,7,-2,3,5,1,2,2,7,7,0,5,R,EN_D1,Boleyn Ground,London
2000/01,9,32,Bradford City,19,10,1,3,6,4,16,-12,6,5,1,2,2,3,4,-1,5,5,0,1,4,1,12,-11,1,R,EN_D1,Valley Parade,Bradford
2000/01,9,28,Derby County,20,10,0,5,5,15,26,-11,5,5,0,4,1,8,12,-4,4,5,0,1,4,7,14,-7,1,R,EN_D1,Pride Park,Derby
2000/01,10,12,Manchester United,1,11,7,3,1,31,8,23,24,6,5,1,0,22,3,19,16,5,2,2,1,9,5,4,8,Q,EU_CL,Old Trafford,Manchester
2000/01,10,1,Arsenal,2,11,7,3,1,22,10,12,24,6,6,0,0,16,4,12,18,5,1,3,1,6,6,0,6,Q,EU_CL,Highbury,London
2000/01,10,10,Liverpool,3,11,6,3,2,20,14,6,21,6,5,1,0,12,5,7,16,5,1,2,2,8,9,-1,5,Q,EU_CL,Anfield,Liverpool
2000/01,10,26,Leicester City,4,11,5,4,2,9,7,2,19,6,3,2,1,6,6,0,11,5,2,2,1,3,1,2,8,Q,EU_UC,Filbert Street,Leicester
2000/01,10,8,Ipswich Town,5,11,5,3,3,16,12,4,18,6,2,3,1,7,6,1,9,5,3,0,2,9,6,3,9,Q,EU_UC,Portman Road,Ipswich
2000/01,10,4,Chelsea,6,11,4,4,3,22,14,8,16,6,4,1,1,18,7,11,13,5,0,3,2,4,7,-3,3,Q,EU_UC,Stamford Bridge,London
2000/01,10,2,Aston Villa,7,10,4,4,2,13,9,4,16,5,3,2,0,9,3,6,11,5,1,2,2,4,6,-2,5,Q,EU_IT,Villa Park,Birmingham
2000/01,10,23,Newcastle United,8,11,5,1,5,11,10,1,16,5,2,1,2,5,4,1,7,6,3,0,3,6,6,0,9,Q,EU_IT,St. James' Park,Newcastle
2000/01,10,29,Sunderland,9,11,4,4,3,9,11,-2,16,6,4,2,0,6,2,4,14,5,0,2,3,3,9,-6,2,,,Stadium of Light,Sunderland
2000/01,10,9,Leeds United,10,10,4,3,3,15,14,1,15,5,3,0,2,11,8,3,9,5,1,3,1,4,6,-2,6,,,Elland Road,Leeds
2000/01,10,31,Charlton Athletic,11,11,4,3,4,17,18,-1,15,5,3,2,0,9,3,6,11,6,1,1,4,8,15,-7,4,,,The Valley,London
2000/01,10,21,Tottenham Hotspur,12,11,4,2,5,15,17,-2,14,5,4,1,0,10,4,6,13,6,0,1,5,5,13,-8,1,,,White Hart Lane,London
2000/01,10,11,Manchester City,13,11,4,2,5,14,19,-5,14,5,2,1,2,8,6,2,7,6,2,1,3,6,13,-7,7,,,Maine Road,Manchester
2000/01,10,7,Everton,14,11,3,3,5,14,19,-5,12,5,1,2,2,7,9,-2,5,6,2,1,3,7,10,-3,7,,,Goodison Park,Liverpool
2000/01,10,25,West Ham United,15,11,2,5,4,13,14,-1,11,6,1,3,2,6,7,-1,6,5,1,2,2,7,7,0,5,,,Boleyn Ground,London
2000/01,10,5,Coventry City,16,11,3,2,6,11,22,-11,11,5,1,1,3,3,9,-6,4,6,2,1,3,8,13,-5,7,,,Highfield Road,Coventry
2000/01,10,13,Middlesbrough,17,11,2,4,5,16,18,-2,10,5,0,2,3,5,9,-4,2,6,2,2,2,11,9,2,8,,,Riverside Stadium,Middlesbrough
2000/01,10,20,Southampton,18,11,2,4,5,12,20,-8,10,5,1,1,3,7,10,-3,4,6,1,3,2,5,10,-5,6,R,EN_D1,The Dell,Southampton
2000/01,10,32,Bradford City,19,11,1,4,6,5,17,-12,7,6,1,3,2,4,5,-1,6,5,0,1,4,1,12,-11,1,R,EN_D1,Valley Parade,Bradford
2000/01,10,28,Derby County,20,11,0,5,6,16,28,-12,5,5,0,4,1,8,12,-4,4,6,0,1,5,8,16,-8,1,R,EN_D1,Pride Park,Derby
2000/01,11,12,Manchester United,1,12,8,3,1,33,9,24,27,6,5,1,0,22,3,19,16,6,3,2,1,11,6,5,11,Q,EU_CL,Old Trafford,Manchester
2000/01,11,1,Arsenal,2,12,8,3,1,23,10,13,27,6,6,0,0,16,4,12,18,6,2,3,1,7,6,1,9,Q,EU_CL,Highbury,London
2000/01,11,26,Leicester City,3,12,6,4,2,10,7,3,22,6,3,2,1,6,6,0,11,6,3,2,1,4,1,3,11,Q,EU_CL,Filbert Street,Leicester
2000/01,11,10,Liverpool,4,12,6,3,3,23,18,5,21,6,5,1,0,12,5,7,16,6,1,2,3,11,13,-2,5,Q,EU_UC,Anfield,Liverpool
2000/01,11,2,Aston Villa,5,11,5,4,2,14,9,5,19,5,3,2,0,9,3,6,11,6,2,2,2,5,6,-1,8,"Q,Q","EU_UC,EU_IT",Villa Park,Birmingham
2000/01,11,23,Newcastle United,6,12,6,1,5,13,11,2,19,6,3,1,2,7,5,2,10,6,3,0,3,6,6,0,9,"Q,Q","EU_UC,EU_IT",St. James' Park,Newcastle
2000/01,11,8,Ipswich Town,7,12,5,3,4,17,14,3,18,6,2,3,1,7,6,1,9,6,3,0,3,10,8,2,9,,,Portman Road,Ipswich
2000/01,11,9,Leeds United,8,11,5,3,3,19,17,2,18,6,4,0,2,15,11,4,12,5,1,3,1,4,6,-2,6,,,Elland Road,Leeds
2000/01,11,31,Charlton Athletic,9,12,5,3,4,19,18,1,18,6,4,2,0,11,3,8,14,6,1,1,4,8,15,-7,4,,,The Valley,London
2000/01,11,21,Tottenham Hotspur,10,12,5,2,5,17,18,-1,17,6,5,1,0,12,5,7,16,6,0,1,5,5,13,-8,1,,,White Hart Lane,London
2000/01,11,4,Chelsea,11,12,4,4,4,24,17,7,16,6,4,1,1,18,7,11,13,6,0,3,3,6,10,-4,3,,,Stamford Bridge,London
2000/01,11,29,Sunderland,12,12,4,4,4,10,13,-3,16,6,4,2,0,6,2,4,14,6,0,2,4,4,11,-7,2,,,Stadium of Light,Sunderland
2000/01,11,11,Manchester City,13,12,4,2,6,14,20,-6,14,6,2,1,3,8,7,1,7,6,2,1,3,6,13,-7,7,,,Maine Road,Manchester
2000/01,11,20,Southampton,14,12,3,4,5,15,22,-7,13,6,2,1,3,10,12,-2,7,6,1,3,2,5,10,-5,6,,,The Dell,Southampton
2000/01,11,25,West Ham United,15,12,2,6,4,13,14,-1,12,6,1,3,2,6,7,-1,6,6,1,3,2,7,7,0,6,,,Boleyn Ground,London
2000/01,11,7,Everton,16,12,3,3,6,14,20,-6,12,6,1,2,3,7,10,-3,5,6,2,1,3,7,10,-3,7,,,Goodison Park,Liverpool
2000/01,11,5,Coventry City,17,12,3,2,7,12,24,-12,11,6,1,1,4,4,11,-7,4,6,2,1,3,8,13,-5,7,,,Highfield Road,Coventry
2000/01,11,13,Middlesbrough,18,12,2,4,6,16,19,-3,10,6,0,2,4,5,10,-5,2,6,2,2,2,11,9,2,8,R,EN_D1,Riverside Stadium,Middlesbrough
2000/01,11,32,Bradford City,19,12,1,4,7,5,19,-14,7,6,1,3,2,4,5,-1,6,6,0,1,5,1,14,-13,1,R,EN_D1,Valley Parade,Bradford
2000/01,11,28,Derby County,20,12,0,6,6,16,28,-12,6,6,0,5,1,8,12,-4,5,6,0,1,5,8,16,-8,1,R,EN_D1,Pride Park,Derby
2000/01,12,12,Manchester United,1,13,9,3,1,35,10,25,30,7,6,1,0,24,4,20,19,6,3,2,1,11,6,5,11,Q,EU_CL,Old Trafford,Manchester
2000/01,12,1,Arsenal,2,13,8,4,1,23,10,13,28,7,6,1,0,16,4,12,19,6,2,3,1,7,6,1,9,Q,EU_CL,Highbury,London
2000/01,12,10,Liverpool,3,13,7,3,3,27,19,8,24,7,6,1,0,16,6,10,19,6,1,2,3,11,13,-2,5,Q,EU_CL,Anfield,Liverpool
2000/01,12,26,Leicester City,4,13,6,5,2,11,8,3,23,7,3,3,1,7,7,0,12,6,3,2,1,4,1,3,11,Q,EU_UC,Filbert Street,Leicester
2000/01,12,2,Aston Villa,5,12,6,4,2,16,9,7,22,6,4,2,0,11,3,8,14,6,2,2,2,5,6,-1,8,"Q,Q","EU_UC,EU_IT",Villa Park,Birmingham
2000/01,12,8,Ipswich Town,6,13,6,3,4,19,14,5,21,7,3,3,1,9,6,3,12,6,3,0,3,10,8,2,9,Q,EU_UC,Portman Road,Ipswich
2000/01,12,23,Newcastle United,7,13,6,2,5,14,12,2,20,6,3,1,2,7,5,2,10,7,3,1,3,7,7,0,10,Q,EU_IT,St. James' Park,Newcastle
2000/01,12,9,Leeds United,8,12,5,4,3,20,18,2,19,6,4,0,2,15,11,4,12,6,1,4,1,5,7,-2,7,,,Elland Road,Leeds
2000/01,12,31,Charlton Athletic,9,13,5,3,5,19,20,-1,18,6,4,2,0,11,3,8,14,7,1,1,5,8,17,-9,4,,,The Valley,London
2000/01,12,4,Chelsea,10,13,4,5,4,25,18,7,17,7,4,2,1,19,8,11,14,6,0,3,3,6,10,-4,3,,,Stamford Bridge,London
2000/01,12,21,Tottenham Hotspur,11,13,5,2,6,17,20,-3,17,6,5,1,0,12,5,7,16,7,0,1,6,5,15,-10,1,,,White Hart Lane,London
2000/01,12,29,Sunderland,12,13,4,5,4,12,15,-3,17,7,4,3,0,8,4,4,15,6,0,2,4,4,11,-7,2,,,Stadium of Light,Sunderland
2000/01,12,25,West Ham United,13,13,3,6,4,17,15,2,15,7,2,3,2,10,8,2,9,6,1,3,2,7,7,0,6,,,Boleyn Ground,London
2000/01,12,7,Everton,14,13,4,3,6,15,20,-5,15,6,1,2,3,7,10,-3,5,7,3,1,3,8,10,-2,10,,,Goodison Park,Liverpool
2000/01,12,20,Southampton,15,13,3,5,5,17,24,-7,14,6,2,1,3,10,12,-2,7,7,1,4,2,7,12,-5,7,,,The Dell,Southampton
2000/01,12,11,Manchester City,16,13,4,2,7,15,24,-9,14,6,2,1,3,8,7,1,7,7,2,1,4,7,17,-10,7,,,Maine Road,Manchester
2000/01,12,5,Coventry City,17,13,3,2,8,13,28,-15,11,6,1,1,4,4,11,-7,4,7,2,1,4,9,17,-8,7,,,Highfield Road,Coventry
2000/01,12,13,Middlesbrough,18,13,2,4,7,17,21,-4,10,6,0,2,4,5,10,-5,2,7,2,2,3,12,11,1,8,R,EN_D1,Riverside Stadium,Middlesbrough
2000/01,12,28,Derby County,19,13,0,7,6,16,28,-12,7,6,0,5,1,8,12,-4,5,7,0,2,5,8,16,-8,2,R,EN_D1,Pride Park,Derby
2000/01,12,32,Bradford City,20,13,1,4,8,5,20,-15,7,7,1,3,3,4,6,-2,6,6,0,1,5,1,14,-13,1,R,EN_D1,Valley Parade,Bradford
2000/01,13,12,Manchester United,1,14,10,3,1,36,10,26,33,7,6,1,0,24,4,20,19,7,4,2,1,12,6,6,14,Q,EU_CL,Old Trafford,Manchester
2000/01,13,1,Arsenal,2,14,8,4,2,23,12,11,28,7,6,1,0,16,4,12,19,7,2,3,2,7,8,-1,9,Q,EU_CL,Highbury,London
2000/01,13,26,Leicester City,3,14,7,5,2,14,8,6,26,7,3,3,1,7,7,0,12,7,4,2,1,7,1,6,14,Q,EU_CL,Filbert Street,Leicester
2000/01,13,10,Liverpool,4,14,7,3,4,28,21,7,24,7,6,1,0,16,6,10,19,7,1,2,4,12,15,-3,5,Q,EU_UC,Anfield,Liverpool
2000/01,13,8,Ipswich Town,5,14,7,3,4,20,14,6,24,7,3,3,1,9,6,3,12,7,4,0,3,11,8,3,12,Q,EU_UC,Portman Road,Ipswich
2000/01,13,2,Aston Villa,6,13,6,4,3,16,11,5,22,6,4,2,0,11,3,8,14,7,2,2,3,5,8,-3,8,"Q,Q","EU_UC,EU_IT",Villa Park,Birmingham
2000/01,13,31,Charlton Athletic,7,14,6,3,5,21,20,1,21,7,5,2,0,13,3,10,17,7,1,1,5,8,17,-9,4,,,The Valley,London
2000/01,13,23,Newcastle United,8,14,6,2,6,15,14,1,20,7,3,1,3,8,7,1,10,7,3,1,3,7,7,0,10,Q,EU_IT,St. James' Park,Newcastle
2000/01,13,21,Tottenham Hotspur,9,14,6,2,6,19,21,-2,20,7,6,1,0,14,6,8,19,7,0,1,6,5,15,-10,1,,,White Hart Lane,London
2000/01,13,29,Sunderland,10,14,5,5,4,14,16,-2,20,7,4,3,0,8,4,4,15,7,1,2,4,6,12,-6,5,,,Stadium of Light,Sunderland
2000/01,13,9,Leeds United,11,13,5,4,4,20,19,1,19,7,4,0,3,15,12,3,12,6,1,4,1,5,7,-2,7,,,Elland Road,Leeds
2000/01,13,25,West Ham United,12,14,4,6,4,18,15,3,18,7,2,3,2,10,8,2,9,7,2,3,2,8,7,1,9,,,Boleyn Ground,London
2000/01,13,7,Everton,13,14,5,3,6,17,20,-3,18,7,2,2,3,9,10,-1,8,7,3,1,3,8,10,-2,10,,,Goodison Park,Liverpool
2000/01,13,4,Chelsea,14,14,4,5,5,25,20,5,17,7,4,2,1,19,8,11,14,7,0,3,4,6,12,-6,3,,,Stamford Bridge,London
2000/01,13,20,Southampton,15,14,4,5,5,19,24,-5,17,7,3,1,3,12,12,0,10,7,1,4,2,7,12,-5,7,,,The Dell,Southampton
2000/01,13,11,Manchester City,16,14,4,2,8,15,25,-10,14,7,2,1,4,8,8,0,7,7,2,1,4,7,17,-10,7,,,Maine Road,Manchester
2000/01,13,5,Coventry City,17,14,3,2,9,13,29,-16,11,7,1,1,5,4,12,-8,4,7,2,1,4,9,17,-8,7,,,Highfield Road,Coventry
2000/01,13,13,Middlesbrough,18,14,2,4,8,17,24,-7,10,7,0,2,5,5,13,-8,2,7,2,2,3,12,11,1,8,R,EN_D1,Riverside Stadium,Middlesbrough
2000/01,13,28,Derby County,19,14,1,7,6,18,28,-10,10,7,1,5,1,10,12,-2,8,7,0,2,5,8,16,-8,2,R,EN_D1,Pride Park,Derby
2000/01,13,32,Bradford City,20,14,1,4,9,5,22,-17,7,7,1,3,3,4,6,-2,6,7,0,1,6,1,16,-15,1,R,EN_D1,Valley Parade,Bradford
2000/01,14,12,Manchester United,1,15,11,3,1,39,10,29,36,7,6,1,0,24,4,20,19,8,5,2,1,15,6,9,17,Q,EU_CL,Old Trafford,Manchester
2000/01,14,1,Arsenal,2,15,8,4,3,23,13,10,28,7,6,1,0,16,4,12,19,8,2,3,3,7,9,-2,9,Q,EU_CL,Highbury,London
2000/01,14,8,Ipswich Town,3,15,8,3,4,23,16,7,27,7,3,3,1,9,6,3,12,8,5,0,3,14,10,4,15,Q,EU_CL,Portman Road,Ipswich
2000/01,14,26,Leicester City,4,15,7,5,3,14,11,3,26,7,3,3,1,7,7,0,12,8,4,2,2,7,4,3,14,Q,EU_UC,Filbert Street,Leicester
2000/01,14,10,Liverpool,5,15,7,3,5,29,23,6,24,7,6,1,0,16,6,10,19,8,1,2,5,13,17,-4,5,Q,EU_UC,Anfield,Liverpool
2000/01,14,2,Aston Villa,6,14,6,5,3,17,12,5,23,6,4,2,0,11,3,8,14,8,2,3,3,6,9,-3,9,"Q,Q","EU_UC,EU_IT",Villa Park,Birmingham
2000/01,14,23,Newcastle United,7,15,7,2,6,17,15,2,23,8,4,1,3,10,8,2,13,7,3,1,3,7,7,0,10,Q,EU_IT,St. James' Park,Newcastle
2000/01,14,21,Tottenham Hotspur,8,15,7,2,6,22,21,1,23,8,7,1,0,17,6,11,22,7,0,1,6,5,15,-10,1,,,White Hart Lane,London
2000/01,14,29,Sunderland,9,15,6,5,4,15,16,-1,23,7,4,3,0,8,4,4,15,8,2,2,4,7,12,-5,8,,,Stadium of Light,Sunderland
2000/01,14,9,Leeds United,10,14,6,4,4,21,19,2,22,8,5,0,3,16,12,4,15,6,1,4,1,5,7,-2,7,,,Elland Road,Leeds
2000/01,14,25,West Ham United,11,15,5,6,4,21,17,4,21,7,2,3,2,10,8,2,9,8,3,3,2,11,9,2,12,,,Boleyn Ground,London
2000/01,14,31,Charlton Athletic,12,15,6,3,6,21,21,0,21,8,5,2,1,13,4,9,17,7,1,1,5,8,17,-9,4,,,The Valley,London
2000/01,14,7,Everton,13,15,6,3,6,19,21,-2,21,8,3,2,3,11,11,0,11,7,3,1,3,8,10,-2,10,,,Goodison Park,Liverpool
2000/01,14,4,Chelsea,14,15,4,5,6,26,22,4,17,7,4,2,1,19,8,11,14,8,0,3,5,7,14,-7,3,,,Stamford Bridge,London
2000/01,14,20,Southampton,15,15,4,5,6,21,27,-6,17,8,3,1,4,14,15,-1,10,7,1,4,2,7,12,-5,7,,,The Dell,Southampton
2000/01,14,11,Manchester City,16,15,4,2,9,17,28,-11,14,8,2,1,5,10,11,-1,7,7,2,1,4,7,17,-10,7,,,Maine Road,Manchester
2000/01,14,5,Coventry City,17,15,3,3,9,14,30,-16,12,8,1,2,5,5,13,-8,5,7,2,1,4,9,17,-8,7,,,Highfield Road,Coventry
2000/01,14,13,Middlesbrough,18,15,2,5,8,19,26,-7,11,8,0,3,5,7,15,-8,3,7,2,2,3,12,11,1,8,R,EN_D1,Riverside Stadium,Middlesbrough
2000/01,14,28,Derby County,19,15,1,7,7,18,31,-13,10,8,1,5,2,10,15,-5,8,7,0,2,5,8,16,-8,2,R,EN_D1,Pride Park,Derby
2000/01,14,32,Bradford City,20,15,1,5,9,7,24,-17,8,7,1,3,3,4,6,-2,6,8,0,2,6,3,18,-15,2,R,EN_D1,Valley Parade,Bradford
2000/01,15,12,Manchester United,1,16,12,3,1,41,10,31,39,8,7,1,0,26,4,22,22,8,5,2,1,15,6,9,17,Q,EU_CL,Old Trafford,Manchester
2000/01,15,1,Arsenal,2,16,9,4,3,24,13,11,31,8,7,1,0,17,4,13,22,8,2,3,3,7,9,-2,9,Q,EU_CL,Highbury,London
2000/01,15,26,Leicester City,3,16,8,5,3,17,12,5,29,8,4,3,1,10,8,2,15,8,4,2,2,7,4,3,14,Q,EU_CL,Filbert Street,Leicester
2000/01,15,10,Liverpool,4,16,8,3,5,32,23,9,27,8,7,1,0,19,6,13,22,8,1,2,5,13,17,-4,5,Q,EU_UC,Anfield,Liverpool
2000/01,15,8,Ipswich Town,5,16,8,3,5,23,17,6,27,8,3,3,2,9,7,2,12,8,5,0,3,14,10,4,15,Q,EU_UC,Portman Road,Ipswich
2000/01,15,29,Sunderland,6,16,7,5,4,17,16,1,26,8,5,3,0,10,4,6,18,8,2,2,4,7,12,-5,8,Q,EU_UC,Stadium of Light,Sunderland
2000/01,15,25,West Ham United,7,16,6,6,4,22,17,5,24,8,3,3,2,11,8,3,12,8,3,3,2,11,9,2,12,,,Boleyn Ground,London
2000/01,15,2,Aston Villa,8,15,6,6,3,18,13,5,24,7,4,3,0,12,4,8,15,8,2,3,3,6,9,-3,9,Q,EU_IT,Villa Park,Birmingham
2000/01,15,23,Newcastle United,9,16,7,3,6,18,16,2,24,8,4,1,3,10,8,2,13,8,3,2,3,8,8,0,11,Q,EU_IT,St. James' Park,Newcastle
2000/01,15,21,Tottenham Hotspur,10,16,7,2,7,22,23,-1,23,8,7,1,0,17,6,11,22,8,0,1,7,5,17,-12,1,,,White Hart Lane,London
2000/01,15,9,Leeds United,11,15,6,4,5,22,22,0,22,8,5,0,3,16,12,4,15,7,1,4,2,6,10,-4,7,,,Elland Road,Leeds
2000/01,15,31,Charlton Athletic,12,16,6,3,7,21,24,-3,21,8,5,2,1,13,4,9,17,8,1,1,6,8,20,-12,4,,,The Valley,London
2000/01,15,7,Everton,13,16,6,3,7,19,23,-4,21,8,3,2,3,11,11,0,11,8,3,1,4,8,12,-4,10,,,Goodison Park,Liverpool
2000/01,15,4,Chelsea,14,16,5,5,6,28,23,5,20,8,5,2,1,21,9,12,17,8,0,3,5,7,14,-7,3,,,Stamford Bridge,London
2000/01,15,20,Southampton,15,16,4,5,7,21,28,-7,17,8,3,1,4,14,15,-1,10,8,1,4,3,7,13,-6,7,,,The Dell,Southampton
2000/01,15,11,Manchester City,16,16,4,2,10,18,30,-12,14,8,2,1,5,10,11,-1,7,8,2,1,5,8,19,-11,7,,,Maine Road,Manchester
2000/01,15,28,Derby County,17,16,2,7,7,19,31,-12,13,8,1,5,2,10,15,-5,8,8,1,2,5,9,16,-7,5,,,Pride Park,Derby
2000/01,15,5,Coventry City,18,16,3,3,10,15,32,-17,12,8,1,2,5,5,13,-8,5,8,2,1,5,10,19,-9,7,R,EN_D1,Highfield Road,Coventry
2000/01,15,13,Middlesbrough,19,16,2,5,9,19,27,-8,11,8,0,3,5,7,15,-8,3,8,2,2,4,12,12,0,8,R,EN_D1,Riverside Stadium,Middlesbrough
2000/01,15,32,Bradford City,20,16,2,5,9,9,25,-16,11,8,2,3,3,6,7,-1,9,8,0,2,6,3,18,-15,2,R,EN_D1,Valley Parade,Bradford
2000/01,16,12,Manchester United,1,17,12,4,1,44,13,31,40,8,7,1,0,26,4,22,22,9,5,3,1,18,9,9,18,Q,EU_CL,Old Trafford,Manchester
2000/01,16,1,Arsenal,2,17,10,4,3,29,13,16,34,9,8,1,0,22,4,18,25,8,2,3,3,7,9,-2,9,Q,EU_CL,Highbury,London
2000/01,16,8,Ipswich Town,3,17,9,3,5,24,17,7,30,8,3,3,2,9,7,2,12,9,6,0,3,15,10,5,18,Q,EU_CL,Portman Road,Ipswich
2000/01,16,26,Leicester City,4,17,8,5,4,17,13,4,29,8,4,3,1,10,8,2,15,9,4,2,3,7,5,2,14,Q,EU_UC,Filbert Street,Leicester
2000/01,16,29,Sunderland,5,17,8,5,4,18,16,2,29,9,6,3,0,11,4,7,21,8,2,2,4,7,12,-5,8,Q,EU_UC,Stadium of Light,Sunderland
2000/01,16,10,Liverpool,6,17,8,3,6,32,24,8,27,9,7,1,1,19,7,12,22,8,1,2,5,13,17,-4,5,Q,EU_UC,Anfield,Liverpool
2000/01,16,25,West Ham United,7,17,6,7,4,23,18,5,25,9,3,4,2,12,9,3,13,8,3,3,2,11,9,2,12,,,Boleyn Ground,London
2000/01,16,2,Aston Villa,8,16,6,7,3,19,14,5,25,7,4,3,0,12,4,8,15,9,2,4,3,7,10,-3,10,Q,EU_IT,Villa Park,Birmingham
2000/01,16,21,Tottenham Hotspur,9,17,7,3,7,25,26,-1,24,8,7,1,0,17,6,11,22,9,0,2,7,8,20,-12,2,,,White Hart Lane,London
2000/01,16,23,Newcastle United,10,17,7,3,7,18,21,-3,24,8,4,1,3,10,8,2,13,9,3,2,4,8,13,-5,11,Q,EU_IT,St. James' Park,Newcastle
2000/01,16,4,Chelsea,11,17,6,5,6,32,24,8,23,9,6,2,1,25,10,15,20,8,0,3,5,7,14,-7,3,,,Stamford Bridge,London
2000/01,16,9,Leeds United,12,16,6,4,6,22,23,-1,22,8,5,0,3,16,12,4,15,8,1,4,3,6,11,-5,7,,,Elland Road,Leeds
2000/01,16,31,Charlton Athletic,13,17,6,4,7,24,27,-3,22,9,5,3,1,16,7,9,18,8,1,1,6,8,20,-12,4,,,The Valley,London
2000/01,16,7,Everton,14,17,6,3,8,19,28,-9,21,8,3,2,3,11,11,0,11,9,3,1,5,8,17,-9,10,,,Goodison Park,Liverpool
2000/01,16,20,Southampton,15,17,5,5,7,22,28,-6,20,9,4,1,4,15,15,0,13,8,1,4,3,7,13,-6,7,,,The Dell,Southampton
2000/01,16,11,Manchester City,16,17,5,2,10,23,30,-7,17,9,3,1,5,15,11,4,10,8,2,1,5,8,19,-11,7,,,Maine Road,Manchester
2000/01,16,5,Coventry City,17,17,4,3,10,16,32,-16,15,9,2,2,5,6,13,-7,8,8,2,1,5,10,19,-9,7,,,Highfield Road,Coventry
2000/01,16,28,Derby County,18,17,2,7,8,20,35,-15,13,8,1,5,2,10,15,-5,8,9,1,2,6,10,20,-10,5,R,EN_D1,Pride Park,Derby
2000/01,16,32,Bradford City,19,17,2,6,9,12,28,-16,12,9,2,4,3,9,10,-1,10,8,0,2,6,3,18,-15,2,R,EN_D1,Valley Parade,Bradford
2000/01,16,13,Middlesbrough,20,17,2,5,10,19,28,-9,11,8,0,3,5,7,15,-8,3,9,2,2,5,12,13,-1,8,R,EN_D1,Riverside Stadium,Middlesbrough
2000/01,17,12,Manchester United,1,18,12,4,2,44,14,30,40,9,7,1,1,26,5,21,22,9,5,3,1,18,9,9,18,Q,EU_CL,Old Trafford,Manchester
2000/01,17,1,Arsenal,2,18,10,5,3,30,14,16,35,9,8,1,0,22,4,18,25,9,2,4,3,8,10,-2,10,Q,EU_CL,Highbury,London
2000/01,17,8,Ipswich Town,3,18,10,3,5,27,18,9,33,9,4,3,2,12,8,4,15,9,6,0,3,15,10,5,18,Q,EU_CL,Portman Road,Ipswich
2000/01,17,26,Leicester City,4,18,9,5,4,20,14,6,32,9,5,3,1,13,9,4,18,9,4,2,3,7,5,2,14,Q,EU_UC,Filbert Street,Leicester
2000/01,17,10,Liverpool,5,18,9,3,6,33,24,9,30,9,7,1,1,19,7,12,22,9,2,2,5,14,17,-3,8,Q,EU_UC,Anfield,Liverpool
2000/01,17,29,Sunderland,6,18,8,5,5,18,18,0,29,9,6,3,0,11,4,7,21,9,2,2,5,7,14,-7,8,Q,EU_UC,Stadium of Light,Sunderland
2000/01,17,23,Newcastle United,7,18,8,3,7,20,22,-2,27,9,5,1,3,12,9,3,16,9,3,2,4,8,13,-5,11,Q,EU_IT,St. James' Park,Newcastle
2000/01,17,25,West Ham United,8,18,6,8,4,24,19,5,26,9,3,4,2,12,9,3,13,9,3,4,2,12,10,2,13,,,Boleyn Ground,London
2000/01,17,2,Aston Villa,9,17,6,8,3,21,16,5,26,8,4,4,0,14,6,8,16,9,2,4,3,7,10,-3,10,Q,EU_IT,Villa Park,Birmingham
2000/01,17,9,Leeds United,10,17,7,4,6,24,23,1,25,9,6,0,3,18,12,6,18,8,1,4,3,6,11,-5,7,,,Elland Road,Leeds
2000/01,17,21,Tottenham Hotspur,11,18,7,4,7,26,27,-1,25,9,7,2,0,18,7,11,23,9,0,2,7,8,20,-12,2,,,White Hart Lane,London
2000/01,17,4,Chelsea,12,18,6,5,7,32,25,7,23,9,6,2,1,25,10,15,20,9,0,3,6,7,15,-8,3,,,Stamford Bridge,London
2000/01,17,31,Charlton Athletic,13,18,6,4,8,25,30,-5,22,9,5,3,1,16,7,9,18,9,1,1,7,9,23,-14,4,,,The Valley,London
2000/01,17,7,Everton,14,18,6,4,8,20,29,-9,22,9,3,3,3,12,12,0,12,9,3,1,5,8,17,-9,10,,,Goodison Park,Liverpool
2000/01,17,20,Southampton,15,18,5,5,8,23,31,-8,20,9,4,1,4,15,15,0,13,9,1,4,4,8,16,-8,7,,,The Dell,Southampton
2000/01,17,11,Manchester City,16,18,5,3,10,25,32,-7,18,9,3,1,5,15,11,4,10,9,2,2,5,10,21,-11,8,,,Maine Road,Manchester
2000/01,17,28,Derby County,17,18,3,7,8,21,35,-14,16,9,2,5,2,11,15,-4,11,9,1,2,6,10,20,-10,5,,,Pride Park,Derby
2000/01,17,5,Coventry City,18,18,4,3,11,16,33,-17,15,9,2,2,5,6,13,-7,8,9,2,1,6,10,20,-10,7,R,EN_D1,Highfield Road,Coventry
2000/01,17,13,Middlesbrough,19,18,3,5,10,20,28,-8,14,9,1,3,5,8,15,-7,6,9,2,2,5,12,13,-1,8,R,EN_D1,Riverside Stadium,Middlesbrough
2000/01,17,32,Bradford City,20,18,2,6,10,13,30,-17,12,9,2,4,3,9,10,-1,10,9,0,2,7,4,20,-16,2,R,EN_D1,Valley Parade,Bradford
2000/01,18,12,Manchester United,1,19,13,4,2,46,14,32,43,10,8,1,1,28,5,23,25,9,5,3,1,18,9,9,18,Q,EU_CL,Old Trafford,Manchester
2000/01,18,1,Arsenal,2,19,10,5,4,30,18,12,35,9,8,1,0,22,4,18,25,10,2,4,4,8,14,-6,10,Q,EU_CL,Highbury,London
2000/01,18,26,Leicester City,3,19,10,5,4,22,15,7,35,10,6,3,1,15,10,5,21,9,4,2,3,7,5,2,14,Q,EU_CL,Filbert Street,Leicester
2000/01,18,10,Liverpool,4,19,10,3,6,37,24,13,33,10,8,1,1,23,7,16,25,9,2,2,5,14,17,-3,8,Q,EU_UC,Anfield,Liverpool
2000/01,18,8,Ipswich Town,5,19,10,3,6,27,20,7,33,9,4,3,2,12,8,4,15,10,6,0,4,15,12,3,18,Q,EU_UC,Portman Road,Ipswich
2000/01,18,29,Sunderland,6,19,9,5,5,19,18,1,32,10,7,3,0,12,4,8,24,9,2,2,5,7,14,-7,8,Q,EU_UC,Stadium of Light,Sunderland
2000/01,18,2,Aston Villa,7,18,7,8,3,23,17,6,29,8,4,4,0,14,6,8,16,10,3,4,3,9,11,-2,13,Q,EU_IT,Villa Park,Birmingham
2000/01,18,23,Newcastle United,8,19,8,3,8,20,24,-4,27,9,5,1,3,12,9,3,16,10,3,2,5,8,15,-7,11,Q,EU_IT,St. James' Park,Newcastle
2000/01,18,4,Chelsea,9,19,7,5,7,35,25,10,26,10,7,2,1,28,10,18,23,9,0,3,6,7,15,-8,3,,,Stamford Bridge,London
2000/01,18,25,West Ham United,10,19,6,8,5,25,21,4,26,9,3,4,2,12,9,3,13,10,3,4,3,13,12,1,13,,,Boleyn Ground,London
2000/01,18,21,Tottenham Hotspur,11,19,7,5,7,26,27,-1,26,10,7,3,0,18,7,11,24,9,0,2,7,8,20,-12,2,,,White Hart Lane,London
2000/01,18,9,Leeds United,12,18,7,4,7,25,25,0,25,10,6,0,4,19,14,5,18,8,1,4,3,6,11,-5,7,,,Elland Road,Leeds
2000/01,18,31,Charlton Athletic,13,19,7,4,8,26,30,-4,25,10,6,3,1,17,7,10,21,9,1,1,7,9,23,-14,4,,,The Valley,London
2000/01,18,7,Everton,14,19,6,4,9,20,30,-10,22,9,3,3,3,12,12,0,12,10,3,1,6,8,18,-10,10,,,Goodison Park,Liverpool
2000/01,18,20,Southampton,15,19,5,6,8,24,32,-8,21,9,4,1,4,15,15,0,13,10,1,5,4,9,17,-8,8,,,The Dell,Southampton
2000/01,18,28,Derby County,16,19,4,7,8,23,35,-12,19,10,3,5,2,13,15,-2,14,9,1,2,6,10,20,-10,5,,,Pride Park,Derby
2000/01,18,11,Manchester City,17,19,5,3,11,25,33,-8,18,9,3,1,5,15,11,4,10,10,2,2,6,10,22,-12,8,,,Maine Road,Manchester
2000/01,18,5,Coventry City,18,19,4,4,11,17,34,-17,16,10,2,3,5,7,14,-7,9,9,2,1,6,10,20,-10,7,R,EN_D1,Highfield Road,Coventry
2000/01,18,13,Middlesbrough,19,19,3,6,10,20,28,-8,15,9,1,3,5,8,15,-7,6,10,2,3,5,12,13,-1,9,R,EN_D1,Riverside Stadium,Middlesbrough
2000/01,18,32,Bradford City,20,19,2,6,11,13,33,-20,12,9,2,4,3,9,10,-1,10,10,0,2,8,4,23,-19,2,R,EN_D1,Valley Parade,Bradford
2000/01,19,12,Manchester United,1,20,14,4,2,47,14,33,46,10,8,1,1,28,5,23,25,10,6,3,1,19,9,10,21,Q,EU_CL,Old Trafford,Manchester
2000/01,19,1,Arsenal,2,20,11,5,4,36,19,17,38,10,9,1,0,28,5,23,28,10,2,4,4,8,14,-6,10,Q,EU_CL,Highbury,London
2000/01,19,29,Sunderland,3,20,10,5,5,23,19,4,35,10,7,3,0,12,4,8,24,10,3,2,5,11,15,-4,11,Q,EU_CL,Stadium of Light,Sunderland
2000/01,19,26,Leicester City,4,20,10,5,5,23,21,2,35,10,6,3,1,15,10,5,21,10,4,2,4,8,11,-3,14,Q,EU_UC,Filbert Street,Leicester
2000/01,19,8,Ipswich Town,5,20,10,4,6,29,22,7,34,10,4,4,2,14,10,4,16,10,6,0,4,15,12,3,18,Q,EU_UC,Portman Road,Ipswich
2000/01,19,10,Liverpool,6,20,10,3,7,37,25,12,33,10,8,1,1,23,7,16,25,10,2,2,6,14,18,-4,8,Q,EU_UC,Anfield,Liverpool
2000/01,19,23,Newcastle United,7,20,9,3,8,22,25,-3,30,10,6,1,3,14,10,4,19,10,3,2,5,8,15,-7,11,Q,EU_IT,St. James' Park,Newcastle
2000/01,19,25,West Ham United,8,20,7,8,5,30,21,9,29,10,4,4,2,17,9,8,16,10,3,4,3,13,12,1,13,,,Boleyn Ground,London
2000/01,19,2,Aston Villa,9,19,7,8,4,23,18,5,29,9,4,4,1,14,7,7,16,10,3,4,3,9,11,-2,13,Q,EU_IT,Villa Park,Birmingham
2000/01,19,4,Chelsea,10,20,7,6,7,37,27,10,27,10,7,2,1,28,10,18,23,10,0,4,6,9,17,-8,4,,,Stamford Bridge,London
2000/01,19,21,Tottenham Hotspur,11,20,7,5,8,26,29,-3,26,10,7,3,0,18,7,11,24,10,0,2,8,8,22,-14,2,,,White Hart Lane,London
2000/01,19,9,Leeds United,12,19,7,4,8,26,27,-1,25,10,6,0,4,19,14,5,18,9,1,4,4,7,13,-6,7,,,Elland Road,Leeds
2000/01,19,31,Charlton Athletic,13,20,7,4,9,26,35,-9,25,10,6,3,1,17,7,10,21,10,1,1,8,9,28,-19,4,,,The Valley,London
2000/01,19,20,Southampton,14,20,6,6,8,26,32,-6,24,10,5,1,4,17,15,2,16,10,1,5,4,9,17,-8,8,,,The Dell,Southampton
2000/01,19,7,Everton,15,20,6,4,10,21,32,-11,22,10,3,3,4,13,14,-1,12,10,3,1,6,8,18,-10,10,,,Goodison Park,Liverpool
2000/01,19,28,Derby County,16,20,4,8,8,23,35,-12,20,10,3,5,2,13,15,-2,14,10,1,3,6,10,20,-10,6,,,Pride Park,Derby
2000/01,19,11,Manchester City,17,20,5,4,11,25,33,-8,19,10,3,2,5,15,11,4,11,10,2,2,6,10,22,-12,8,,,Maine Road,Manchester
2000/01,19,5,Coventry City,18,20,5,4,11,19,35,-16,19,10,2,3,5,7,14,-7,9,10,3,1,6,12,21,-9,10,R,EN_D1,Highfield Road,Coventry
2000/01,19,13,Middlesbrough,19,20,4,6,10,21,28,-7,18,10,2,3,5,9,15,-6,9,10,2,3,5,12,13,-1,9,R,EN_D1,Riverside Stadium,Middlesbrough
2000/01,19,32,Bradford City,20,20,2,6,12,14,37,-23,12,10,2,4,4,10,14,-4,10,10,0,2,8,4,23,-19,2,R,EN_D1,Valley Parade,Bradford
2000/01,20,12,Manchester United,1,21,14,5,2,48,15,33,47,10,8,1,1,28,5,23,25,11,6,4,1,20,10,10,22,Q,EU_CL,Old Trafford,Manchester
2000/01,20,1,Arsenal,2,21,11,6,4,38,21,17,39,11,9,2,0,30,7,23,29,10,2,4,4,8,14,-6,10,Q,EU_CL,Highbury,London
2000/01,20,8,Ipswich Town,3,21,11,4,6,32,22,10,37,11,5,4,2,17,10,7,19,10,6,0,4,15,12,3,18,Q,EU_CL,Portman Road,Ipswich
2000/01,20,29,Sunderland,4,21,10,6,5,25,21,4,36,10,7,3,0,12,4,8,24,11,3,3,5,13,17,-4,12,Q,EU_UC,Stadium of Light,Sunderland
2000/01,20,26,Leicester City,5,20,10,5,5,23,21,2,35,10,6,3,1,15,10,5,21,10,4,2,4,8,11,-3,14,Q,EU_UC,Filbert Street,Leicester
2000/01,20,10,Liverpool,6,20,10,3,7,37,25,12,33,10,8,1,1,23,7,16,25,10,2,2,6,14,18,-4,8,Q,EU_UC,Anfield,Liverpool
2000/01,20,23,Newcastle United,7,21,9,4,8,23,26,-3,31,11,6,2,3,15,11,4,20,10,3,2,5,8,15,-7,11,Q,EU_IT,St. James' Park,Newcastle
2000/01,20,25,West Ham United,8,20,7,8,5,30,21,9,29,10,4,4,2,17,9,8,16,10,3,4,3,13,12,1,13,,,Boleyn Ground,London
2000/01,20,2,Aston Villa,9,19,7,8,4,23,18,5,29,9,4,4,1,14,7,7,16,10,3,4,3,9,11,-2,13,Q,EU_IT,Villa Park,Birmingham
2000/01,20,31,Charlton Athletic,10,21,8,4,9,30,36,-6,28,10,6,3,1,17,7,10,21,11,2,1,8,13,29,-16,7,,,The Valley,London
2000/01,20,4,Chelsea,11,20,7,6,7,37,27,10,27,10,7,2,1,28,10,18,23,10,0,4,6,9,17,-8,4,,,Stamford Bridge,London
2000/01,20,20,Southampton,12,21,7,6,8,27,32,-5,27,11,6,1,4,18,15,3,19,10,1,5,4,9,17,-8,8,,,The Dell,Southampton
2000/01,20,21,Tottenham Hotspur,13,21,7,5,9,26,32,-6,26,10,7,3,0,18,7,11,24,11,0,2,9,8,25,-17,2,,,White Hart Lane,London
2000/01,20,9,Leeds United,14,19,7,4,8,26,27,-1,25,10,6,0,4,19,14,5,18,9,1,4,4,7,13,-6,7,,,Elland Road,Leeds
2000/01,20,7,Everton,15,20,6,4,10,21,32,-11,22,10,3,3,4,13,14,-1,12,10,3,1,6,8,18,-10,10,,,Goodison Park,Liverpool
2000/01,20,28,Derby County,16,21,4,8,9,23,36,-13,20,10,3,5,2,13,15,-2,14,11,1,3,7,10,21,-11,6,,,Pride Park,Derby
2000/01,20,5,Coventry City,17,21,5,5,11,20,36,-16,20,10,2,3,5,7,14,-7,9,11,3,2,6,13,22,-9,11,,,Highfield Road,Coventry
2000/01,20,13,Middlesbrough,18,21,4,7,10,22,29,-7,19,11,2,4,5,10,16,-6,10,10,2,3,5,12,13,-1,9,R,EN_D1,Riverside Stadium,Middlesbrough
2000/01,20,11,Manchester City,19,21,5,4,12,26,37,-11,19,11,3,2,6,16,15,1,11,10,2,2,6,10,22,-12,8,R,EN_D1,Maine Road,Manchester
2000/01,20,32,Bradford City,20,20,2,6,12,14,37,-23,12,10,2,4,4,10,14,-4,10,10,0,2,8,4,23,-19,2,R,EN_D1,Valley Parade,Bradford
2000/01,21,12,Manchester United,1,22,15,5,2,51,16,35,50,11,9,1,1,31,6,25,28,11,6,4,1,20,10,10,22,Q,EU_CL,Old Trafford,Manchester
2000/01,21,1,Arsenal,2,22,11,6,5,38,22,16,39,11,9,2,0,30,7,23,29,11,2,4,5,8,15,-7,10,Q,EU_CL,Highbury,London
2000/01,21,29,Sunderland,3,22,11,6,5,29,22,7,39,11,8,3,0,16,5,11,27,11,3,3,5,13,17,-4,12,Q,EU_CL,Stadium of Light,Sunderland
2000/01,21,8,Ipswich Town,4,22,11,4,7,33,26,7,37,11,5,4,2,17,10,7,19,11,6,0,5,16,16,0,18,Q,EU_UC,Portman Road,Ipswich
2000/01,21,10,Liverpool,5,21,11,3,7,39,26,13,36,11,9,1,1,25,8,17,28,10,2,2,6,14,18,-4,8,Q,EU_UC,Anfield,Liverpool
2000/01,21,26,Leicester City,6,21,10,5,6,24,23,1,35,11,6,3,2,16,12,4,21,10,4,2,4,8,11,-3,14,Q,EU_UC,Filbert Street,Leicester
2000/01,21,31,Charlton Athletic,7,22,9,4,9,31,36,-5,31,11,7,3,1,18,7,11,24,11,2,1,8,13,29,-16,7,,,The Valley,London
2000/01,21,23,Newcastle United,8,22,9,4,9,25,30,-5,31,11,6,2,3,15,11,4,20,11,3,2,6,10,19,-9,11,Q,EU_IT,St. James' Park,Newcastle
2000/01,21,4,Chelsea,9,21,8,6,7,38,27,11,30,11,8,2,1,29,10,19,26,10,0,4,6,9,17,-8,4,,,Stamford Bridge,London
2000/01,21,25,West Ham United,10,21,7,8,6,31,24,7,29,10,4,4,2,17,9,8,16,11,3,4,4,14,15,-1,13,,,Boleyn Ground,London
2000/01,21,2,Aston Villa,11,20,7,8,5,23,19,4,29,9,4,4,1,14,7,7,16,11,3,4,4,9,12,-3,13,Q,EU_IT,Villa Park,Birmingham
2000/01,21,21,Tottenham Hotspur,12,22,8,5,9,30,34,-4,29,11,8,3,0,22,9,13,27,11,0,2,9,8,25,-17,2,,,White Hart Lane,London
2000/01,21,20,Southampton,13,22,7,6,9,28,34,-6,27,11,6,1,4,18,15,3,19,11,1,5,5,10,19,-9,8,,,The Dell,Southampton
2000/01,21,9,Leeds United,14,20,7,5,8,27,28,-1,26,11,6,1,4,20,15,5,19,9,1,4,4,7,13,-6,7,,,Elland Road,Leeds
2000/01,21,28,Derby County,15,22,5,8,9,24,36,-12,23,11,4,5,2,14,15,-1,17,11,1,3,7,10,21,-11,6,,,Pride Park,Derby
2000/01,21,7,Everton,16,21,6,4,11,21,33,-12,22,10,3,3,4,13,14,-1,12,11,3,1,7,8,19,-11,10,,,Goodison Park,Liverpool
2000/01,21,5,Coventry City,17,22,5,6,11,21,37,-16,21,11,2,4,5,8,15,-7,10,11,3,2,6,13,22,-9,11,,,Highfield Road,Coventry
2000/01,21,13,Middlesbrough,18,22,4,8,10,23,30,-7,20,11,2,4,5,10,16,-6,10,11,2,4,5,13,14,-1,10,R,EN_D1,Riverside Stadium,Middlesbrough
2000/01,21,11,Manchester City,19,22,5,5,12,27,38,-11,20,11,3,2,6,16,15,1,11,11,2,3,6,11,23,-12,9,R,EN_D1,Maine Road,Manchester
2000/01,21,32,Bradford City,20,21,3,6,12,16,38,-22,15,10,2,4,4,10,14,-4,10,11,1,2,8,6,24,-18,5,R,EN_D1,Valley Parade,Bradford
2000/01,22,12,Manchester United,1,23,16,5,2,54,16,38,53,11,9,1,1,31,6,25,28,12,7,4,1,23,10,13,25,Q,EU_CL,Old Trafford,Manchester
2000/01,22,29,Sunderland,2,23,12,6,5,31,22,9,42,11,8,3,0,16,5,11,27,12,4,3,5,15,17,-2,15,Q,EU_CL,Stadium of Light,Sunderland
2000/01,22,1,Arsenal,3,23,11,7,5,39,23,16,40,12,9,3,0,31,8,23,30,11,2,4,5,8,15,-7,10,Q,EU_CL,Highbury,London
2000/01,22,8,Ipswich Town,4,23,12,4,7,35,26,9,40,12,6,4,2,19,10,9,22,11,6,0,5,16,16,0,18,Q,EU_UC,Portman Road,Ipswich
2000/01,22,10,Liverpool,5,22,12,3,7,42,26,16,39,11,9,1,1,25,8,17,28,11,3,2,6,17,18,-1,11,Q,EU_UC,Anfield,Liverpool
2000/01,22,26,Leicester City,6,22,10,5,7,24,25,-1,35,11,6,3,2,16,12,4,21,11,4,2,5,8,13,-5,14,Q,EU_UC,Filbert Street,Leicester
2000/01,22,23,Newcastle United,7,23,10,4,9,28,31,-3,34,12,7,2,3,18,12,6,23,11,3,2,6,10,19,-9,11,Q,EU_IT,St. James' Park,Newcastle
2000/01,22,31,Charlton Athletic,8,23,9,5,9,31,36,-5,32,11,7,3,1,18,7,11,24,12,2,2,8,13,29,-16,8,,,The Valley,London
2000/01,22,4,Chelsea,9,22,8,7,7,39,28,11,31,11,8,2,1,29,10,19,26,11,0,5,6,10,18,-8,5,,,Stamford Bridge,London
2000/01,22,21,Tottenham Hotspur,10,23,8,6,9,30,34,-4,30,11,8,3,0,22,9,13,27,12,0,3,9,8,25,-17,3,,,White Hart Lane,London
2000/01,22,25,West Ham United,11,22,7,8,7,31,26,5,29,11,4,4,3,17,11,6,16,11,3,4,4,14,15,-1,13,,,Boleyn Ground,London
2000/01,22,9,Leeds United,12,21,8,5,8,31,28,3,29,11,6,1,4,20,15,5,19,10,2,4,4,11,13,-2,10,,,Elland Road,Leeds
2000/01,22,2,Aston Villa,13,21,7,8,6,23,22,1,29,10,4,4,2,14,10,4,16,11,3,4,4,9,12,-3,13,Q,EU_IT,Villa Park,Birmingham
2000/01,22,20,Southampton,14,23,7,7,9,28,34,-6,28,12,6,2,4,18,15,3,20,11,1,5,5,10,19,-9,8,,,The Dell,Southampton
2000/01,22,13,Middlesbrough,15,23,5,8,10,27,30,-3,23,12,3,4,5,14,16,-2,13,11,2,4,5,13,14,-1,10,,,Riverside Stadium,Middlesbrough
2000/01,22,7,Everton,16,22,6,5,11,21,33,-12,23,11,3,4,4,13,14,-1,13,11,3,1,7,8,19,-11,10,,,Goodison Park,Liverpool
2000/01,22,28,Derby County,17,23,5,8,10,24,40,-16,23,11,4,5,2,14,15,-1,17,12,1,3,8,10,25,-15,6,,,Pride Park,Derby
2000/01,22,5,Coventry City,18,23,5,6,12,22,40,-18,21,11,2,4,5,8,15,-7,10,12,3,2,7,14,25,-11,11,R,EN_D1,Highfield Road,Coventry
2000/01,22,11,Manchester City,19,23,5,5,13,27,42,-15,20,12,3,2,7,16,19,-3,11,11,2,3,6,11,23,-12,9,R,EN_D1,Maine Road,Manchester
2000/01,22,32,Bradford City,20,22,3,6,13,16,41,-25,15,11,2,4,5,10,17,-7,10,11,1,2,8,6,24,-18,5,R,EN_D1,Valley Parade,Bradford
2000/01,23,12,Manchester United,1,24,17,5,2,56,16,40,56,12,10,1,1,33,6,27,31,12,7,4,1,23,10,13,25,Q,EU_CL,Old Trafford,Manchester
2000/01,23,29,Sunderland,2,24,12,7,5,31,22,9,43,12,8,4,0,16,5,11,28,12,4,3,5,15,17,-2,15,Q,EU_CL,Stadium of Light,Sunderland
2000/01,23,1,Arsenal,3,24,11,8,5,39,23,16,41,12,9,3,0,31,8,23,30,12,2,5,5,8,15,-7,11,Q,EU_CL,Highbury,London
2000/01,23,10,Liverpool,4,23,12,4,7,42,26,16,40,12,9,2,1,25,8,17,29,11,3,2,6,17,18,-1,11,Q,EU_UC,Anfield,Liverpool
2000/01,23,8,Ipswich Town,5,24,12,4,8,36,30,6,40,12,6,4,2,19,10,9,22,12,6,0,6,17,20,-3,18,Q,EU_UC,Portman Road,Ipswich
2000/01,23,23,Newcastle United,6,24,11,4,9,31,32,-1,37,12,7,2,3,18,12,6,23,12,4,2,6,13,20,-7,14,"Q,Q","EU_UC,EU_IT",St. James' Park,Newcastle
2000/01,23,26,Leicester City,7,23,10,6,7,24,25,-1,36,12,6,4,2,16,12,4,22,11,4,2,5,8,13,-5,14,,,Filbert Street,Leicester
2000/01,23,4,Chelsea,8,23,9,7,7,43,29,14,34,12,9,2,1,33,11,22,29,11,0,5,6,10,18,-8,5,,,Stamford Bridge,London
2000/01,23,31,Charlton Athletic,9,24,9,6,9,32,37,-5,33,12,7,4,1,19,8,11,25,12,2,2,8,13,29,-16,8,,,The Valley,London
2000/01,23,9,Leeds United,10,23,9,5,9,34,32,2,32,12,6,1,5,21,18,3,19,11,3,4,4,13,14,-1,13,,,Elland Road,Leeds
2000/01,23,21,Tottenham Hotspur,11,24,8,7,9,30,34,-4,31,12,8,4,0,22,9,13,28,12,0,3,9,8,25,-17,3,,,White Hart Lane,London
2000/01,23,25,West Ham United,12,23,7,9,7,32,27,5,30,11,4,4,3,17,11,6,16,12,3,5,4,15,16,-1,14,,,Boleyn Ground,London
2000/01,23,2,Aston Villa,13,23,7,8,8,24,26,-2,29,11,4,4,3,15,12,3,16,12,3,4,5,9,14,-5,13,Q,EU_IT,Villa Park,Birmingham
2000/01,23,20,Southampton,14,24,7,8,9,28,34,-6,29,12,6,2,4,18,15,3,20,12,1,6,5,10,19,-9,9,,,The Dell,Southampton
2000/01,23,7,Everton,15,23,7,5,11,24,34,-10,26,11,3,4,4,13,14,-1,13,12,4,1,7,11,20,-9,13,,,Goodison Park,Liverpool
2000/01,23,13,Middlesbrough,16,24,5,9,10,27,30,-3,24,12,3,4,5,14,16,-2,13,12,2,5,5,13,14,-1,11,,,Riverside Stadium,Middlesbrough
2000/01,23,28,Derby County,17,24,5,9,10,25,41,-16,24,12,4,6,2,15,16,-1,18,12,1,3,8,10,25,-15,6,,,Pride Park,Derby
2000/01,23,11,Manchester City,18,24,5,6,13,28,43,-15,21,12,3,2,7,16,19,-3,11,12,2,4,6,12,24,-12,10,R,EN_D1,Maine Road,Manchester
2000/01,23,5,Coventry City,19,24,5,6,13,23,43,-20,21,12,2,4,6,9,18,-9,10,12,3,2,7,14,25,-11,11,R,EN_D1,Highfield Road,Coventry
2000/01,23,32,Bradford City,20,23,3,7,13,16,41,-25,16,11,2,4,5,10,17,-7,10,12,1,3,8,6,24,-18,6,R,EN_D1,Valley Parade,Bradford
2000/01,24,12,Manchester United,1,25,18,5,2,57,16,41,59,12,10,1,1,33,6,27,31,13,8,4,1,24,10,14,28,Q,EU_CL,Old Trafford,Manchester
2000/01,24,1,Arsenal,2,25,12,8,5,41,23,18,44,13,10,3,0,33,8,25,33,12,2,5,5,8,15,-7,11,Q,EU_CL,Highbury,London
2000/01,24,29,Sunderland,3,25,12,7,6,31,23,8,43,13,8,4,1,16,6,10,28,12,4,3,5,15,17,-2,15,Q,EU_CL,Stadium of Light,Sunderland
2000/01,24,10,Liverpool,4,24,12,5,7,43,27,16,41,12,9,2,1,25,8,17,29,12,3,3,6,18,19,-1,12,Q,EU_UC,Anfield,Liverpool
2000/01,24,8,Ipswich Town,5,24,12,4,8,36,30,6,40,12,6,4,2,19,10,9,22,12,6,0,6,17,20,-3,18,Q,EU_UC,Portman Road,Ipswich
2000/01,24,4,Chelsea,6,24,10,7,7,46,30,16,37,13,10,2,1,36,12,24,32,11,0,5,6,10,18,-8,5,Q,EU_UC,Stamford Bridge,London
2000/01,24,23,Newcastle United,7,25,11,4,10,32,35,-3,37,12,7,2,3,18,12,6,23,13,4,2,7,14,23,-9,14,Q,EU_IT,St. James' Park,Newcastle
2000/01,24,26,Leicester City,8,24,10,6,8,24,26,-2,36,12,6,4,2,16,12,4,22,12,4,2,6,8,14,-6,14,,,Filbert Street,Leicester
2000/01,24,31,Charlton Athletic,9,25,10,6,9,34,38,-4,36,13,8,4,1,21,9,12,28,12,2,2,8,13,29,-16,8,,,The Valley,London
2000/01,24,9,Leeds United,10,24,10,5,9,35,32,3,35,13,7,1,5,22,18,4,22,11,3,4,4,13,14,-1,13,,,Elland Road,Leeds
2000/01,24,21,Tottenham Hotspur,11,25,8,8,9,30,34,-4,32,12,8,4,0,22,9,13,28,13,0,4,9,8,25,-17,4,,,White Hart Lane,London
2000/01,24,20,Southampton,12,25,8,8,9,29,34,-5,32,13,7,2,4,19,15,4,23,12,1,6,5,10,19,-9,9,,,The Dell,Southampton
2000/01,24,25,West Ham United,13,24,7,10,7,32,27,5,31,12,4,5,3,17,11,6,17,12,3,5,4,15,16,-1,14,,,Boleyn Ground,London
2000/01,24,2,Aston Villa,14,23,7,8,8,24,26,-2,29,11,4,4,3,15,12,3,16,12,3,4,5,9,14,-5,13,Q,EU_IT,Villa Park,Birmingham
2000/01,24,7,Everton,15,24,7,6,11,26,36,-10,27,12,3,5,4,15,16,-1,14,12,4,1,7,11,20,-9,13,,,Goodison Park,Liverpool
2000/01,24,13,Middlesbrough,16,25,5,10,10,29,32,-3,25,12,3,4,5,14,16,-2,13,13,2,6,5,15,16,-1,12,,,Riverside Stadium,Middlesbrough
2000/01,24,28,Derby County,17,25,5,9,11,26,43,-17,24,12,4,6,2,15,16,-1,18,13,1,3,9,11,27,-16,6,,,Pride Park,Derby
2000/01,24,11,Manchester City,18,25,5,7,13,29,44,-15,22,13,3,3,7,17,20,-3,12,12,2,4,6,12,24,-12,10,R,EN_D1,Maine Road,Manchester
2000/01,24,5,Coventry City,19,25,5,6,14,23,44,-21,21,12,2,4,6,9,18,-9,10,13,3,2,8,14,26,-12,11,R,EN_D1,Highfield Road,Coventry
2000/01,24,32,Bradford City,20,24,3,7,14,16,43,-27,16,11,2,4,5,10,17,-7,10,13,1,3,9,6,26,-20,6,R,EN_D1,Valley Parade,Bradford
2000/01,25,12,Manchester United,1,26,19,5,2,58,16,42,62,13,11,1,1,34,6,28,34,13,8,4,1,24,10,14,28,Q,EU_CL,Old Trafford,Manchester
2000/01,25,1,Arsenal,2,26,13,8,5,42,23,19,47,13,10,3,0,33,8,25,33,13,3,5,5,9,15,-6,14,Q,EU_CL,Highbury,London
2000/01,25,10,Liverpool,3,25,13,5,7,46,27,19,44,13,10,2,1,28,8,20,32,12,3,3,6,18,19,-1,12,Q,EU_CL,Anfield,Liverpool
2000/01,25,29,Sunderland,4,26,12,7,7,31,24,7,43,13,8,4,1,16,6,10,28,13,4,3,6,15,18,-3,15,Q,EU_UC,Stadium of Light,Sunderland
2000/01,25,8,Ipswich Town,5,25,12,4,9,37,32,5,40,13,6,4,3,20,12,8,22,12,6,0,6,17,20,-3,18,Q,EU_UC,Portman Road,Ipswich
2000/01,25,9,Leeds United,6,26,11,6,9,39,35,4,39,13,7,1,5,22,18,4,22,13,4,5,4,17,17,0,17,Q,EU_UC,Elland Road,Leeds
2000/01,25,26,Leicester City,7,25,11,6,8,26,27,-1,39,13,7,4,2,18,13,5,25,12,4,2,6,8,14,-6,14,,,Filbert Street,Leicester
2000/01,25,4,Chelsea,8,25,10,7,8,47,32,15,37,13,10,2,1,36,12,24,32,12,0,5,7,11,20,-9,5,,,Stamford Bridge,London
2000/01,25,23,Newcastle United,9,25,11,4,10,32,35,-3,37,12,7,2,3,18,12,6,23,13,4,2,7,14,23,-9,14,Q,EU_IT,St. James' Park,Newcastle
2000/01,25,31,Charlton Athletic,10,26,10,7,9,34,38,-4,37,13,8,4,1,21,9,12,28,13,2,3,8,13,29,-16,9,,,The Valley,London
2000/01,25,21,Tottenham Hotspur,11,26,8,9,9,30,34,-4,33,13,8,5,0,22,9,13,29,13,0,4,9,8,25,-17,4,,,White Hart Lane,London
2000/01,25,2,Aston Villa,12,24,8,8,8,27,26,1,32,11,4,4,3,15,12,3,16,13,4,4,5,12,14,-2,16,Q,EU_IT,Villa Park,Birmingham
2000/01,25,20,Southampton,13,25,8,8,9,29,34,-5,32,13,7,2,4,19,15,4,23,12,1,6,5,10,19,-9,9,,,The Dell,Southampton
2000/01,25,25,West Ham United,14,25,7,10,8,32,30,2,31,12,4,5,3,17,11,6,17,13,3,5,5,15,19,-4,14,,,Boleyn Ground,London
2000/01,25,7,Everton,15,26,7,7,12,28,39,-11,28,13,3,6,4,17,18,-1,15,13,4,1,8,11,21,-10,13,,,Goodison Park,Liverpool
2000/01,25,28,Derby County,16,26,6,9,11,27,43,-16,27,13,5,6,2,16,16,0,21,13,1,3,9,11,27,-16,6,,,Pride Park,Derby
2000/01,25,13,Middlesbrough,17,26,5,11,10,30,33,-3,26,13,3,5,5,15,17,-2,14,13,2,6,5,15,16,-1,12,,,Riverside Stadium,Middlesbrough
2000/01,25,11,Manchester City,18,26,5,8,13,30,45,-15,23,13,3,3,7,17,20,-3,12,13,2,5,6,13,25,-12,11,R,EN_D1,Maine Road,Manchester
2000/01,25,5,Coventry City,19,26,5,6,15,23,45,-22,21,13,2,4,7,9,19,-10,10,13,3,2,8,14,26,-12,11,R,EN_D1,Highfield Road,Coventry
2000/01,25,32,Bradford City,20,25,3,7,15,16,46,-30,16,12,2,4,6,10,20,-10,10,13,1,3,9,6,26,-20,6,R,EN_D1,Valley Parade,Bradford
2000/01,26,12,Manchester United,1,27,19,6,2,59,17,42,63,13,11,1,1,34,6,28,34,14,8,5,1,25,11,14,29,Q,EU_CL,Old Trafford,Manchester
2000/01,26,1,Arsenal,2,27,14,8,5,43,23,20,50,14,11,3,0,34,8,26,36,13,3,5,5,9,15,-6,14,Q,EU_CL,Highbury,London
2000/01,26,10,Liverpool,3,26,13,6,7,47,28,19,45,13,10,2,1,28,8,20,32,13,3,4,6,19,20,-1,13,Q,EU_CL,Anfield,Liverpool
2000/01,26,29,Sunderland,4,27,12,8,7,32,25,7,44,14,8,5,1,17,7,10,29,13,4,3,6,15,18,-3,15,Q,EU_UC,Stadium of Light,Sunderland
2000/01,26,9,Leeds United,5,27,11,7,9,39,35,4,40,14,7,2,5,22,18,4,23,13,4,5,4,17,17,0,17,Q,EU_UC,Elland Road,Leeds
2000/01,26,8,Ipswich Town,6,26,12,4,10,37,33,4,40,13,6,4,3,20,12,8,22,13,6,0,7,17,21,-4,18,Q,EU_UC,Portman Road,Ipswich
2000/01,26,31,Charlton Athletic,7,27,11,7,9,36,38,-2,40,14,9,4,1,23,9,14,31,13,2,3,8,13,29,-16,9,,,The Valley,London
2000/01,26,26,Leicester City,8,26,11,6,9,27,29,-2,39,13,7,4,2,18,13,5,25,13,4,2,7,9,16,-7,14,,,Filbert Street,Leicester
2000/01,26,4,Chelsea,9,26,10,8,8,48,33,15,38,14,10,3,1,37,13,24,33,12,0,5,7,11,20,-9,5,,,Stamford Bridge,London
2000/01,26,23,Newcastle United,10,26,11,4,11,32,37,-5,37,12,7,2,3,18,12,6,23,14,4,2,8,14,25,-11,14,Q,EU_IT,St. James' Park,Newcastle
2000/01,26,21,Tottenham Hotspur,11,27,9,9,9,31,34,-3,36,13,8,5,0,22,9,13,29,14,1,4,9,9,25,-16,7,,,White Hart Lane,London
2000/01,26,20,Southampton,12,26,9,8,9,31,34,-3,35,14,8,2,4,21,15,6,26,12,1,6,5,10,19,-9,9,,,The Dell,Southampton
2000/01,26,2,Aston Villa,13,25,8,9,8,28,27,1,33,12,4,5,3,16,13,3,17,13,4,4,5,12,14,-2,16,Q,EU_IT,Villa Park,Birmingham
2000/01,26,25,West Ham United,14,26,7,11,8,33,31,2,32,13,4,6,3,18,12,6,18,13,3,5,5,15,19,-4,14,,,Boleyn Ground,London
2000/01,26,7,Everton,15,27,8,7,12,30,40,-10,31,14,4,6,4,19,19,0,18,13,4,1,8,11,21,-10,13,,,Goodison Park,Liverpool
2000/01,26,28,Derby County,16,27,6,10,11,27,43,-16,28,13,5,6,2,16,16,0,21,14,1,4,9,11,27,-16,7,,,Pride Park,Derby
2000/01,26,13,Middlesbrough,17,27,5,12,10,31,34,-3,27,13,3,5,5,15,17,-2,14,14,2,7,5,16,17,-1,13,,,Riverside Stadium,Middlesbrough
2000/01,26,11,Manchester City,18,27,5,8,14,30,46,-16,23,14,3,3,8,17,21,-4,12,13,2,5,6,13,25,-12,11,R,EN_D1,Maine Road,Manchester
2000/01,26,5,Coventry City,19,27,5,7,15,24,46,-22,22,13,2,4,7,9,19,-10,10,14,3,3,8,15,27,-12,12,R,EN_D1,Highfield Road,Coventry
2000/01,26,32,Bradford City,20,26,3,7,16,16,48,-32,16,12,2,4,6,10,20,-10,10,14,1,3,10,6,28,-22,6,R,EN_D1,Valley Parade,Bradford
2000/01,27,12,Manchester United,1,28,20,6,2,65,18,47,66,14,12,1,1,40,7,33,37,14,8,5,1,25,11,14,29,Q,EU_CL,Old Trafford,Manchester
2000/01,27,1,Arsenal,2,28,14,8,6,44,29,15,50,14,11,3,0,34,8,26,36,14,3,5,6,10,21,-11,14,Q,EU_CL,Highbury,London
2000/01,27,10,Liverpool,3,26,13,6,7,47,28,19,45,13,10,2,1,28,8,20,32,13,3,4,6,19,20,-1,13,Q,EU_CL,Anfield,Liverpool
2000/01,27,29,Sunderland,4,28,12,8,8,32,27,5,44,14,8,5,1,17,7,10,29,14,4,3,7,15,20,-5,15,Q,EU_UC,Stadium of Light,Sunderland
2000/01,27,8,Ipswich Town,5,27,13,4,10,39,33,6,43,14,7,4,3,22,12,10,25,13,6,0,7,17,21,-4,18,Q,EU_UC,Portman Road,Ipswich
2000/01,27,9,Leeds United,6,28,12,7,9,41,36,5,43,14,7,2,5,22,18,4,23,14,5,5,4,19,18,1,20,Q,EU_UC,Elland Road,Leeds
2000/01,27,26,Leicester City,7,27,12,6,9,29,29,0,42,14,8,4,2,20,13,7,28,13,4,2,7,9,16,-7,14,,,Filbert Street,Leicester
2000/01,27,31,Charlton Athletic,8,28,11,8,9,38,40,-2,41,14,9,4,1,23,9,14,31,14,2,4,8,15,31,-16,10,,,The Valley,London
2000/01,27,4,Chelsea,9,26,10,8,8,48,33,15,38,14,10,3,1,37,13,24,33,12,0,5,7,11,20,-9,5,,,Stamford Bridge,London
2000/01,27,20,Southampton,10,27,10,8,9,32,34,-2,38,14,8,2,4,21,15,6,26,13,2,6,5,11,19,-8,12,,,The Dell,Southampton
2000/01,27,23,Newcastle United,11,27,11,4,12,32,38,-6,37,13,7,2,4,18,13,5,23,14,4,2,8,14,25,-11,14,Q,EU_IT,St. James' Park,Newcastle
2000/01,27,21,Tottenham Hotspur,12,28,9,9,10,32,36,-4,36,14,8,5,1,23,11,12,29,14,1,4,9,9,25,-16,7,,,White Hart Lane,London
2000/01,27,25,West Ham United,13,27,8,11,8,35,32,3,35,13,4,6,3,18,12,6,18,14,4,5,5,17,20,-3,17,,,Boleyn Ground,London
2000/01,27,2,Aston Villa,14,26,8,9,9,28,28,0,33,12,4,5,3,16,13,3,17,14,4,4,6,12,15,-3,16,Q,EU_IT,Villa Park,Birmingham
2000/01,27,7,Everton,15,28,8,7,13,30,42,-12,31,14,4,6,4,19,19,0,18,14,4,1,9,11,23,-12,13,,,Goodison Park,Liverpool
2000/01,27,28,Derby County,16,28,7,10,11,28,43,-15,31,14,6,6,2,17,16,1,24,14,1,4,9,11,27,-16,7,,,Pride Park,Derby
2000/01,27,13,Middlesbrough,17,28,5,12,11,31,35,-4,27,14,3,5,6,15,18,-3,14,14,2,7,5,16,17,-1,13,,,Riverside Stadium,Middlesbrough
2000/01,27,11,Manchester City,18,28,6,8,14,31,46,-15,26,14,3,3,8,17,21,-4,12,14,3,5,6,14,25,-11,14,R,EN_D1,Maine Road,Manchester
2000/01,27,5,Coventry City,19,28,5,8,15,26,48,-22,23,14,2,5,7,11,21,-10,11,14,3,3,8,15,27,-12,12,R,EN_D1,Highfield Road,Coventry
2000/01,27,32,Bradford City,20,27,3,7,17,17,50,-33,16,13,2,4,7,11,22,-11,10,14,1,3,10,6,28,-22,6,R,EN_D1,Valley Parade,Bradford
2000/01,28,12,Manchester United,1,29,20,7,2,66,19,47,67,14,12,1,1,40,7,33,37,15,8,6,1,26,12,14,30,Q,EU_CL,Old Trafford,Manchester
2000/01,28,1,Arsenal,2,29,15,8,6,47,29,18,53,15,12,3,0,37,8,29,39,14,3,5,6,10,21,-11,14,Q,EU_CL,Highbury,London
2000/01,28,8,Ipswich Town,3,29,14,4,11,43,36,7,46,15,8,4,3,25,13,12,28,14,6,0,8,18,23,-5,18,Q,EU_CL,Portman Road,Ipswich
2000/01,28,10,Liverpool,4,27,13,6,8,47,30,17,45,13,10,2,1,28,8,20,32,14,3,4,7,19,22,-3,13,Q,EU_UC,Anfield,Liverpool
2000/01,28,29,Sunderland,5,29,12,9,8,33,28,5,45,15,8,6,1,18,8,10,30,14,4,3,7,15,20,-5,15,Q,EU_UC,Stadium of Light,Sunderland
2000/01,28,26,Leicester City,6,28,13,6,9,31,29,2,45,15,9,4,2,22,13,9,31,13,4,2,7,9,16,-7,14,Q,EU_UC,Filbert Street,Leicester
2000/01,28,9,Leeds United,7,29,12,8,9,42,37,5,44,15,7,3,5,23,19,4,24,14,5,5,4,19,18,1,20,,,Elland Road,Leeds
2000/01,28,4,Chelsea,8,28,11,9,8,50,33,17,42,14,10,3,1,37,13,24,33,14,1,6,7,13,20,-7,9,,,Stamford Bridge,London
2000/01,28,31,Charlton Athletic,9,29,11,9,9,38,40,-2,42,14,9,4,1,23,9,14,31,15,2,5,8,15,31,-16,11,,,The Valley,London
2000/01,28,20,Southampton,10,28,11,8,9,33,34,-1,41,14,8,2,4,21,15,6,26,14,3,6,5,12,19,-7,15,,,The Dell,Southampton
2000/01,28,23,Newcastle United,11,28,11,5,12,33,39,-6,38,13,7,2,4,18,13,5,23,15,4,3,8,15,26,-11,15,Q,EU_IT,St. James' Park,Newcastle
2000/01,28,2,Aston Villa,12,28,9,10,9,31,30,1,37,13,5,5,3,18,14,4,20,15,4,5,6,13,16,-3,17,Q,EU_IT,Villa Park,Birmingham
2000/01,28,21,Tottenham Hotspur,13,29,9,9,11,33,38,-5,36,14,8,5,1,23,11,12,29,15,1,4,10,10,27,-17,7,,,White Hart Lane,London
2000/01,28,25,West Ham United,14,29,8,11,10,35,37,-2,35,14,4,6,4,18,14,4,18,15,4,5,6,17,23,-6,17,,,Boleyn Ground,London
2000/01,28,28,Derby County,15,29,8,10,11,30,44,-14,34,15,7,6,2,19,17,2,27,14,1,4,9,11,27,-16,7,,,Pride Park,Derby
2000/01,28,7,Everton,16,29,8,8,13,31,43,-12,32,15,4,7,4,20,20,0,19,14,4,1,9,11,23,-12,13,,,Goodison Park,Liverpool
2000/01,28,13,Middlesbrough,17,29,5,13,11,31,35,-4,28,15,3,6,6,15,18,-3,15,14,2,7,5,16,17,-1,13,,,Riverside Stadium,Middlesbrough
2000/01,28,11,Manchester City,18,29,6,8,15,31,47,-16,26,15,3,3,9,17,22,-5,12,14,3,5,6,14,25,-11,14,R,EN_D1,Maine Road,Manchester
2000/01,28,5,Coventry City,19,29,5,9,15,26,48,-22,24,15,2,6,7,11,21,-10,12,14,3,3,8,15,27,-12,12,R,EN_D1,Highfield Road,Coventry
2000/01,28,32,Bradford City,20,28,3,7,18,18,53,-35,16,13,2,4,7,11,22,-11,10,15,1,3,11,7,31,-24,6,R,EN_D1,Valley Parade,Bradford
2000/01,29,12,Manchester United,1,30,21,7,2,68,19,49,70,15,13,1,1,42,7,35,40,15,8,6,1,26,12,14,30,Q,EU_CL,Old Trafford,Manchester
2000/01,29,1,Arsenal,2,30,15,9,6,47,29,18,54,15,12,3,0,37,8,29,39,15,3,6,6,10,21,-11,15,Q,EU_CL,Highbury,London
2000/01,29,8,Ipswich Town,3,30,15,4,11,44,36,8,49,15,8,4,3,25,13,12,28,15,7,0,8,19,23,-4,21,Q,EU_CL,Portman Road,Ipswich
2000/01,29,29,Sunderland,4,30,13,9,8,37,30,7,48,15,8,6,1,18,8,10,30,15,5,3,7,19,22,-3,18,Q,EU_UC,Stadium of Light,Sunderland
2000/01,29,9,Leeds United,5,30,13,8,9,44,38,6,47,15,7,3,5,23,19,4,24,15,6,5,4,21,19,2,23,Q,EU_UC,Elland Road,Leeds
2000/01,29,10,Liverpool,6,28,13,7,8,48,31,17,46,14,10,3,1,29,9,20,33,14,3,4,7,19,22,-3,13,Q,EU_UC,Anfield,Liverpool
2000/01,29,26,Leicester City,7,29,13,6,10,31,31,0,45,15,9,4,2,22,13,9,31,14,4,2,8,9,18,-9,14,,,Filbert Street,Leicester
2000/01,29,20,Southampton,8,29,12,8,9,34,34,0,44,15,9,2,4,22,15,7,29,14,3,6,5,12,19,-7,15,,,The Dell,Southampton
2000/01,29,4,Chelsea,9,29,11,9,9,52,37,15,42,15,10,3,2,39,17,22,33,14,1,6,7,13,20,-7,9,,,Stamford Bridge,London
2000/01,29,31,Charlton Athletic,10,30,11,9,10,39,42,-3,42,15,9,4,2,24,11,13,31,15,2,5,8,15,31,-16,11,,,The Valley,London
2000/01,29,21,Tottenham Hotspur,11,30,10,9,11,36,38,-2,39,15,9,5,1,26,11,15,32,15,1,4,10,10,27,-17,7,,,White Hart Lane,London
2000/01,29,2,Aston Villa,12,29,9,11,9,31,30,1,38,14,5,6,3,18,14,4,21,15,4,5,6,13,16,-3,17,Q,EU_IT,Villa Park,Birmingham
2000/01,29,23,Newcastle United,13,29,11,5,13,34,41,-7,38,14,7,2,5,19,15,4,23,15,4,3,8,15,26,-11,15,Q,EU_IT,St. James' Park,Newcastle
2000/01,29,25,West Ham United,14,30,8,11,11,35,38,-3,35,15,4,6,5,18,15,3,18,15,4,5,6,17,23,-6,17,,,Boleyn Ground,London
2000/01,29,28,Derby County,15,30,8,11,11,31,45,-14,35,15,7,6,2,19,17,2,27,15,1,5,9,12,28,-16,8,,,Pride Park,Derby
2000/01,29,7,Everton,16,30,8,8,14,31,44,-13,32,15,4,7,4,20,20,0,19,15,4,1,10,11,24,-13,13,,,Goodison Park,Liverpool
2000/01,29,13,Middlesbrough,17,30,6,13,11,33,36,-3,31,15,3,6,6,15,18,-3,15,15,3,7,5,18,18,0,16,,,Riverside Stadium,Middlesbrough
2000/01,29,11,Manchester City,18,30,6,9,15,33,49,-16,27,15,3,3,9,17,22,-5,12,15,3,6,6,16,27,-11,15,R,EN_D1,Maine Road,Manchester
2000/01,29,5,Coventry City,19,30,5,9,16,26,51,-25,24,15,2,6,7,11,21,-10,12,15,3,3,9,15,30,-15,12,R,EN_D1,Highfield Road,Coventry
2000/01,29,32,Bradford City,20,29,3,8,18,20,55,-35,17,14,2,5,7,13,24,-11,11,15,1,3,11,7,31,-24,6,R,EN_D1,Valley Parade,Bradford
2000/01,30,12,Manchester United,1,31,21,7,3,68,21,47,70,15,13,1,1,42,7,35,40,16,8,6,2,26,14,12,30,Q,EU_CL,Old Trafford,Manchester
2000/01,30,1,Arsenal,2,31,16,9,6,49,29,20,57,16,13,3,0,39,8,31,42,15,3,6,6,10,21,-11,15,Q,EU_CL,Highbury,London
2000/01,30,8,Ipswich Town,3,31,16,4,11,47,36,11,52,15,8,4,3,25,13,12,28,16,8,0,8,22,23,-1,24,Q,EU_CL,Portman Road,Ipswich
2000/01,30,9,Leeds United,4,31,14,8,9,46,38,8,50,15,7,3,5,23,19,4,24,16,7,5,4,23,19,4,26,Q,EU_UC,Elland Road,Leeds
2000/01,30,10,Liverpool,5,29,14,7,8,50,31,19,49,15,11,3,1,31,9,22,36,14,3,4,7,19,22,-3,13,Q,EU_UC,Anfield,Liverpool
2000/01,30,29,Sunderland,6,31,13,9,9,37,32,5,48,16,8,6,2,18,10,8,30,15,5,3,7,19,22,-3,18,Q,EU_UC,Stadium of Light,Sunderland
2000/01,30,4,Chelsea,7,30,12,9,9,54,38,16,45,16,11,3,2,41,18,23,36,14,1,6,7,13,20,-7,9,,,Stamford Bridge,London
2000/01,30,31,Charlton Athletic,8,31,12,9,10,41,42,-1,45,16,10,4,2,26,11,15,34,15,2,5,8,15,31,-16,11,,,The Valley,London
2000/01,30,26,Leicester City,9,31,13,6,12,32,35,-3,45,15,9,4,2,22,13,9,31,16,4,2,10,10,22,-12,14,,,Filbert Street,Leicester
2000/01,30,2,Aston Villa,10,31,11,11,9,36,32,4,44,15,6,6,3,20,15,5,24,16,5,5,6,16,17,-1,20,Q,EU_IT,Villa Park,Birmingham
2000/01,30,20,Southampton,11,30,12,8,10,34,37,-3,44,16,9,2,5,22,18,4,29,14,3,6,5,12,19,-7,15,,,The Dell,Southampton
2000/01,30,21,Tottenham Hotspur,12,31,10,9,12,36,40,-4,39,15,9,5,1,26,11,15,32,16,1,4,11,10,29,-19,7,,,White Hart Lane,London
2000/01,30,23,Newcastle United,13,30,11,6,13,36,43,-7,39,14,7,2,5,19,15,4,23,16,4,4,8,17,28,-11,16,Q,EU_IT,St. James' Park,Newcastle
2000/01,30,25,West Ham United,14,31,8,11,12,35,40,-5,35,16,4,6,6,18,17,1,18,15,4,5,6,17,23,-6,17,,,Boleyn Ground,London
2000/01,30,7,Everton,15,31,9,8,14,33,44,-11,35,15,4,7,4,20,20,0,19,16,5,1,10,13,24,-11,16,,,Goodison Park,Liverpool
2000/01,30,28,Derby County,16,31,8,11,12,31,47,-16,35,15,7,6,2,19,17,2,27,16,1,5,10,12,30,-18,8,,,Pride Park,Derby
2000/01,30,13,Middlesbrough,17,31,6,13,12,34,38,-4,31,15,3,6,6,15,18,-3,15,16,3,7,6,19,20,-1,16,,,Riverside Stadium,Middlesbrough
2000/01,30,11,Manchester City,18,31,6,9,16,34,52,-18,27,16,3,3,10,18,25,-7,12,15,3,6,6,16,27,-11,15,R,EN_D1,Maine Road,Manchester
2000/01,30,5,Coventry City,19,31,6,9,16,28,51,-23,27,16,3,6,7,13,21,-8,15,15,3,3,9,15,30,-15,12,R,EN_D1,Highfield Road,Coventry
2000/01,30,32,Bradford City,20,30,3,9,18,22,57,-35,18,15,2,6,7,15,26,-11,12,15,1,3,11,7,31,-24,6,R,EN_D1,Valley Parade,Bradford
2000/01,31,12,Manchester United,1,32,22,7,3,70,22,48,73,16,14,1,1,44,8,36,43,16,8,6,2,26,14,12,30,Q,EU_CL,Old Trafford,Manchester
2000/01,31,1,Arsenal,2,32,17,9,6,53,29,24,60,16,13,3,0,39,8,31,42,16,4,6,6,14,21,-7,18,Q,EU_CL,Highbury,London
2000/01,31,8,Ipswich Town,3,32,16,5,11,48,37,11,53,16,8,5,3,26,14,12,29,16,8,0,8,22,23,-1,24,Q,EU_CL,Portman Road,Ipswich
2000/01,31,9,Leeds United,4,32,15,8,9,48,38,10,53,16,8,3,5,25,19,6,27,16,7,5,4,23,19,4,26,Q,EU_UC,Elland Road,Leeds
2000/01,31,10,Liverpool,5,30,14,8,8,51,32,19,50,15,11,3,1,31,9,22,36,15,3,5,7,20,23,-3,14,Q,EU_UC,Anfield,Liverpool
2000/01,31,29,Sunderland,6,32,13,10,9,37,32,5,49,16,8,6,2,18,10,8,30,16,5,4,7,19,22,-3,19,Q,EU_UC,Stadium of Light,Sunderland
2000/01,31,4,Chelsea,7,31,13,9,9,58,38,20,48,16,11,3,2,41,18,23,36,15,2,6,7,17,20,-3,12,,,Stamford Bridge,London
2000/01,31,2,Aston Villa,8,32,11,12,9,38,34,4,45,16,6,7,3,22,17,5,25,16,5,5,6,16,17,-1,20,Q,EU_IT,Villa Park,Birmingham
2000/01,31,31,Charlton Athletic,9,32,12,9,11,42,44,-2,45,16,10,4,2,26,11,15,34,16,2,5,9,16,33,-17,11,,,The Valley,London
2000/01,31,26,Leicester City,10,32,13,6,13,33,38,-5,45,16,9,4,3,23,16,7,31,16,4,2,10,10,22,-12,14,,,Filbert Street,Leicester
2000/01,31,20,Southampton,11,31,12,8,11,34,39,-5,44,16,9,2,5,22,18,4,29,15,3,6,6,12,21,-9,15,,,The Dell,Southampton
2000/01,31,21,Tottenham Hotspur,12,32,11,9,12,38,41,-3,42,16,10,5,1,28,12,16,35,16,1,4,11,10,29,-19,7,,,White Hart Lane,London
2000/01,31,23,Newcastle United,13,30,11,6,13,36,43,-7,39,14,7,2,5,19,15,4,23,16,4,4,8,17,28,-11,16,Q,EU_IT,St. James' Park,Newcastle
2000/01,31,7,Everton,14,32,10,8,14,36,45,-9,38,16,5,7,4,23,21,2,22,16,5,1,10,13,24,-11,16,,,Goodison Park,Liverpool
2000/01,31,25,West Ham United,15,32,8,12,12,37,42,-5,36,16,4,6,6,18,17,1,18,16,4,6,6,19,25,-6,18,,,Boleyn Ground,London
2000/01,31,28,Derby County,16,32,8,11,13,31,51,-20,35,16,7,6,3,19,21,-2,27,16,1,5,10,12,30,-18,8,,,Pride Park,Derby
2000/01,31,13,Middlesbrough,17,32,6,14,12,34,38,-4,32,16,3,7,6,15,18,-3,16,16,3,7,6,19,20,-1,16,,,Riverside Stadium,Middlesbrough
2000/01,31,5,Coventry City,18,32,7,9,16,31,52,-21,30,16,3,6,7,13,21,-8,15,16,4,3,9,18,31,-13,15,R,EN_D1,Highfield Road,Coventry
2000/01,31,11,Manchester City,19,33,6,9,18,35,59,-24,27,17,3,3,11,18,29,-11,12,16,3,6,7,17,30,-13,15,R,EN_D1,Maine Road,Manchester
2000/01,31,32,Bradford City,20,31,3,9,19,23,59,-36,18,15,2,6,7,15,26,-11,12,16,1,3,12,8,33,-25,6,R,EN_D1,Valley Parade,Bradford
2000/01,32,12,Manchester United,1,33,23,7,3,74,24,50,76,17,15,1,1,48,10,38,46,16,8,6,2,26,14,12,30,Q,EU_CL,Old Trafford,Manchester
2000/01,32,1,Arsenal,2,33,17,9,7,53,32,21,60,17,13,3,1,39,11,28,42,16,4,6,6,14,21,-7,18,Q,EU_CL,Highbury,London
2000/01,32,8,Ipswich Town,3,33,17,5,11,49,37,12,56,17,9,5,3,27,14,13,32,16,8,0,8,22,23,-1,24,Q,EU_CL,Portman Road,Ipswich
2000/01,32,9,Leeds United,4,33,16,8,9,50,39,11,56,16,8,3,5,25,19,6,27,17,8,5,4,25,20,5,29,Q,EU_UC,Elland Road,Leeds
2000/01,32,4,Chelsea,5,32,14,9,9,59,38,21,51,17,12,3,2,42,18,24,39,15,2,6,7,17,20,-3,12,Q,EU_UC,Stamford Bridge,London
2000/01,32,10,Liverpool,6,31,14,8,9,52,34,18,50,16,11,3,2,32,11,21,36,15,3,5,7,20,23,-3,14,Q,EU_UC,Anfield,Liverpool
2000/01,32,29,Sunderland,7,33,13,10,10,39,35,4,49,17,8,6,3,20,13,7,30,16,5,4,7,19,22,-3,19,,,Stadium of Light,Sunderland
2000/01,32,2,Aston Villa,8,33,12,12,9,40,35,5,48,17,7,7,3,24,18,6,28,16,5,5,6,16,17,-1,20,Q,EU_IT,Villa Park,Birmingham
2000/01,32,21,Tottenham Hotspur,9,33,12,9,12,41,43,-2,45,16,10,5,1,28,12,16,35,17,2,4,11,13,31,-18,10,,,White Hart Lane,London
2000/01,32,31,Charlton Athletic,10,33,12,9,12,42,46,-4,45,16,10,4,2,26,11,15,34,17,2,5,10,16,35,-19,11,,,The Valley,London
2000/01,32,26,Leicester City,11,33,13,6,14,34,40,-6,45,17,9,4,4,24,18,6,31,16,4,2,10,10,22,-12,14,,,Filbert Street,Leicester
2000/01,32,20,Southampton,12,32,12,8,12,34,40,-6,44,16,9,2,5,22,18,4,29,16,3,6,7,12,22,-10,15,,,The Dell,Southampton
2000/01,32,25,West Ham United,13,33,9,12,12,40,43,-3,39,17,5,6,6,21,18,3,21,16,4,6,6,19,25,-6,18,,,Boleyn Ground,London
2000/01,32,23,Newcastle United,14,31,11,6,14,36,44,-8,39,14,7,2,5,19,15,4,23,17,4,4,9,17,29,-12,16,Q,EU_IT,St. James' Park,Newcastle
2000/01,32,7,Everton,15,33,10,8,15,37,47,-10,38,16,5,7,4,23,21,2,22,17,5,1,11,14,26,-12,16,,,Goodison Park,Liverpool
2000/01,32,13,Middlesbrough,16,33,7,14,12,37,38,-1,35,16,3,7,6,15,18,-3,16,17,4,7,6,22,20,2,19,,,Riverside Stadium,Middlesbrough
2000/01,32,28,Derby County,17,33,8,11,14,32,54,-22,35,16,7,6,3,19,21,-2,27,17,1,5,11,13,33,-20,8,,,Pride Park,Derby
2000/01,32,11,Manchester City,18,34,7,9,18,37,60,-23,30,17,3,3,11,18,29,-11,12,17,4,6,7,19,31,-12,18,R,EN_D1,Maine Road,Manchester
2000/01,32,5,Coventry City,19,33,7,9,17,33,56,-23,30,16,3,6,7,13,21,-8,15,17,4,3,10,20,35,-15,15,R,EN_D1,Highfield Road,Coventry
2000/01,32,32,Bradford City,20,32,4,9,19,25,59,-34,21,16,3,6,7,17,26,-9,15,16,1,3,12,8,33,-25,6,R,EN_D1,Valley Parade,Bradford
2000/01,33,12,Manchester United,1,33,23,7,3,74,24,50,76,17,15,1,1,48,10,38,46,16,8,6,2,26,14,12,30,Q,EU_CL,Old Trafford,Manchester
2000/01,33,1,Arsenal,2,33,17,9,7,53,32,21,60,17,13,3,1,39,11,28,42,16,4,6,6,14,21,-7,18,Q,EU_CL,Highbury,London
2000/01,33,8,Ipswich Town,3,34,18,5,11,51,38,13,59,17,9,5,3,27,14,13,32,17,9,0,8,24,24,0,27,Q,EU_CL,Portman Road,Ipswich
2000/01,33,9,Leeds United,4,33,16,8,9,50,39,11,56,16,8,3,5,25,19,6,27,17,8,5,4,25,20,5,29,Q,EU_UC,Elland Road,Leeds
2000/01,33,4,Chelsea,5,33,15,9,9,62,38,24,54,17,12,3,2,42,18,24,39,16,3,6,7,20,20,0,15,Q,EU_UC,Stamford Bridge,London
2000/01,33,10,Liverpool,6,32,15,8,9,55,36,19,53,16,11,3,2,32,11,21,36,16,4,5,7,23,25,-2,17,Q,EU_UC,Anfield,Liverpool
2000/01,33,2,Aston Villa,7,34,12,13,9,43,38,5,49,17,7,7,3,24,18,6,28,17,5,6,6,19,20,-1,21,Q,EU_IT,Villa Park,Birmingham
2000/01,33,29,Sunderland,8,34,13,10,11,39,36,3,49,17,8,6,3,20,13,7,30,17,5,4,8,19,23,-4,19,,,Stadium of Light,Sunderland
2000/01,33,31,Charlton Athletic,9,34,12,10,12,45,49,-4,46,17,10,5,2,29,14,15,35,17,2,5,10,16,35,-19,11,,,The Valley,London
2000/01,33,21,Tottenham Hotspur,10,34,12,9,13,41,46,-5,45,17,10,5,2,28,15,13,35,17,2,4,11,13,31,-18,10,,,White Hart Lane,London
2000/01,33,26,Leicester City,11,34,13,6,15,34,42,-8,45,17,9,4,4,24,18,6,31,17,4,2,11,10,24,-14,14,,,Filbert Street,Leicester
2000/01,33,20,Southampton,12,32,12,8,12,34,40,-6,44,16,9,2,5,22,18,4,29,16,3,6,7,12,22,-10,15,,,The Dell,Southampton
2000/01,33,23,Newcastle United,13,32,12,6,14,38,45,-7,42,15,8,2,5,21,16,5,26,17,4,4,9,17,29,-12,16,Q,EU_IT,St. James' Park,Newcastle
2000/01,33,25,West Ham United,14,34,9,12,13,41,45,-4,39,17,5,6,6,21,18,3,21,17,4,6,7,20,27,-7,18,,,Boleyn Ground,London
2000/01,33,7,Everton,15,34,10,8,16,39,50,-11,38,17,5,7,5,25,24,1,22,17,5,1,11,14,26,-12,16,,,Goodison Park,Liverpool
2000/01,33,28,Derby County,16,34,9,11,14,34,54,-20,38,17,8,6,3,21,21,0,30,17,1,5,11,13,33,-20,8,,,Pride Park,Derby
2000/01,33,13,Middlesbrough,17,34,7,14,13,38,40,-2,35,17,3,7,7,16,20,-4,16,17,4,7,6,22,20,2,19,,,Riverside Stadium,Middlesbrough
2000/01,33,5,Coventry City,18,34,8,9,17,34,56,-22,33,17,4,6,7,14,21,-7,18,17,4,3,10,20,35,-15,15,R,EN_D1,Highfield Road,Coventry
2000/01,33,11,Manchester City,19,34,7,9,18,37,60,-23,30,17,3,3,11,18,29,-11,12,17,4,6,7,19,31,-12,18,R,EN_D1,Maine Road,Manchester
2000/01,33,32,Bradford City,20,32,4,9,19,25,59,-34,21,16,3,6,7,17,26,-9,15,16,1,3,12,8,33,-25,6,R,EN_D1,Valley Parade,Bradford
2000/01,34,12,Manchester United,1,34,23,8,3,75,25,50,77,18,15,2,1,49,11,38,47,16,8,6,2,26,14,12,30,Q,EU_CL,Old Trafford,Manchester
2000/01,34,1,Arsenal,2,34,18,9,7,57,33,24,63,18,14,3,1,43,12,31,45,16,4,6,6,14,21,-7,18,Q,EU_CL,Highbury,London
2000/01,34,8,Ipswich Town,3,35,19,5,11,53,38,15,62,18,10,5,3,29,14,15,35,17,9,0,8,24,24,0,27,Q,EU_CL,Portman Road,Ipswich
2000/01,34,9,Leeds United,4,34,17,8,9,52,39,13,59,16,8,3,5,25,19,6,27,18,9,5,4,27,20,7,32,Q,EU_UC,Elland Road,Leeds
2000/01,34,10,Liverpool,5,33,16,8,9,58,37,21,56,17,12,3,2,35,12,23,39,16,4,5,7,23,25,-2,17,Q,EU_UC,Anfield,Liverpool
2000/01,34,4,Chelsea,6,34,15,9,10,62,39,23,54,18,12,3,3,42,19,23,39,16,3,6,7,20,20,0,15,Q,EU_UC,Stamford Bridge,London
2000/01,34,2,Aston Villa,7,35,12,14,9,43,38,5,50,18,7,8,3,24,18,6,29,17,5,6,6,19,20,-1,21,Q,EU_IT,Villa Park,Birmingham
2000/01,34,29,Sunderland,8,35,13,11,11,40,37,3,50,18,8,7,3,21,14,7,31,17,5,4,8,19,23,-4,19,,,Stadium of Light,Sunderland
2000/01,34,31,Charlton Athletic,9,35,13,10,12,46,49,-3,49,17,10,5,2,29,14,15,35,18,3,5,10,17,35,-18,14,,,The Valley,London
2000/01,34,20,Southampton,10,33,12,9,12,34,40,-6,45,16,9,2,5,22,18,4,29,17,3,7,7,12,22,-10,16,,,The Dell,Southampton
2000/01,34,21,Tottenham Hotspur,11,35,12,9,14,42,49,-7,45,17,10,5,2,28,15,13,35,18,2,4,12,14,34,-20,10,,,White Hart Lane,London
2000/01,34,26,Leicester City,12,35,13,6,16,34,45,-11,45,18,9,4,5,24,21,3,31,17,4,2,11,10,24,-14,14,,,Filbert Street,Leicester
2000/01,34,23,Newcastle United,13,33,12,7,14,39,46,-7,43,15,8,2,5,21,16,5,26,18,4,5,9,18,30,-12,17,Q,EU_IT,St. James' Park,Newcastle
2000/01,34,25,West Ham United,14,35,9,12,14,41,47,-6,39,18,5,6,7,21,20,1,21,17,4,6,7,20,27,-7,18,,,Boleyn Ground,London
2000/01,34,13,Middlesbrough,15,35,8,14,13,41,40,1,38,17,3,7,7,16,20,-4,16,18,5,7,6,25,20,5,22,,,Riverside Stadium,Middlesbrough
2000/01,34,7,Everton,16,35,10,8,17,40,54,-14,38,17,5,7,5,25,24,1,22,18,5,1,12,15,30,-15,16,,,Goodison Park,Liverpool
2000/01,34,28,Derby County,17,35,9,11,15,34,56,-22,38,17,8,6,3,21,21,0,30,18,1,5,12,13,35,-22,8,,,Pride Park,Derby
2000/01,34,5,Coventry City,18,35,8,9,18,34,58,-24,33,17,4,6,7,14,21,-7,18,18,4,3,11,20,37,-17,15,R,EN_D1,Highfield Road,Coventry
2000/01,34,11,Manchester City,19,35,7,10,18,38,61,-23,31,17,3,3,11,18,29,-11,12,18,4,7,7,20,32,-12,19,R,EN_D1,Maine Road,Manchester
2000/01,34,32,Bradford City,20,33,5,9,19,27,59,-32,24,17,4,6,7,19,26,-7,18,16,1,3,12,8,33,-25,6,R,EN_D1,Valley Parade,Bradford
2000/01,35,12,Manchester United,1,35,24,8,3,77,25,52,80,18,15,2,1,49,11,38,47,17,9,6,2,28,14,14,33,Q,EU_CL,Old Trafford,Manchester
2000/01,35,1,Arsenal,2,35,19,9,7,59,34,25,66,18,14,3,1,43,12,31,45,17,5,6,6,16,22,-6,21,Q,EU_CL,Highbury,London
2000/01,35,9,Leeds United,3,35,18,8,9,54,39,15,62,17,9,3,5,27,19,8,30,18,9,5,4,27,20,7,32,Q,EU_CL,Elland Road,Leeds
2000/01,35,8,Ipswich Town,4,35,19,5,11,53,38,15,62,18,10,5,3,29,14,15,35,17,9,0,8,24,24,0,27,Q,EU_UC,Portman Road,Ipswich
2000/01,35,10,Liverpool,5,34,17,8,9,60,37,23,59,17,12,3,2,35,12,23,39,17,5,5,7,25,25,0,20,Q,EU_UC,Anfield,Liverpool
2000/01,35,4,Chelsea,6,35,15,9,11,62,41,21,54,18,12,3,3,42,19,23,39,17,3,6,8,20,22,-2,15,Q,EU_UC,Stamford Bridge,London
2000/01,35,29,Sunderland,7,36,14,11,11,41,37,4,53,18,8,7,3,21,14,7,31,18,6,4,8,20,23,-3,22,,,Stadium of Light,Sunderland
2000/01,35,2,Aston Villa,8,36,12,15,9,43,38,5,51,18,7,8,3,24,18,6,29,18,5,7,6,19,20,-1,22,Q,EU_IT,Villa Park,Birmingham
2000/01,35,31,Charlton Athletic,9,35,13,10,12,46,49,-3,49,17,10,5,2,29,14,15,35,18,3,5,10,17,35,-18,14,,,The Valley,London
2000/01,35,23,Newcastle United,10,34,13,7,14,40,46,-6,46,16,9,2,5,22,16,6,29,18,4,5,9,18,30,-12,17,Q,EU_IT,St. James' Park,Newcastle
2000/01,35,21,Tottenham Hotspur,11,36,12,10,14,42,49,-7,46,18,10,6,2,28,15,13,36,18,2,4,12,14,34,-20,10,,,White Hart Lane,London
2000/01,35,20,Southampton,12,34,12,9,13,34,41,-7,45,17,9,2,6,22,19,3,29,17,3,7,7,12,22,-10,16,,,The Dell,Southampton
2000/01,35,26,Leicester City,13,36,13,6,17,34,46,-12,45,18,9,4,5,24,21,3,31,18,4,2,12,10,25,-15,14,,,Filbert Street,Leicester
2000/01,35,7,Everton,14,36,11,8,17,42,55,-13,41,18,6,7,5,27,25,2,25,18,5,1,12,15,30,-15,16,,,Goodison Park,Liverpool
2000/01,35,25,West Ham United,15,36,9,12,15,41,48,-7,39,18,5,6,7,21,20,1,21,18,4,6,8,20,28,-8,18,,,Boleyn Ground,London
2000/01,35,13,Middlesbrough,16,36,8,14,14,41,42,-1,38,18,3,7,8,16,22,-6,16,18,5,7,6,25,20,5,22,,,Riverside Stadium,Middlesbrough
2000/01,35,28,Derby County,17,36,9,11,16,35,58,-23,38,18,8,6,4,22,23,-1,30,18,1,5,12,13,35,-22,8,,,Pride Park,Derby
2000/01,35,11,Manchester City,18,36,8,10,18,39,61,-22,34,18,4,3,11,19,29,-10,15,18,4,7,7,20,32,-12,19,R,EN_D1,Maine Road,Manchester
2000/01,35,5,Coventry City,19,36,8,9,19,34,60,-26,33,18,4,6,8,14,23,-9,18,18,4,3,11,20,37,-17,15,R,EN_D1,Highfield Road,Coventry
2000/01,35,32,Bradford City,20,34,5,9,20,28,61,-33,24,17,4,6,7,19,26,-7,18,17,1,3,13,9,35,-26,6,R,EN_D1,Valley Parade,Bradford
2000/01,36,12,Manchester United,1,35,24,8,3,77,25,52,80,18,15,2,1,49,11,38,47,17,9,6,2,28,14,14,33,Q,EU_CL,Old Trafford,Manchester
2000/01,36,1,Arsenal,2,35,19,9,7,59,34,25,66,18,14,3,1,43,12,31,45,17,5,6,6,16,22,-6,21,Q,EU_CL,Highbury,London
2000/01,36,10,Liverpool,3,35,18,8,9,62,37,25,62,17,12,3,2,35,12,23,39,18,6,5,7,27,25,2,23,Q,EU_CL,Anfield,Liverpool
2000/01,36,9,Leeds United,4,35,18,8,9,54,39,15,62,17,9,3,5,27,19,8,30,18,9,5,4,27,20,7,32,Q,EU_UC,Elland Road,Leeds
2000/01,36,8,Ipswich Town,5,36,19,5,12,54,40,14,62,18,10,5,3,29,14,15,35,18,9,0,9,25,26,-1,27,Q,EU_UC,Portman Road,Ipswich
2000/01,36,4,Chelsea,6,35,15,9,11,62,41,21,54,18,12,3,3,42,19,23,39,17,3,6,8,20,22,-2,15,Q,EU_UC,Stamford Bridge,London
2000/01,36,29,Sunderland,7,36,14,11,11,41,37,4,53,18,8,7,3,21,14,7,31,18,6,4,8,20,23,-3,22,,,Stadium of Light,Sunderland
2000/01,36,31,Charlton Athletic,8,36,14,10,12,48,50,-2,52,18,11,5,2,31,15,16,38,18,3,5,10,17,35,-18,14,,,The Valley,London
2000/01,36,2,Aston Villa,9,36,12,15,9,43,38,5,51,18,7,8,3,24,18,6,29,18,5,7,6,19,20,-1,22,Q,EU_IT,Villa Park,Birmingham
2000/01,36,23,Newcastle United,10,35,13,8,14,41,47,-6,47,17,9,3,5,23,17,6,30,18,4,5,9,18,30,-12,17,Q,EU_IT,St. James' Park,Newcastle
2000/01,36,21,Tottenham Hotspur,11,36,12,10,14,42,49,-7,46,18,10,6,2,28,15,13,36,18,2,4,12,14,34,-20,10,,,White Hart Lane,London
2000/01,36,20,Southampton,12,35,12,10,13,35,42,-7,46,17,9,2,6,22,19,3,29,18,3,8,7,13,23,-10,17,,,The Dell,Southampton
2000/01,36,26,Leicester City,13,36,13,6,17,34,46,-12,45,18,9,4,5,24,21,3,31,18,4,2,12,10,25,-15,14,,,Filbert Street,Leicester
2000/01,36,7,Everton,14,36,11,8,17,42,55,-13,41,18,6,7,5,27,25,2,25,18,5,1,12,15,30,-15,16,,,Goodison Park,Liverpool
2000/01,36,25,West Ham United,15,36,9,12,15,41,48,-7,39,18,5,6,7,21,20,1,21,18,4,6,8,20,28,-8,18,,,Boleyn Ground,London
2000/01,36,13,Middlesbrough,16,36,8,14,14,41,42,-1,38,18,3,7,8,16,22,-6,16,18,5,7,6,25,20,5,22,,,Riverside Stadium,Middlesbrough
2000/01,36,28,Derby County,17,36,9,11,16,35,58,-23,38,18,8,6,4,22,23,-1,30,18,1,5,12,13,35,-22,8,,,Pride Park,Derby
2000/01,36,11,Manchester City,18,36,8,10,18,39,61,-22,34,18,4,3,11,19,29,-10,15,18,4,7,7,20,32,-12,19,R,EN_D1,Maine Road,Manchester
2000/01,36,5,Coventry City,19,36,8,9,19,34,60,-26,33,18,4,6,8,14,23,-9,18,18,4,3,11,20,37,-17,15,R,EN_D1,Highfield Road,Coventry
2000/01,36,32,Bradford City,20,35,5,9,21,28,63,-35,24,18,4,6,8,19,28,-9,18,17,1,3,13,9,35,-26,6,R,EN_D1,Valley Parade,Bradford
2000/01,37,12,Manchester United,1,37,24,8,5,78,28,50,80,19,15,2,2,49,12,37,47,18,9,6,3,29,16,13,33,Q,EU_CL,Old Trafford,Manchester
2000/01,37,1,Arsenal,2,37,20,10,7,61,35,26,70,19,15,3,1,45,13,32,48,18,5,7,6,16,22,-6,22,Q,EU_CL,Highbury,London
2000/01,37,10,Liverpool,3,37,19,9,9,67,39,28,66,19,13,4,2,40,14,26,43,18,6,5,7,27,25,2,23,Q,EU_CL,Anfield,Liverpool
2000/01,37,9,Leeds United,4,37,19,8,10,61,42,19,65,18,10,3,5,33,20,13,33,19,9,5,5,28,22,6,32,Q,EU_UC,Elland Road,Leeds
2000/01,37,8,Ipswich Town,5,37,20,5,12,56,41,15,65,19,11,5,3,31,15,16,38,18,9,0,9,25,26,-1,27,Q,EU_UC,Portman Road,Ipswich
2000/01,37,4,Chelsea,6,37,16,10,11,66,44,22,58,19,13,3,3,44,20,24,42,18,3,7,8,22,24,-2,16,Q,EU_UC,Stamford Bridge,London
2000/01,37,29,Sunderland,7,37,15,11,11,44,39,5,56,19,9,7,3,24,16,8,34,18,6,4,8,20,23,-3,22,,,Stadium of Light,Sunderland
2000/01,37,2,Aston Villa,8,37,13,15,9,46,40,6,54,19,8,8,3,27,20,7,32,18,5,7,6,19,20,-1,22,Q,EU_IT,Villa Park,Birmingham
2000/01,37,31,Charlton Athletic,9,37,14,10,13,50,53,-3,52,18,11,5,2,31,15,16,38,19,3,5,11,19,38,-19,14,,,The Valley,London
2000/01,37,20,Southampton,10,37,13,10,14,37,46,-9,49,18,10,2,6,24,20,4,32,19,3,8,8,13,26,-13,17,,,The Dell,Southampton
2000/01,37,23,Newcastle United,11,37,13,9,15,41,50,-9,48,18,9,4,5,23,17,6,31,19,4,5,10,18,33,-15,17,Q,EU_IT,St. James' Park,Newcastle
2000/01,37,26,Leicester City,12,37,14,6,17,38,48,-10,48,19,10,4,5,28,23,5,34,18,4,2,12,10,25,-15,14,,,Filbert Street,Leicester
2000/01,37,21,Tottenham Hotspur,13,37,12,10,15,44,53,-9,46,18,10,6,2,28,15,13,36,19,2,4,13,16,38,-22,10,,,White Hart Lane,London
2000/01,37,25,West Ham United,14,37,10,12,15,44,48,-4,42,19,6,6,7,24,20,4,24,18,4,6,8,20,28,-8,18,,,Boleyn Ground,London
2000/01,37,7,Everton,15,37,11,8,18,43,57,-14,41,18,6,7,5,27,25,2,25,19,5,1,13,16,32,-16,16,,,Goodison Park,Liverpool
2000/01,37,28,Derby County,16,37,10,11,16,36,58,-22,41,18,8,6,4,22,23,-1,30,19,2,5,12,14,35,-21,11,,,Pride Park,Derby
2000/01,37,13,Middlesbrough,17,37,8,15,14,42,43,-1,39,18,3,7,8,16,22,-6,16,19,5,8,6,26,21,5,23,,,Riverside Stadium,Middlesbrough
2000/01,37,11,Manchester City,18,37,8,10,19,40,63,-23,34,18,4,3,11,19,29,-10,15,19,4,7,8,21,34,-13,19,R,EN_D1,Maine Road,Manchester
2000/01,37,5,Coventry City,19,37,8,9,20,36,63,-27,33,18,4,6,8,14,23,-9,18,19,4,3,12,22,40,-18,15,R,EN_D1,Highfield Road,Coventry
2000/01,37,32,Bradford City,20,37,5,10,22,30,70,-40,25,19,4,7,8,20,29,-9,19,18,1,3,14,10,41,-31,6,R,EN_D1,Valley Parade,Bradford
2000/01,38,12,Manchester United,1,38,24,8,6,79,31,48,80,19,15,2,2,49,12,37,47,19,9,6,4,30,19,11,33,Q,EU_CL,Old Trafford,Manchester
2000/01,38,1,Arsenal,2,38,20,10,8,63,38,25,70,19,15,3,1,45,13,32,48,19,5,7,7,18,25,-7,22,Q,EU_CL,Highbury,London
2000/01,38,10,Liverpool,3,38,20,9,9,71,39,32,69,19,13,4,2,40,14,26,43,19,7,5,7,31,25,6,26,Q,EU_CL,Anfield,Liverpool
2000/01,38,9,Leeds United,4,38,20,8,10,64,43,21,68,19,11,3,5,36,21,15,36,19,9,5,5,28,22,6,32,Q,EU_UC,Elland Road,Leeds
2000/01,38,8,Ipswich Town,5,38,20,6,12,57,42,15,66,19,11,5,3,31,15,16,38,19,9,1,9,26,27,-1,28,Q,EU_UC,Portman Road,Ipswich
2000/01,38,4,Chelsea,6,38,17,10,11,68,45,23,61,19,13,3,3,44,20,24,42,19,4,7,8,24,25,-1,19,Q,EU_UC,Stamford Bridge,London
2000/01,38,29,Sunderland,7,38,15,12,11,46,41,5,57,19,9,7,3,24,16,8,34,19,6,5,8,22,25,-3,23,,,Stadium of Light,Sunderland
2000/01,38,2,Aston Villa,8,38,13,15,10,46,43,3,54,19,8,8,3,27,20,7,32,19,5,7,7,19,23,-4,22,Q,EU_IT,Villa Park,Birmingham
2000/01,38,31,Charlton Athletic,9,38,14,10,14,50,57,-7,52,19,11,5,3,31,19,12,38,19,3,5,11,19,38,-19,14,,,The Valley,London
2000/01,38,20,Southampton,10,38,14,10,14,40,48,-8,52,19,11,2,6,27,22,5,35,19,3,8,8,13,26,-13,17,,,The Dell,Southampton
2000/01,38,23,Newcastle United,11,38,14,9,15,44,50,-6,51,19,10,4,5,26,17,9,34,19,4,5,10,18,33,-15,17,Q,EU_IT,St. James' Park,Newcastle
2000/01,38,21,Tottenham Hotspur,12,38,13,10,15,47,54,-7,49,19,11,6,2,31,16,15,39,19,2,4,13,16,38,-22,10,,,White Hart Lane,London
2000/01,38,26,Leicester City,13,38,14,6,18,39,51,-12,48,19,10,4,5,28,23,5,34,19,4,2,13,11,28,-17,14,,,Filbert Street,Leicester
2000/01,38,13,Middlesbrough,14,38,9,15,14,44,44,0,42,19,4,7,8,18,23,-5,19,19,5,8,6,26,21,5,23,,,Riverside Stadium,Middlesbrough
2000/01,38,25,West Ham United,15,38,10,12,16,45,50,-5,42,19,6,6,7,24,20,4,24,19,4,6,9,21,30,-9,18,,,Boleyn Ground,London
2000/01,38,7,Everton,16,38,11,9,18,45,59,-14,42,19,6,8,5,29,27,2,26,19,5,1,13,16,32,-16,16,,,Goodison Park,Liverpool
2000/01,38,28,Derby County,17,38,10,12,16,37,59,-22,42,19,8,7,4,23,24,-1,31,19,2,5,12,14,35,-21,11,,,Pride Park,Derby
2000/01,38,11,Manchester City,18,38,8,10,20,41,65,-24,34,19,4,3,12,20,31,-11,15,19,4,7,8,21,34,-13,19,R,EN_D1,Maine Road,Manchester
2000/01,38,5,Coventry City,19,38,8,10,20,36,63,-27,34,19,4,7,8,14,23,-9,19,19,4,3,12,22,40,-18,15,R,EN_D1,Highfield Road,Coventry
2000/01,38,32,Bradford City,20,38,5,11,22,30,70,-40,26,19,4,7,8,20,29,-9,19,19,1,4,14,10,41,-31,7,R,EN_D1,Valley Parade,Bradford
