season,match_week,team_id,team_name,position,played,won,drawn,lost,goals_for,goals_against,goal_difference,points,home_played,home_won,home_drawn,home_lost,home_goals_for,home_goals_against,home_goal_difference,home_points,away_played,away_won,away_drawn,away_lost,away_goals_for,away_goals_against,away_goal_difference,away_points,annotation_types,annotation_destinations,stadium_name,stadium_city
2001/02,1,27,Bolton Wanderers,1,2,2,0,0,6,0,6,6,1,1,0,0,1,0,1,3,1,1,0,0,5,0,5,3,Q,EU_CL,Macron Stadium,Bolton
2001/02,1,9,Leeds United,2,2,2,0,0,4,1,3,6,1,1,0,0,2,0,2,3,1,1,0,0,2,1,1,3,Q,EU_CL,Elland Road,Leeds
2001/02,1,12,Manchester United,3,2,1,1,0,5,4,1,4,1,1,0,0,3,2,1,3,1,0,1,0,2,2,0,1,Q,EU_CL,Old Trafford,Manchester
2001/02,1,7,Everton,4,2,1,1,0,3,2,1,4,1,0,1,0,1,1,0,1,1,1,0,0,2,1,1,3,Q,EU_CL,Goodison Park,Liverpool
2001/02,1,1,Arsenal,5,2,1,0,1,5,2,3,3,1,0,0,1,1,2,-1,0,1,1,0,0,4,0,4,3,Q,EU_UC,Highbury,London
2001/02,1,34,Fulham,6,2,1,0,1,4,3,1,3,1,1,0,0,2,0,2,3,1,0,0,1,2,3,-1,0,"Q,Q","EU_UC,EU_IT",Craven Cottage,London
2001/02,1,8,Ipswich Town,7,2,1,0,1,3,2,1,3,1,1,0,0,3,1,2,3,1,0,0,1,0,1,-1,0,Q,EU_UC,Portman Road,Ipswich
2001/02,1,10,Liverpool,8,1,1,0,0,2,1,1,3,1,1,0,0,2,1,1,3,0,0,0,0,0,0,0,0,,,Anfield,Liverpool
2001/02,1,28,Derby County,9,2,1,0,1,3,4,-1,3,1,1,0,0,2,1,1,3,1,0,0,1,1,3,-2,0,,,Pride Park,Derby
2001/02,1,29,Sunderland,10,2,1,0,1,1,2,-1,3,1,1,0,0,1,0,1,3,1,0,0,1,0,2,-2,0,,,Stadium of Light,Sunderland
2001/02,1,21,Tottenham Hotspur,11,2,0,2,0,1,1,0,2,1,0,1,0,0,0,0,1,1,0,1,0,1,1,0,1,,,White Hart Lane,London
2001/02,1,4,Chelsea,12,1,0,1,0,1,1,0,1,1,0,1,0,1,1,0,1,0,0,0,0,0,0,0,0,,,Stamford Bridge,London
2001/02,1,23,Newcastle United,13,1,0,1,0,1,1,0,1,0,0,0,0,0,0,0,0,1,0,1,0,1,1,0,1,,,St. James' Park,Newcastle
2001/02,1,2,Aston Villa,14,1,0,1,0,0,0,0,1,0,0,0,0,0,0,0,0,1,0,1,0,0,0,0,1,Q,EU_IT,Villa Park,Birmingham
2001/02,1,3,Blackburn Rovers,15,2,0,1,1,3,4,-1,1,1,0,1,0,2,2,0,1,1,0,0,1,1,2,-1,0,Q,EU_UC,Ewood Park,Blackburn
2001/02,1,31,Charlton Athletic,16,1,0,0,1,1,2,-1,0,1,0,0,1,1,2,-1,0,0,0,0,0,0,0,0,0,,,The Valley,London
2001/02,1,25,West Ham United,17,1,0,0,1,1,2,-1,0,0,0,0,0,0,0,0,0,1,0,0,1,1,2,-1,0,,,Boleyn Ground,London
2001/02,1,20,Southampton,18,1,0,0,1,0,2,-2,0,0,0,0,0,0,0,0,0,1,0,0,1,0,2,-2,0,R,EN_D1,St. Mary's Stadium,Southampton
2001/02,1,26,Leicester City,19,1,0,0,1,0,5,-5,0,1,0,0,1,0,5,-5,0,0,0,0,0,0,0,0,0,R,EN_D1,Filbert Street,Leicester
2001/02,1,13,Middlesbrough,20,2,0,0,2,0,5,-5,0,1,0,0,1,0,4,-4,0,1,0,0,1,0,1,-1,0,R,EN_D1,Riverside Stadium,Middlesbrough
2001/02,2,27,Bolton Wanderers,1,3,3,0,0,8,1,7,9,2,2,0,0,3,1,2,6,1,1,0,0,5,0,5,3,Q,EU_CL,Macron Stadium,Bolton
2001/02,2,7,Everton,2,3,2,1,0,5,2,3,7,2,1,1,0,3,1,2,4,1,1,0,0,2,1,1,3,Q,EU_CL,Goodison Park,Liverpool
2001/02,2,9,Leeds United,3,3,2,1,0,4,1,3,7,1,1,0,0,2,0,2,3,2,1,1,0,2,1,1,4,Q,EU_CL,Elland Road,Leeds
2001/02,2,1,Arsenal,4,3,2,0,1,9,2,7,6,2,1,0,1,5,2,3,3,1,1,0,0,4,0,4,3,Q,EU_CL,Highbury,London
2001/02,2,12,Manchester United,5,3,1,2,0,6,5,1,5,1,1,0,0,3,2,1,3,2,0,2,0,3,3,0,2,Q,EU_UC,Old Trafford,Manchester
2001/02,2,4,Chelsea,6,2,1,1,0,3,1,2,4,1,0,1,0,1,1,0,1,1,1,0,0,2,0,2,3,Q,EU_UC,Stamford Bridge,London
2001/02,2,34,Fulham,7,3,1,1,1,4,3,1,4,2,1,1,0,2,0,2,4,1,0,0,1,2,3,-1,0,Q,EU_IT,Craven Cottage,London
2001/02,2,3,Blackburn Rovers,8,3,1,1,1,5,5,0,4,2,1,1,0,4,3,1,4,1,0,0,1,1,2,-1,0,Q,EU_UC,Ewood Park,Blackburn
2001/02,2,28,Derby County,9,3,1,1,1,3,4,-1,4,1,1,0,0,2,1,1,3,2,0,1,1,1,3,-2,1,,,Pride Park,Derby
2001/02,2,29,Sunderland,10,3,1,1,1,2,3,-1,4,1,1,0,0,1,0,1,3,2,0,1,1,1,3,-2,1,,,Stadium of Light,Sunderland
2001/02,2,8,Ipswich Town,11,3,1,0,2,3,3,0,3,2,1,0,1,3,2,1,3,1,0,0,1,0,1,-1,0,Q,EU_UC,Portman Road,Ipswich
2001/02,2,10,Liverpool,12,2,1,0,1,3,3,0,3,1,1,0,0,2,1,1,3,1,0,0,1,1,2,-1,0,,,Anfield,Liverpool
2001/02,2,31,Charlton Athletic,13,2,1,0,1,2,2,0,3,1,0,0,1,1,2,-1,0,1,1,0,0,1,0,1,3,,,The Valley,London
2001/02,2,23,Newcastle United,14,2,0,2,0,2,2,0,2,1,0,1,0,1,1,0,1,1,0,1,0,1,1,0,1,,,St. James' Park,Newcastle
2001/02,2,2,Aston Villa,15,2,0,2,0,1,1,0,2,1,0,1,0,1,1,0,1,1,0,1,0,0,0,0,1,Q,EU_IT,Villa Park,Birmingham
2001/02,2,21,Tottenham Hotspur,16,3,0,2,1,2,3,-1,2,1,0,1,0,0,0,0,1,2,0,1,1,2,3,-1,1,,,White Hart Lane,London
2001/02,2,25,West Ham United,17,2,0,1,1,1,2,-1,1,1,0,1,0,0,0,0,1,1,0,0,1,1,2,-1,0,,,Boleyn Ground,London
2001/02,2,20,Southampton,18,2,0,0,2,0,4,-4,0,1,0,0,1,0,2,-2,0,1,0,0,1,0,2,-2,0,R,EN_D1,St. Mary's Stadium,Southampton
2001/02,2,13,Middlesbrough,19,3,0,0,3,0,7,-7,0,1,0,0,1,0,4,-4,0,2,0,0,2,0,3,-3,0,R,EN_D1,Riverside Stadium,Middlesbrough
2001/02,2,26,Leicester City,20,2,0,0,2,0,9,-9,0,1,0,0,1,0,5,-5,0,1,0,0,1,0,4,-4,0,R,EN_D1,Filbert Street,Leicester
2001/02,3,27,Bolton Wanderers,1,4,3,1,0,8,1,7,10,2,2,0,0,3,1,2,6,2,1,1,0,5,0,5,4,Q,EU_CL,Macron Stadium,Bolton
2001/02,3,12,Manchester United,2,4,2,2,0,10,6,4,8,2,2,0,0,7,3,4,6,2,0,2,0,3,3,0,2,Q,EU_CL,Old Trafford,Manchester
2001/02,3,9,Leeds United,3,4,2,2,0,4,1,3,8,2,1,1,0,2,0,2,4,2,1,1,0,2,1,1,4,Q,EU_CL,Elland Road,Leeds
2001/02,3,1,Arsenal,4,4,2,1,1,10,3,7,7,2,1,0,1,5,2,3,3,2,1,1,0,5,1,4,4,Q,EU_CL,Highbury,London
2001/02,3,7,Everton,5,4,2,1,1,6,6,0,7,2,1,1,0,3,1,2,4,2,1,0,1,3,5,-2,3,Q,EU_UC,Goodison Park,Liverpool
2001/02,3,29,Sunderland,6,4,2,1,1,3,3,0,7,2,2,0,0,2,0,2,6,2,0,1,1,1,3,-2,1,Q,EU_UC,Stadium of Light,Sunderland
2001/02,3,23,Newcastle United,7,3,1,2,0,6,3,3,5,1,0,1,0,1,1,0,1,2,1,1,0,5,2,3,4,,,St. James' Park,Newcastle
2001/02,3,2,Aston Villa,8,3,1,2,0,4,2,2,5,1,0,1,0,1,1,0,1,2,1,1,0,3,1,2,4,Q,EU_IT,Villa Park,Birmingham
2001/02,3,4,Chelsea,9,3,1,2,0,4,2,2,5,2,0,2,0,2,2,0,2,1,1,0,0,2,0,2,3,,,Stamford Bridge,London
2001/02,3,34,Fulham,10,4,1,2,1,5,4,1,5,2,1,1,0,2,0,2,4,2,0,1,1,3,4,-1,1,Q,EU_IT,Craven Cottage,London
2001/02,3,21,Tottenham Hotspur,11,4,1,2,1,4,3,1,5,2,1,1,0,2,0,2,4,2,0,1,1,2,3,-1,1,,,White Hart Lane,London
2001/02,3,28,Derby County,12,4,1,2,1,3,4,-1,5,2,1,1,0,2,1,1,4,2,0,1,1,1,3,-2,1,,,Pride Park,Derby
2001/02,3,8,Ipswich Town,13,4,1,1,2,4,4,0,4,2,1,0,1,3,2,1,3,2,0,1,1,1,2,-1,1,Q,EU_UC,Portman Road,Ipswich
2001/02,3,31,Charlton Athletic,14,3,1,1,1,3,3,0,4,2,0,1,1,2,3,-1,1,1,1,0,0,1,0,1,3,,,The Valley,London
2001/02,3,3,Blackburn Rovers,15,4,1,1,2,5,6,-1,4,2,1,1,0,4,3,1,4,2,0,0,2,1,3,-2,0,Q,EU_UC,Ewood Park,Blackburn
2001/02,3,10,Liverpool,16,3,1,0,2,4,6,-2,3,2,1,0,1,3,4,-1,3,1,0,0,1,1,2,-1,0,,,Anfield,Liverpool
2001/02,3,25,West Ham United,17,3,0,2,1,1,2,-1,2,1,0,1,0,0,0,0,1,2,0,1,1,1,2,-1,1,,,Boleyn Ground,London
2001/02,3,26,Leicester City,18,3,0,1,2,1,10,-9,1,2,0,1,1,1,6,-5,1,1,0,0,1,0,4,-4,0,R,EN_D1,Filbert Street,Leicester
2001/02,3,20,Southampton,19,3,0,0,3,0,6,-6,0,1,0,0,1,0,2,-2,0,2,0,0,2,0,4,-4,0,R,EN_D1,St. Mary's Stadium,Southampton
2001/02,3,13,Middlesbrough,20,4,0,0,4,1,11,-10,0,2,0,0,2,1,8,-7,0,2,0,0,2,0,3,-3,0,R,EN_D1,Riverside Stadium,Middlesbrough
2001/02,4,27,Bolton Wanderers,1,6,3,2,1,9,3,6,11,3,2,0,1,3,2,1,6,3,1,2,0,6,1,5,5,Q,EU_CL,Macron Stadium,Bolton
2001/02,4,9,Leeds United,2,5,3,2,0,6,1,5,11,2,1,1,0,2,0,2,4,3,2,1,0,4,1,3,7,Q,EU_CL,Elland Road,Leeds
2001/02,4,1,Arsenal,3,5,3,1,1,13,4,9,10,2,1,0,1,5,2,3,3,3,2,1,0,8,2,6,7,Q,EU_CL,Highbury,London
2001/02,4,23,Newcastle United,4,4,2,2,0,10,6,4,8,2,1,1,0,5,4,1,4,2,1,1,0,5,2,3,4,Q,EU_CL,St. James' Park,Newcastle
2001/02,4,12,Manchester United,5,5,2,2,1,13,10,3,8,2,2,0,0,7,3,4,6,3,0,2,1,6,7,-1,2,Q,EU_UC,Old Trafford,Manchester
2001/02,4,4,Chelsea,6,4,2,2,0,7,4,3,8,2,0,2,0,2,2,0,2,2,2,0,0,5,2,3,6,Q,EU_UC,Stamford Bridge,London
2001/02,4,21,Tottenham Hotspur,7,6,2,2,2,8,7,1,8,3,1,1,1,4,3,1,4,3,1,1,1,4,4,0,4,,,White Hart Lane,London
2001/02,4,29,Sunderland,8,6,2,2,2,4,5,-1,8,3,2,0,1,3,2,1,6,3,0,2,1,1,3,-2,2,,,Stadium of Light,Sunderland
2001/02,4,7,Everton,9,5,2,1,2,7,9,-2,7,3,1,1,1,4,4,0,4,2,1,0,1,3,5,-2,3,,,Goodison Park,Liverpool
2001/02,4,2,Aston Villa,10,4,1,3,0,4,2,2,6,2,0,2,0,1,1,0,2,2,1,1,0,3,1,2,4,Q,EU_IT,Villa Park,Birmingham
2001/02,4,10,Liverpool,11,4,2,0,2,7,7,0,6,2,1,0,1,3,4,-1,3,2,1,0,1,4,3,1,3,,,Anfield,Liverpool
2001/02,4,3,Blackburn Rovers,12,6,1,3,2,7,8,-1,6,3,1,2,0,5,4,1,5,3,0,1,2,2,4,-2,1,Q,EU_UC,Ewood Park,Blackburn
2001/02,4,13,Middlesbrough,13,6,2,0,4,5,12,-7,6,3,1,0,2,3,8,-5,3,3,1,0,2,2,4,-2,3,,,Riverside Stadium,Middlesbrough
2001/02,4,8,Ipswich Town,14,5,1,2,2,5,5,0,5,3,1,1,1,4,3,1,4,2,0,1,1,1,2,-1,1,Q,EU_UC,Portman Road,Ipswich
2001/02,4,34,Fulham,15,5,1,2,2,6,7,-1,5,3,1,1,1,3,3,0,4,2,0,1,1,3,4,-1,1,Q,EU_IT,Craven Cottage,London
2001/02,4,28,Derby County,16,5,1,2,2,5,7,-2,5,3,1,1,1,4,4,0,4,2,0,1,1,1,3,-2,1,,,Pride Park,Derby
2001/02,4,31,Charlton Athletic,17,4,1,1,2,3,5,-2,4,3,0,1,2,2,5,-3,1,1,1,0,0,1,0,1,3,,,The Valley,London
2001/02,4,26,Leicester City,18,5,1,1,3,5,14,-9,4,3,0,1,2,2,8,-6,1,2,1,0,1,3,6,-3,3,R,EN_D1,Filbert Street,Leicester
2001/02,4,20,Southampton,19,4,1,0,3,1,6,-5,3,1,0,0,1,0,2,-2,0,3,1,0,2,1,4,-3,3,R,EN_D1,St. Mary's Stadium,Southampton
2001/02,4,25,West Ham United,20,4,0,2,2,1,4,-3,2,1,0,1,0,0,0,0,1,3,0,1,2,1,4,-3,1,R,EN_D1,Boleyn Ground,London
2001/02,5,9,Leeds United,1,6,4,2,0,9,1,8,14,3,2,1,0,5,0,5,7,3,2,1,0,4,1,3,7,Q,EU_CL,Elland Road,Leeds
2001/02,5,27,Bolton Wanderers,2,7,3,3,1,10,4,6,12,3,2,0,1,3,2,1,6,4,1,3,0,7,2,5,6,Q,EU_CL,Macron Stadium,Bolton
2001/02,5,1,Arsenal,3,6,3,2,1,14,5,9,11,3,1,1,1,6,3,3,4,3,2,1,0,8,2,6,7,Q,EU_CL,Highbury,London
2001/02,5,12,Manchester United,4,6,3,2,1,17,10,7,11,3,3,0,0,11,3,8,9,3,0,2,1,6,7,-1,2,Q,EU_CL,Old Trafford,Manchester
2001/02,5,23,Newcastle United,5,6,3,2,1,11,9,2,11,3,2,1,0,6,4,2,7,3,1,1,1,5,5,0,4,Q,EU_UC,St. James' Park,Newcastle
2001/02,5,2,Aston Villa,6,5,2,3,0,7,3,4,9,2,0,2,0,1,1,0,2,3,2,1,0,6,2,4,7,"Q,Q","EU_UC,EU_IT",Villa Park,Birmingham
2001/02,5,4,Chelsea,7,5,2,3,0,9,6,3,9,3,0,3,0,4,4,0,3,2,2,0,0,5,2,3,6,,,Stamford Bridge,London
2001/02,5,10,Liverpool,8,5,3,0,2,8,7,1,9,3,2,0,1,4,4,0,6,2,1,0,1,4,3,1,3,,,Anfield,Liverpool
2001/02,5,3,Blackburn Rovers,9,7,2,3,2,8,8,0,9,4,2,2,0,6,4,2,8,3,0,1,2,2,4,-2,1,Q,EU_UC,Ewood Park,Blackburn
2001/02,5,29,Sunderland,10,7,2,3,2,6,7,-1,9,4,2,1,1,5,4,1,7,3,0,2,1,1,3,-2,2,,,Stadium of Light,Sunderland
2001/02,5,21,Tottenham Hotspur,11,7,2,2,3,8,8,0,8,3,1,1,1,4,3,1,4,4,1,1,2,4,5,-1,4,,,White Hart Lane,London
2001/02,5,7,Everton,12,6,2,1,3,7,10,-3,7,3,1,1,1,4,4,0,4,3,1,0,2,3,6,-3,3,,,Goodison Park,Liverpool
2001/02,5,13,Middlesbrough,13,7,2,1,4,7,14,-7,7,3,1,0,2,3,8,-5,3,4,1,1,2,4,6,-2,4,,,Riverside Stadium,Middlesbrough
2001/02,5,34,Fulham,14,6,1,3,2,6,7,-1,6,3,1,1,1,3,3,0,4,3,0,2,1,3,4,-1,2,Q,EU_IT,Craven Cottage,London
2001/02,5,25,West Ham United,15,5,1,2,2,4,4,0,5,2,1,1,0,3,0,3,4,3,0,1,2,1,4,-3,1,,,Boleyn Ground,London
2001/02,5,31,Charlton Athletic,16,5,1,2,2,5,7,-2,5,3,0,1,2,2,5,-3,1,2,1,1,0,3,2,1,4,,,The Valley,London
2001/02,5,8,Ipswich Town,17,6,1,2,3,5,9,-4,5,3,1,1,1,4,3,1,4,3,0,1,2,1,6,-5,1,Q,EU_UC,Portman Road,Ipswich
2001/02,5,28,Derby County,18,6,1,2,3,5,10,-5,5,3,1,1,1,4,4,0,4,3,0,1,2,1,6,-5,1,R,EN_D1,Pride Park,Derby
2001/02,5,26,Leicester City,19,7,1,2,4,5,15,-10,5,4,0,2,2,2,8,-6,2,3,1,0,2,3,7,-4,3,R,EN_D1,Filbert Street,Leicester
2001/02,5,20,Southampton,20,5,1,0,4,2,9,-7,3,2,0,0,2,1,5,-4,0,3,1,0,2,1,4,-3,3,R,EN_D1,St. Mary's Stadium,Southampton
2001/02,6,9,Leeds United,1,7,5,2,0,11,2,9,17,3,2,1,0,5,0,5,7,4,3,1,0,6,2,4,10,Q,EU_CL,Elland Road,Leeds
2001/02,6,1,Arsenal,2,7,4,2,1,16,5,11,14,3,1,1,1,6,3,3,4,4,3,1,0,10,2,8,10,Q,EU_CL,Highbury,London
2001/02,6,12,Manchester United,3,7,4,2,1,22,13,9,14,3,3,0,0,11,3,8,9,4,1,2,1,11,10,1,5,Q,EU_CL,Old Trafford,Manchester
2001/02,6,2,Aston Villa,4,6,3,3,0,9,3,6,12,3,1,2,0,3,1,2,5,3,2,1,0,6,2,4,7,"Q,Q","EU_CL,EU_IT",Villa Park,Birmingham
2001/02,6,27,Bolton Wanderers,5,8,3,3,2,10,6,4,12,4,2,0,2,3,4,-1,6,4,1,3,0,7,2,5,6,Q,EU_UC,Macron Stadium,Bolton
2001/02,6,10,Liverpool,6,6,4,0,2,10,7,3,12,3,2,0,1,4,4,0,6,3,2,0,1,6,3,3,6,Q,EU_UC,Anfield,Liverpool
2001/02,6,29,Sunderland,7,8,3,3,2,8,7,1,12,4,2,1,1,5,4,1,7,4,1,2,1,3,3,0,5,,,Stadium of Light,Sunderland
2001/02,6,23,Newcastle United,8,7,3,2,2,11,11,0,11,4,2,1,1,6,6,0,7,3,1,1,1,5,5,0,4,,,St. James' Park,Newcastle
2001/02,6,4,Chelsea,9,6,2,4,0,10,7,3,10,3,0,3,0,4,4,0,3,3,2,1,0,6,3,3,7,,,Stamford Bridge,London
2001/02,6,7,Everton,10,7,3,1,3,12,10,2,10,4,2,1,1,9,4,5,7,3,1,0,2,3,6,-3,3,,,Goodison Park,Liverpool
2001/02,6,3,Blackburn Rovers,11,8,2,3,3,8,10,-2,9,4,2,2,0,6,4,2,8,4,0,1,3,2,6,-4,1,Q,EU_UC,Ewood Park,Blackburn
2001/02,6,31,Charlton Athletic,12,6,2,2,2,7,7,0,8,4,1,1,2,4,5,-1,4,2,1,1,0,3,2,1,4,,,The Valley,London
2001/02,6,21,Tottenham Hotspur,13,8,2,2,4,11,13,-2,8,4,1,1,2,7,8,-1,4,4,1,1,2,4,5,-1,4,,,White Hart Lane,London
2001/02,6,34,Fulham,14,7,1,4,2,7,8,-1,7,4,1,2,1,4,4,0,5,3,0,2,1,3,4,-1,2,Q,EU_IT,Craven Cottage,London
2001/02,6,13,Middlesbrough,15,8,2,1,5,8,17,-9,7,4,1,0,3,4,11,-7,3,4,1,1,2,4,6,-2,4,,,Riverside Stadium,Middlesbrough
2001/02,6,20,Southampton,16,6,2,0,4,5,10,-5,6,2,0,0,2,1,5,-4,0,4,2,0,2,4,5,-1,6,,,St. Mary's Stadium,Southampton
2001/02,6,8,Ipswich Town,17,7,1,2,4,6,11,-5,5,4,1,1,2,5,5,0,4,3,0,1,2,1,6,-5,1,Q,EU_UC,Portman Road,Ipswich
2001/02,6,25,West Ham United,18,6,1,2,3,4,9,-5,5,2,1,1,0,3,0,3,4,4,0,1,3,1,9,-8,1,R,EN_D1,Boleyn Ground,London
2001/02,6,28,Derby County,19,7,1,2,4,5,12,-7,5,4,1,1,2,4,6,-2,4,3,0,1,2,1,6,-5,1,R,EN_D1,Pride Park,Derby
2001/02,6,26,Leicester City,20,8,1,2,5,5,17,-12,5,4,0,2,2,2,8,-6,2,4,1,0,3,3,9,-6,3,R,EN_D1,Filbert Street,Leicester
2001/02,7,9,Leeds United,1,8,5,3,0,12,3,9,18,3,2,1,0,5,0,5,7,5,3,2,0,7,3,4,11,Q,EU_CL,Elland Road,Leeds
2001/02,7,1,Arsenal,2,8,5,2,1,18,5,13,17,3,1,1,1,6,3,3,4,5,4,1,0,12,2,10,13,Q,EU_CL,Highbury,London
2001/02,7,12,Manchester United,3,8,5,2,1,25,14,11,17,3,3,0,0,11,3,8,9,5,2,2,1,14,11,3,8,Q,EU_CL,Old Trafford,Manchester
2001/02,7,2,Aston Villa,4,7,4,3,0,11,3,8,15,4,2,2,0,5,1,4,8,3,2,1,0,6,2,4,7,"Q,Q","EU_CL,EU_IT",Villa Park,Birmingham
2001/02,7,23,Newcastle United,5,8,4,2,2,15,11,4,14,4,2,1,1,6,6,0,7,4,2,1,1,9,5,4,7,Q,EU_UC,St. James' Park,Newcastle
2001/02,7,4,Chelsea,6,7,3,4,0,12,7,5,13,4,1,3,0,6,4,2,6,3,2,1,0,6,3,3,7,Q,EU_UC,Stamford Bridge,London
2001/02,7,10,Liverpool,7,7,4,1,2,11,8,3,13,4,2,1,1,5,5,0,7,3,2,0,1,6,3,3,6,,,Anfield,Liverpool
2001/02,7,3,Blackburn Rovers,8,9,3,3,3,15,11,4,12,5,3,2,0,13,5,8,11,4,0,1,3,2,6,-4,1,Q,EU_UC,Ewood Park,Blackburn
2001/02,7,27,Bolton Wanderers,9,9,3,3,3,10,10,0,12,5,2,0,3,3,8,-5,6,4,1,3,0,7,2,5,6,,,Macron Stadium,Bolton
2001/02,7,29,Sunderland,10,9,3,3,3,9,10,-1,12,5,2,1,2,6,7,-1,7,4,1,2,1,3,3,0,5,,,Stadium of Light,Sunderland
2001/02,7,7,Everton,11,8,3,2,3,12,10,2,11,4,2,1,1,9,4,5,7,4,1,1,2,3,6,-3,4,,,Goodison Park,Liverpool
2001/02,7,21,Tottenham Hotspur,12,9,3,2,4,14,14,0,11,5,2,1,2,10,9,1,7,4,1,1,2,4,5,-1,4,,,White Hart Lane,London
2001/02,7,31,Charlton Athletic,13,7,2,3,2,7,7,0,9,5,1,2,2,4,5,-1,5,2,1,1,0,3,2,1,4,,,The Valley,London
2001/02,7,13,Middlesbrough,14,9,2,2,5,8,17,-9,8,4,1,0,3,4,11,-7,3,5,1,2,2,4,6,-2,5,,,Riverside Stadium,Middlesbrough
2001/02,7,34,Fulham,15,8,1,4,3,7,10,-3,7,4,1,2,1,4,4,0,5,4,0,2,2,3,6,-3,2,Q,EU_IT,Craven Cottage,London
2001/02,7,8,Ipswich Town,16,8,1,3,4,6,11,-5,6,5,1,2,2,5,5,0,5,3,0,1,2,1,6,-5,1,Q,EU_UC,Portman Road,Ipswich
2001/02,7,20,Southampton,17,7,2,0,5,5,12,-7,6,3,0,0,3,1,7,-6,0,4,2,0,2,4,5,-1,6,,,St. Mary's Stadium,Southampton
2001/02,7,28,Derby County,18,8,1,2,5,6,15,-9,5,4,1,1,2,4,6,-2,4,4,0,1,3,2,9,-7,1,R,EN_D1,Pride Park,Derby
2001/02,7,25,West Ham United,19,7,1,2,4,5,16,-11,5,2,1,1,0,3,0,3,4,5,0,1,4,2,16,-14,1,R,EN_D1,Boleyn Ground,London
2001/02,7,26,Leicester City,20,9,1,2,6,5,19,-14,5,4,0,2,2,2,8,-6,2,5,1,0,4,3,11,-8,3,R,EN_D1,Filbert Street,Leicester
2001/02,8,9,Leeds United,1,9,5,4,0,12,3,9,19,4,2,2,0,5,0,5,8,5,3,2,0,7,3,4,11,Q,EU_CL,Elland Road,Leeds
2001/02,8,1,Arsenal,2,9,5,3,1,21,8,13,18,4,1,2,1,9,6,3,5,5,4,1,0,12,2,10,13,Q,EU_CL,Highbury,London
2001/02,8,12,Manchester United,3,9,5,2,2,26,16,10,17,4,3,0,1,12,5,7,9,5,2,2,1,14,11,3,8,Q,EU_CL,Old Trafford,Manchester
2001/02,8,10,Liverpool,4,8,5,1,2,15,9,6,16,4,2,1,1,5,5,0,7,4,3,0,1,10,4,6,9,Q,EU_CL,Anfield,Liverpool
2001/02,8,2,Aston Villa,5,8,4,3,1,13,6,7,15,4,2,2,0,5,1,4,8,4,2,1,1,8,5,3,7,"Q,Q","EU_UC,EU_IT",Villa Park,Birmingham
2001/02,8,27,Bolton Wanderers,6,10,4,3,3,12,11,1,15,5,2,0,3,3,8,-5,6,5,2,3,0,9,3,6,9,Q,EU_UC,Macron Stadium,Bolton
2001/02,8,4,Chelsea,7,8,3,5,0,12,7,5,14,4,1,3,0,6,4,2,6,4,2,2,0,6,3,3,8,,,Stamford Bridge,London
2001/02,8,7,Everton,8,9,4,2,3,15,12,3,14,5,3,1,1,12,6,6,10,4,1,1,2,3,6,-3,4,,,Goodison Park,Liverpool
2001/02,8,21,Tottenham Hotspur,9,10,4,2,4,16,14,2,14,5,2,1,2,10,9,1,7,5,2,1,2,6,5,1,7,,,White Hart Lane,London
2001/02,8,23,Newcastle United,10,9,4,2,3,15,13,2,14,5,2,1,2,6,8,-2,7,4,2,1,1,9,5,4,7,,,St. James' Park,Newcastle
2001/02,8,3,Blackburn Rovers,11,10,3,4,3,18,14,4,13,5,3,2,0,13,5,8,11,5,0,2,3,5,9,-4,2,Q,EU_UC,Ewood Park,Blackburn
2001/02,8,29,Sunderland,12,10,3,3,4,9,12,-3,12,5,2,1,2,6,7,-1,7,5,1,2,2,3,5,-2,5,,,Stadium of Light,Sunderland
2001/02,8,13,Middlesbrough,13,10,3,2,5,10,17,-7,11,5,2,0,3,6,11,-5,6,5,1,2,2,4,6,-2,5,,,Riverside Stadium,Middlesbrough
2001/02,8,31,Charlton Athletic,14,8,2,4,2,8,8,0,10,5,1,2,2,4,5,-1,5,3,1,2,0,4,3,1,5,,,The Valley,London
2001/02,8,34,Fulham,15,9,1,5,3,8,11,-3,8,5,1,3,1,5,5,0,6,4,0,2,2,3,6,-3,2,Q,EU_IT,Craven Cottage,London
2001/02,8,25,West Ham United,16,8,2,2,4,7,16,-9,8,3,2,1,0,5,0,5,7,5,0,1,4,2,16,-14,1,,,Boleyn Ground,London
2001/02,8,8,Ipswich Town,17,9,1,4,4,7,12,-5,7,5,1,2,2,5,5,0,5,4,0,2,2,2,7,-5,2,Q,EU_UC,Portman Road,Ipswich
2001/02,8,28,Derby County,18,9,1,3,5,7,16,-9,6,5,1,2,2,5,7,-2,5,4,0,1,3,2,9,-7,1,R,EN_D1,Pride Park,Derby
2001/02,8,20,Southampton,19,8,2,0,6,5,14,-9,6,3,0,0,3,1,7,-6,0,5,2,0,3,4,7,-3,6,R,EN_D1,St. Mary's Stadium,Southampton
2001/02,8,26,Leicester City,20,10,1,2,7,6,23,-17,5,5,0,2,3,3,12,-9,2,5,1,0,4,3,11,-8,3,R,EN_D1,Filbert Street,Leicester
2001/02,9,9,Leeds United,1,9,5,4,0,12,3,9,19,4,2,2,0,5,0,5,8,5,3,2,0,7,3,4,11,Q,EU_CL,Elland Road,Leeds
2001/02,9,1,Arsenal,2,9,5,3,1,21,8,13,18,4,1,2,1,9,6,3,5,5,4,1,0,12,2,10,13,Q,EU_CL,Highbury,London
2001/02,9,2,Aston Villa,3,9,5,3,1,14,6,8,18,5,3,2,0,6,1,5,11,4,2,1,1,8,5,3,7,"Q,Q","EU_CL,EU_IT",Villa Park,Birmingham
2001/02,9,12,Manchester United,4,9,5,2,2,26,16,10,17,4,3,0,1,12,5,7,9,5,2,2,1,14,11,3,8,Q,EU_CL,Old Trafford,Manchester
2001/02,9,10,Liverpool,5,8,5,1,2,15,9,6,16,4,2,1,1,5,5,0,7,4,3,0,1,10,4,6,9,Q,EU_UC,Anfield,Liverpool
2001/02,9,27,Bolton Wanderers,6,10,4,3,3,12,11,1,15,5,2,0,3,3,8,-5,6,5,2,3,0,9,3,6,9,Q,EU_UC,Macron Stadium,Bolton
2001/02,9,4,Chelsea,7,9,3,5,1,13,9,4,14,4,1,3,0,6,4,2,6,5,2,2,1,7,5,2,8,,,Stamford Bridge,London
2001/02,9,7,Everton,8,9,4,2,3,15,12,3,14,5,3,1,1,12,6,6,10,4,1,1,2,3,6,-3,4,,,Goodison Park,Liverpool
2001/02,9,21,Tottenham Hotspur,9,10,4,2,4,16,14,2,14,5,2,1,2,10,9,1,7,5,2,1,2,6,5,1,7,,,White Hart Lane,London
2001/02,9,23,Newcastle United,10,9,4,2,3,15,13,2,14,5,2,1,2,6,8,-2,7,4,2,1,1,9,5,4,7,,,St. James' Park,Newcastle
2001/02,9,3,Blackburn Rovers,11,10,3,4,3,18,14,4,13,5,3,2,0,13,5,8,11,5,0,2,3,5,9,-4,2,Q,EU_UC,Ewood Park,Blackburn
2001/02,9,29,Sunderland,12,10,3,3,4,9,12,-3,12,5,2,1,2,6,7,-1,7,5,1,2,2,3,5,-2,5,,,Stadium of Light,Sunderland
2001/02,9,13,Middlesbrough,13,10,3,2,5,10,17,-7,11,5,2,0,3,6,11,-5,6,5,1,2,2,4,6,-2,5,,,Riverside Stadium,Middlesbrough
2001/02,9,25,West Ham United,14,9,3,2,4,9,17,-8,11,4,3,1,0,7,1,6,10,5,0,1,4,2,16,-14,1,,,Boleyn Ground,London
2001/02,9,31,Charlton Athletic,15,9,2,4,3,8,9,-1,10,5,1,2,2,4,5,-1,5,4,1,2,1,4,4,0,5,,,The Valley,London
2001/02,9,34,Fulham,16,9,1,5,3,8,11,-3,8,5,1,3,1,5,5,0,6,4,0,2,2,3,6,-3,2,Q,EU_IT,Craven Cottage,London
2001/02,9,8,Ipswich Town,17,10,1,5,4,10,15,-5,8,5,1,2,2,5,5,0,5,5,0,3,2,5,10,-5,3,Q,EU_UC,Portman Road,Ipswich
2001/02,9,20,Southampton,18,9,2,1,6,8,17,-9,7,4,0,1,3,4,10,-6,1,5,2,0,3,4,7,-3,6,R,EN_D1,St. Mary's Stadium,Southampton
2001/02,9,28,Derby County,19,9,1,3,5,7,16,-9,6,5,1,2,2,5,7,-2,5,4,0,1,3,2,9,-7,1,R,EN_D1,Pride Park,Derby
2001/02,9,26,Leicester City,20,10,1,2,7,6,23,-17,5,5,0,2,3,3,12,-9,2,5,1,0,4,3,11,-8,3,R,EN_D1,Filbert Street,Leicester
2001/02,10,2,Aston Villa,1,10,6,3,1,17,8,9,21,6,4,2,0,9,3,6,14,4,2,1,1,8,5,3,7,"Q,Q","EU_CL,EU_IT",Villa Park,Birmingham
2001/02,10,9,Leeds United,2,10,5,5,0,13,4,9,20,4,2,2,0,5,0,5,8,6,3,3,0,8,4,4,12,Q,EU_CL,Elland Road,Leeds
2001/02,10,1,Arsenal,3,10,5,4,1,22,9,13,19,4,1,2,1,9,6,3,5,6,4,2,0,13,3,10,14,Q,EU_CL,Highbury,London
2001/02,10,10,Liverpool,4,9,6,1,2,17,9,8,19,4,2,1,1,5,5,0,7,5,4,0,1,12,4,8,12,Q,EU_CL,Anfield,Liverpool
2001/02,10,12,Manchester United,5,10,5,3,2,27,17,10,18,5,3,1,1,13,6,7,10,5,2,2,1,14,11,3,8,Q,EU_UC,Old Trafford,Manchester
2001/02,10,23,Newcastle United,6,10,5,2,3,18,14,4,17,5,2,1,2,6,8,-2,7,5,3,1,1,12,6,6,10,Q,EU_UC,St. James' Park,Newcastle
2001/02,10,21,Tottenham Hotspur,7,11,5,2,4,18,15,3,17,6,3,1,2,12,10,2,10,5,2,1,2,6,5,1,7,,,White Hart Lane,London
2001/02,10,4,Chelsea,8,10,3,6,1,14,10,4,15,4,1,3,0,6,4,2,6,6,2,3,1,8,6,2,9,,,Stamford Bridge,London
2001/02,10,27,Bolton Wanderers,9,11,4,3,4,14,14,0,15,5,2,0,3,3,8,-5,6,6,2,3,1,11,6,5,9,,,Macron Stadium,Bolton
2001/02,10,3,Blackburn Rovers,10,11,3,5,3,18,14,4,14,6,3,3,0,13,5,8,12,5,0,2,3,5,9,-4,2,Q,EU_UC,Ewood Park,Blackburn
2001/02,10,7,Everton,11,10,4,2,4,16,15,1,14,6,3,1,2,13,9,4,10,4,1,1,2,3,6,-3,4,,,Goodison Park,Liverpool
2001/02,10,25,West Ham United,12,10,4,2,4,12,19,-7,14,4,3,1,0,7,1,6,10,6,1,1,4,5,18,-13,4,,,Boleyn Ground,London
2001/02,10,29,Sunderland,13,11,3,4,4,10,13,-3,13,6,2,2,2,7,8,-1,8,5,1,2,2,3,5,-2,5,,,Stadium of Light,Sunderland
2001/02,10,34,Fulham,14,10,2,5,3,10,12,-2,11,6,2,3,1,7,6,1,9,4,0,2,2,3,6,-3,2,Q,EU_IT,Craven Cottage,London
2001/02,10,13,Middlesbrough,15,11,3,2,6,11,19,-8,11,5,2,0,3,6,11,-5,6,6,1,2,3,5,8,-3,5,,,Riverside Stadium,Middlesbrough
2001/02,10,31,Charlton Athletic,16,10,2,4,4,8,11,-3,10,6,1,2,3,4,7,-3,5,4,1,2,1,4,4,0,5,,,The Valley,London
2001/02,10,8,Ipswich Town,17,11,1,5,5,12,18,-6,8,6,1,2,3,7,8,-1,5,5,0,3,2,5,10,-5,3,Q,EU_UC,Portman Road,Ipswich
2001/02,10,28,Derby County,18,10,1,4,5,8,17,-9,7,6,1,3,2,6,8,-2,6,4,0,1,3,2,9,-7,1,R,EN_D1,Pride Park,Derby
2001/02,10,20,Southampton,19,10,2,1,7,9,19,-10,7,4,0,1,3,4,10,-6,1,6,2,0,4,5,9,-4,6,R,EN_D1,St. Mary's Stadium,Southampton
2001/02,10,26,Leicester City,20,11,1,3,7,6,23,-17,6,5,0,2,3,3,12,-9,2,6,1,1,4,3,11,-8,4,R,EN_D1,Filbert Street,Leicester
2001/02,11,9,Leeds United,1,11,6,5,0,15,5,10,23,5,3,2,0,7,1,6,11,6,3,3,0,8,4,4,12,Q,EU_CL,Elland Road,Leeds
2001/02,11,10,Liverpool,2,10,7,1,2,20,10,10,22,5,3,1,1,8,6,2,10,5,4,0,1,12,4,8,12,Q,EU_CL,Anfield,Liverpool
2001/02,11,2,Aston Villa,3,11,6,3,2,17,11,6,21,6,4,2,0,9,3,6,14,5,2,1,2,8,8,0,7,"Q,Q","EU_CL,EU_IT",Villa Park,Birmingham
2001/02,11,23,Newcastle United,4,11,6,2,3,21,14,7,20,6,3,1,2,9,8,1,10,5,3,1,1,12,6,6,10,Q,EU_CL,St. James' Park,Newcastle
2001/02,11,1,Arsenal,5,11,5,4,2,24,13,11,19,5,1,2,2,11,10,1,5,6,4,2,0,13,3,10,14,Q,EU_UC,Highbury,London
2001/02,11,12,Manchester United,6,11,5,3,3,28,20,8,18,5,3,1,1,13,6,7,10,6,2,2,2,15,14,1,8,Q,EU_UC,Old Trafford,Manchester
2001/02,11,4,Chelsea,7,11,4,6,1,16,11,5,18,5,2,3,0,8,5,3,9,6,2,3,1,8,6,2,9,,,Stamford Bridge,London
2001/02,11,3,Blackburn Rovers,8,12,4,5,3,20,15,5,17,6,3,3,0,13,5,8,12,6,1,2,3,7,10,-3,5,Q,EU_UC,Ewood Park,Blackburn
2001/02,11,21,Tottenham Hotspur,9,12,5,2,5,19,17,2,17,6,3,1,2,12,10,2,10,6,2,1,3,7,7,0,7,,,White Hart Lane,London
2001/02,11,27,Bolton Wanderers,10,12,4,4,4,16,16,0,16,6,2,1,3,5,10,-5,7,6,2,3,1,11,6,5,9,,,Macron Stadium,Bolton
2001/02,11,7,Everton,11,11,4,3,4,18,17,1,15,6,3,1,2,13,9,4,10,5,1,2,2,5,8,-3,5,,,Goodison Park,Liverpool
2001/02,11,34,Fulham,12,11,3,5,3,12,12,0,14,6,2,3,1,7,6,1,9,5,1,2,2,5,6,-1,5,Q,EU_IT,Craven Cottage,London
2001/02,11,13,Middlesbrough,13,12,4,2,6,16,20,-4,14,6,3,0,3,11,12,-1,9,6,1,2,3,5,8,-3,5,,,Riverside Stadium,Middlesbrough
2001/02,11,25,West Ham United,14,11,4,2,5,12,21,-9,14,5,3,1,1,7,3,4,10,6,1,1,4,5,18,-13,4,,,Boleyn Ground,London
2001/02,11,31,Charlton Athletic,15,11,3,4,4,12,13,-1,13,6,1,2,3,4,7,-3,5,5,2,2,1,8,6,2,8,,,The Valley,London
2001/02,11,29,Sunderland,16,12,3,4,5,10,14,-4,13,6,2,2,2,7,8,-1,8,6,1,2,3,3,6,-3,5,,,Stadium of Light,Sunderland
2001/02,11,26,Leicester City,17,12,2,3,7,7,23,-16,9,6,1,2,3,4,12,-8,5,6,1,1,4,3,11,-8,4,,,Filbert Street,Leicester
2001/02,11,8,Ipswich Town,18,12,1,5,6,13,20,-7,8,6,1,2,3,7,8,-1,5,6,0,3,3,6,12,-6,3,"R,Q","EN_D1,EU_UC",Portman Road,Ipswich
2001/02,11,20,Southampton,19,11,2,1,8,10,21,-11,7,5,0,1,4,5,12,-7,1,6,2,0,4,5,9,-4,6,R,EN_D1,St. Mary's Stadium,Southampton
2001/02,11,28,Derby County,20,11,1,4,6,9,22,-13,7,6,1,3,2,6,8,-2,6,5,0,1,4,3,14,-11,1,R,EN_D1,Pride Park,Derby
2001/02,12,10,Liverpool,1,11,7,2,2,21,11,10,23,5,3,1,1,8,6,2,10,6,4,1,1,13,5,8,13,Q,EU_CL,Anfield,Liverpool
2001/02,12,9,Leeds United,2,12,6,5,1,15,7,8,23,5,3,2,0,7,1,6,11,7,3,3,1,8,6,2,12,Q,EU_CL,Elland Road,Leeds
2001/02,12,2,Aston Villa,3,12,6,4,2,17,11,6,22,7,4,3,0,9,3,6,15,5,2,1,2,8,8,0,7,"Q,Q","EU_CL,EU_IT",Villa Park,Birmingham
2001/02,12,12,Manchester United,4,12,6,3,3,30,20,10,21,6,4,1,1,15,6,9,13,6,2,2,2,15,14,1,8,Q,EU_CL,Old Trafford,Manchester
2001/02,12,1,Arsenal,5,12,5,5,2,25,14,11,20,5,1,2,2,11,10,1,5,7,4,3,0,14,4,10,15,Q,EU_UC,Highbury,London
2001/02,12,23,Newcastle United,6,12,6,2,4,22,17,5,20,6,3,1,2,9,8,1,10,6,3,1,2,13,9,4,10,Q,EU_UC,St. James' Park,Newcastle
2001/02,12,4,Chelsea,7,12,4,7,1,16,11,5,19,5,2,3,0,8,5,3,9,7,2,4,1,8,6,2,10,,,Stamford Bridge,London
2001/02,12,27,Bolton Wanderers,8,13,5,4,4,18,17,1,19,6,2,1,3,5,10,-5,7,7,3,3,1,13,7,6,12,,,Macron Stadium,Bolton
2001/02,12,3,Blackburn Rovers,9,13,4,6,3,21,16,5,18,7,3,4,0,14,6,8,13,6,1,2,3,7,10,-3,5,Q,EU_UC,Ewood Park,Blackburn
2001/02,12,21,Tottenham Hotspur,10,13,5,3,5,20,18,2,18,7,3,2,2,13,11,2,11,6,2,1,3,7,7,0,7,,,White Hart Lane,London
2001/02,12,34,Fulham,11,12,4,5,3,15,13,2,17,7,3,3,1,10,7,3,12,5,1,2,2,5,6,-1,5,Q,EU_IT,Craven Cottage,London
2001/02,12,7,Everton,12,12,4,4,4,18,17,1,16,7,3,2,2,13,9,4,11,5,1,2,2,5,8,-3,5,,,Goodison Park,Liverpool
2001/02,12,29,Sunderland,13,13,4,4,5,12,14,-2,16,7,3,2,2,9,8,1,11,6,1,2,3,3,6,-3,5,,,Stadium of Light,Sunderland
2001/02,12,13,Middlesbrough,14,13,4,3,6,16,20,-4,15,6,3,0,3,11,12,-1,9,7,1,3,3,5,8,-3,6,,,Riverside Stadium,Middlesbrough
2001/02,12,25,West Ham United,15,12,4,3,5,16,25,-9,15,5,3,1,1,7,3,4,10,7,1,2,4,9,22,-13,5,,,Boleyn Ground,London
2001/02,12,31,Charlton Athletic,16,12,3,5,4,16,17,-1,14,7,1,3,3,8,11,-3,6,5,2,2,1,8,6,2,8,,,The Valley,London
2001/02,12,28,Derby County,17,12,2,4,6,10,22,-12,10,7,2,3,2,7,8,-1,9,5,0,1,4,3,14,-11,1,,,Pride Park,Derby
2001/02,12,26,Leicester City,18,13,2,3,8,7,25,-18,9,6,1,2,3,4,12,-8,5,7,1,1,5,3,13,-10,4,R,EN_D1,Filbert Street,Leicester
2001/02,12,8,Ipswich Town,19,13,1,5,7,14,22,-8,8,7,1,2,4,8,10,-2,5,6,0,3,3,6,12,-6,3,"R,Q","EN_D1,EU_UC",Portman Road,Ipswich
2001/02,12,20,Southampton,20,12,2,1,9,10,22,-12,7,5,0,1,4,5,12,-7,1,7,2,0,5,5,10,-5,6,R,EN_D1,St. Mary's Stadium,Southampton
2001/02,13,10,Liverpool,1,12,8,2,2,22,11,11,26,6,4,1,1,9,6,3,13,6,4,1,1,13,5,8,13,Q,EU_CL,Anfield,Liverpool
2001/02,13,9,Leeds United,2,13,6,6,1,16,8,8,24,6,3,3,0,8,2,6,12,7,3,3,1,8,6,2,12,Q,EU_CL,Elland Road,Leeds
2001/02,13,1,Arsenal,3,13,6,5,2,28,15,13,23,6,2,2,2,14,11,3,8,7,4,3,0,14,4,10,15,Q,EU_CL,Highbury,London
2001/02,13,23,Newcastle United,4,13,7,2,4,23,17,6,23,7,4,1,2,10,8,2,13,6,3,1,2,13,9,4,10,Q,EU_CL,St. James' Park,Newcastle
2001/02,13,2,Aston Villa,5,13,6,5,2,18,12,6,23,7,4,3,0,9,3,6,15,6,2,2,2,9,9,0,8,"Q,Q","EU_UC,EU_IT",Villa Park,Birmingham
2001/02,13,12,Manchester United,6,13,6,3,4,31,23,8,21,6,4,1,1,15,6,9,13,7,2,2,3,16,17,-1,8,Q,EU_UC,Old Trafford,Manchester
2001/02,13,21,Tottenham Hotspur,7,14,6,3,5,21,18,3,21,7,3,2,2,13,11,2,11,7,3,1,3,8,7,1,10,,,White Hart Lane,London
2001/02,13,4,Chelsea,8,13,4,8,1,16,11,5,20,6,2,4,0,8,5,3,10,7,2,4,1,8,6,2,10,,,Stamford Bridge,London
2001/02,13,27,Bolton Wanderers,9,14,5,5,4,18,17,1,20,7,2,2,3,5,10,-5,8,7,3,3,1,13,7,6,12,,,Macron Stadium,Bolton
2001/02,13,3,Blackburn Rovers,10,14,4,7,3,21,16,5,19,7,3,4,0,14,6,8,13,7,1,3,3,7,10,-3,6,Q,EU_UC,Ewood Park,Blackburn
2001/02,13,34,Fulham,11,13,4,6,3,15,13,2,18,7,3,3,1,10,7,3,12,6,1,3,2,5,6,-1,6,Q,EU_IT,Craven Cottage,London
2001/02,13,7,Everton,12,13,4,5,4,18,17,1,17,7,3,2,2,13,9,4,11,6,1,3,2,5,8,-3,6,,,Goodison Park,Liverpool
2001/02,13,29,Sunderland,13,14,4,4,6,12,15,-3,16,7,3,2,2,9,8,1,11,7,1,2,4,3,7,-4,5,,,Stadium of Light,Sunderland
2001/02,13,13,Middlesbrough,14,14,4,4,6,16,20,-4,16,7,3,1,3,11,12,-1,10,7,1,3,3,5,8,-3,6,,,Riverside Stadium,Middlesbrough
2001/02,13,25,West Ham United,15,13,4,3,6,16,26,-10,15,6,3,1,2,7,4,3,10,7,1,2,4,9,22,-13,5,,,Boleyn Ground,London
2001/02,13,31,Charlton Athletic,16,13,3,5,5,16,18,-2,14,7,1,3,3,8,11,-3,6,6,2,2,2,8,7,1,8,,,The Valley,London
2001/02,13,20,Southampton,17,13,3,1,9,11,22,-11,10,6,1,1,4,6,12,-6,4,7,2,0,5,5,10,-5,6,,,St. Mary's Stadium,Southampton
2001/02,13,28,Derby County,18,13,2,4,7,10,23,-13,10,7,2,3,2,7,8,-1,9,6,0,1,5,3,15,-12,1,R,EN_D1,Pride Park,Derby
2001/02,13,26,Leicester City,19,14,2,4,8,7,25,-18,10,7,1,3,3,4,12,-8,6,7,1,1,5,3,13,-10,4,R,EN_D1,Filbert Street,Leicester
2001/02,13,8,Ipswich Town,20,14,1,6,7,14,22,-8,9,7,1,2,4,8,10,-2,5,7,0,4,3,6,12,-6,4,"R,Q","EN_D1,EU_UC",Portman Road,Ipswich
2001/02,14,10,Liverpool,1,13,9,2,2,23,11,12,29,6,4,1,1,9,6,3,13,7,5,1,1,14,5,9,16,Q,EU_CL,Anfield,Liverpool
2001/02,14,1,Arsenal,2,14,7,5,2,30,15,15,26,6,2,2,2,14,11,3,8,8,5,3,0,16,4,12,18,Q,EU_CL,Highbury,London
2001/02,14,9,Leeds United,3,14,6,7,1,16,8,8,25,6,3,3,0,8,2,6,12,8,3,4,1,8,6,2,13,Q,EU_CL,Elland Road,Leeds
2001/02,14,23,Newcastle United,4,14,7,3,4,24,18,6,24,7,4,1,2,10,8,2,13,7,3,2,2,14,10,4,11,Q,EU_CL,St. James' Park,Newcastle
2001/02,14,21,Tottenham Hotspur,5,15,7,3,5,24,20,4,24,8,4,2,2,16,13,3,14,7,3,1,3,8,7,1,10,Q,EU_UC,White Hart Lane,London
2001/02,14,2,Aston Villa,6,15,6,6,3,19,15,4,24,8,4,3,1,9,5,4,15,7,2,3,2,10,10,0,9,"Q,Q","EU_UC,EU_IT",Villa Park,Birmingham
2001/02,14,4,Chelsea,7,15,5,8,2,19,12,7,23,7,2,4,1,8,6,2,10,8,3,4,1,11,6,5,13,,,Stamford Bridge,London
2001/02,14,12,Manchester United,8,14,6,3,5,31,26,5,21,7,4,1,2,15,9,6,13,7,2,2,3,16,17,-1,8,,,Old Trafford,Manchester
2001/02,14,7,Everton,9,14,5,5,4,20,17,3,20,8,4,2,2,15,9,6,14,6,1,3,2,5,8,-3,6,,,Goodison Park,Liverpool
2001/02,14,27,Bolton Wanderers,10,15,5,5,5,20,20,0,20,7,2,2,3,5,10,-5,8,8,3,3,2,15,10,5,12,,,Macron Stadium,Bolton
2001/02,14,3,Blackburn Rovers,11,15,4,7,4,21,17,4,19,8,3,4,1,14,7,7,13,7,1,3,3,7,10,-3,6,Q,EU_UC,Ewood Park,Blackburn
2001/02,14,34,Fulham,12,14,4,7,3,15,13,2,19,8,3,4,1,10,7,3,13,6,1,3,2,5,6,-1,6,Q,EU_IT,Craven Cottage,London
2001/02,14,29,Sunderland,13,15,5,4,6,13,15,-2,19,8,4,2,2,10,8,2,14,7,1,2,4,3,7,-4,5,,,Stadium of Light,Sunderland
2001/02,14,13,Middlesbrough,14,15,5,4,6,17,20,-3,19,7,3,1,3,11,12,-1,10,8,2,3,3,6,8,-2,9,,,Riverside Stadium,Middlesbrough
2001/02,14,31,Charlton Athletic,15,15,4,6,5,18,19,-1,18,8,1,4,3,9,12,-3,7,7,3,2,2,9,7,2,11,,,The Valley,London
2001/02,14,25,West Ham United,16,15,4,4,7,17,28,-11,16,7,3,2,2,8,5,3,11,8,1,2,5,9,23,-14,5,,,Boleyn Ground,London
2001/02,14,26,Leicester City,17,15,3,4,8,9,25,-16,13,7,1,3,3,4,12,-8,6,8,2,1,5,5,13,-8,7,,,Filbert Street,Leicester
2001/02,14,20,Southampton,18,14,3,1,10,11,24,-13,10,6,1,1,4,6,12,-6,4,8,2,0,6,5,12,-7,6,R,EN_D1,St. Mary's Stadium,Southampton
2001/02,14,28,Derby County,19,14,2,4,8,10,24,-14,10,8,2,3,3,7,9,-2,9,6,0,1,5,3,15,-12,1,R,EN_D1,Pride Park,Derby
2001/02,14,8,Ipswich Town,20,15,1,6,8,14,24,-10,9,8,1,2,5,8,12,-4,5,7,0,4,3,6,12,-6,4,"R,Q","EN_D1,EU_UC",Portman Road,Ipswich
2001/02,15,10,Liverpool,1,15,10,3,2,25,11,14,33,8,5,2,1,11,6,5,17,7,5,1,1,14,5,9,16,Q,EU_CL,Anfield,Liverpool
2001/02,15,1,Arsenal,2,15,8,5,2,33,17,16,29,7,3,2,2,17,13,4,11,8,5,3,0,16,4,12,18,Q,EU_CL,Highbury,London
2001/02,15,9,Leeds United,3,15,7,7,1,18,9,9,28,6,3,3,0,8,2,6,12,9,4,4,1,10,7,3,16,Q,EU_CL,Elland Road,Leeds
2001/02,15,23,Newcastle United,4,15,8,3,4,25,18,7,27,7,4,1,2,10,8,2,13,8,4,2,2,15,10,5,14,Q,EU_CL,St. James' Park,Newcastle
2001/02,15,12,Manchester United,5,16,7,3,6,36,27,9,24,9,5,1,3,20,10,10,16,7,2,2,3,16,17,-1,8,Q,EU_UC,Old Trafford,Manchester
2001/02,15,4,Chelsea,6,16,5,9,2,19,12,7,24,7,2,4,1,8,6,2,10,9,3,5,1,11,6,5,14,Q,EU_UC,Stamford Bridge,London
2001/02,15,2,Aston Villa,7,16,6,6,4,21,18,3,24,8,4,3,1,9,5,4,15,8,2,3,3,12,13,-1,9,Q,EU_IT,Villa Park,Birmingham
2001/02,15,21,Tottenham Hotspur,8,16,7,3,6,25,23,2,24,8,4,2,2,16,13,3,14,8,3,1,4,9,10,-1,10,,,White Hart Lane,London
2001/02,15,34,Fulham,9,16,5,8,3,17,13,4,23,9,4,4,1,12,7,5,16,7,1,4,2,5,6,-1,7,Q,EU_IT,Craven Cottage,London
2001/02,15,31,Charlton Athletic,10,16,5,6,5,21,20,1,21,9,2,4,3,12,13,-1,10,7,3,2,2,9,7,2,11,,,The Valley,London
2001/02,15,7,Everton,11,15,5,5,5,20,19,1,20,8,4,2,2,15,9,6,14,7,1,3,3,5,10,-5,6,,,Goodison Park,Liverpool
2001/02,15,27,Bolton Wanderers,12,16,5,5,6,20,21,-1,20,7,2,2,3,5,10,-5,8,9,3,3,3,15,11,4,12,,,Macron Stadium,Bolton
2001/02,15,29,Sunderland,13,16,5,5,6,13,15,-2,20,9,4,3,2,10,8,2,15,7,1,2,4,3,7,-4,5,,,Stadium of Light,Sunderland
2001/02,15,3,Blackburn Rovers,14,16,4,7,5,22,19,3,19,9,3,4,2,15,9,6,13,7,1,3,3,7,10,-3,6,Q,EU_UC,Ewood Park,Blackburn
2001/02,15,13,Middlesbrough,15,16,5,4,7,17,22,-5,19,7,3,1,3,11,12,-1,10,9,2,3,4,6,10,-4,9,,,Riverside Stadium,Middlesbrough
2001/02,15,25,West Ham United,16,16,5,4,7,18,28,-10,19,7,3,2,2,8,5,3,11,9,2,2,5,10,23,-13,8,,,Boleyn Ground,London
2001/02,15,20,Southampton,17,15,4,1,10,15,24,-9,13,6,1,1,4,6,12,-6,4,9,3,0,6,9,12,-3,9,,,St. Mary's Stadium,Southampton
2001/02,15,28,Derby County,18,16,3,4,9,11,29,-18,13,9,3,3,3,8,9,-1,12,7,0,1,6,3,20,-17,1,R,EN_D1,Pride Park,Derby
2001/02,15,26,Leicester City,19,16,3,4,9,9,29,-20,13,8,1,3,4,4,16,-12,6,8,2,1,5,5,13,-8,7,R,EN_D1,Filbert Street,Leicester
2001/02,15,8,Ipswich Town,20,16,1,6,9,14,25,-11,9,9,1,2,6,8,13,-5,5,7,0,4,3,6,12,-6,4,"R,Q","EN_D1,EU_UC",Portman Road,Ipswich
2001/02,16,23,Newcastle United,1,17,10,3,4,30,20,10,33,8,5,1,2,12,9,3,16,9,5,2,2,18,11,7,17,Q,EU_CL,St. James' Park,Newcastle
2001/02,16,10,Liverpool,2,16,10,3,3,25,15,10,33,8,5,2,1,11,6,5,17,8,5,1,2,14,9,5,16,Q,EU_CL,Anfield,Liverpool
2001/02,16,9,Leeds United,3,17,8,8,1,23,13,10,32,8,4,4,0,13,6,7,16,9,4,4,1,10,7,3,16,Q,EU_CL,Elland Road,Leeds
2001/02,16,1,Arsenal,4,17,8,6,3,35,21,14,30,8,3,2,3,18,16,2,11,9,5,4,0,17,5,12,19,Q,EU_CL,Highbury,London
2001/02,16,4,Chelsea,5,17,6,9,2,23,12,11,27,8,3,4,1,12,6,6,13,9,3,5,1,11,6,5,14,Q,EU_UC,Stamford Bridge,London
2001/02,16,12,Manchester United,6,17,8,3,6,37,27,10,27,9,5,1,3,20,10,10,16,8,3,2,3,17,17,0,11,Q,EU_UC,Old Trafford,Manchester
2001/02,16,21,Tottenham Hotspur,7,17,8,3,6,29,23,6,27,9,5,2,2,20,13,7,17,8,3,1,4,9,10,-1,10,,,White Hart Lane,London
2001/02,16,2,Aston Villa,8,17,7,6,4,23,19,4,27,9,5,3,1,11,6,5,18,8,2,3,3,12,13,-1,9,Q,EU_IT,Villa Park,Birmingham
2001/02,16,7,Everton,9,17,6,5,6,23,22,1,23,9,5,2,2,16,9,7,17,8,1,3,4,7,13,-6,6,,,Goodison Park,Liverpool
2001/02,16,34,Fulham,10,17,5,8,4,17,17,0,23,9,4,4,1,12,7,5,16,8,1,4,3,5,10,-5,7,Q,EU_IT,Craven Cottage,London
2001/02,16,31,Charlton Athletic,11,17,5,7,5,21,20,1,22,9,2,4,3,12,13,-1,10,8,3,3,2,9,7,2,12,,,The Valley,London
2001/02,16,27,Bolton Wanderers,12,17,5,6,6,20,21,-1,21,8,2,3,3,5,10,-5,9,9,3,3,3,15,11,4,12,,,Macron Stadium,Bolton
2001/02,16,29,Sunderland,13,17,5,5,7,13,17,-4,20,9,4,3,2,10,8,2,15,8,1,2,5,3,9,-6,5,,,Stadium of Light,Sunderland
2001/02,16,25,West Ham United,14,17,5,5,7,19,29,-10,20,8,3,3,2,9,6,3,12,9,2,2,5,10,23,-13,8,,,Boleyn Ground,London
2001/02,16,3,Blackburn Rovers,15,17,4,7,6,23,21,2,19,9,3,4,2,15,9,6,13,8,1,3,4,8,12,-4,6,Q,EU_UC,Ewood Park,Blackburn
2001/02,16,13,Middlesbrough,16,17,5,4,8,17,23,-6,19,8,3,1,4,11,13,-2,10,9,2,3,4,6,10,-4,9,,,Riverside Stadium,Middlesbrough
2001/02,16,20,Southampton,17,16,5,1,10,17,24,-7,16,7,2,1,4,8,12,-4,7,9,3,0,6,9,12,-3,9,,,St. Mary's Stadium,Southampton
2001/02,16,26,Leicester City,18,17,3,5,9,11,31,-20,14,8,1,3,4,4,16,-12,6,9,2,2,5,7,15,-8,8,R,EN_D1,Filbert Street,Leicester
2001/02,16,28,Derby County,19,17,3,4,10,11,30,-19,13,9,3,3,3,8,9,-1,12,8,0,1,7,3,21,-18,1,R,EN_D1,Pride Park,Derby
2001/02,16,8,Ipswich Town,20,17,1,6,10,15,27,-12,9,9,1,2,6,8,13,-5,5,8,0,4,4,7,14,-7,4,"R,Q","EN_D1,EU_UC",Portman Road,Ipswich
2001/02,17,23,Newcastle United,1,18,11,3,4,34,23,11,36,8,5,1,2,12,9,3,16,10,6,2,2,22,14,8,20,Q,EU_CL,St. James' Park,Newcastle
2001/02,17,1,Arsenal,2,18,9,6,3,37,22,15,33,8,3,2,3,18,16,2,11,10,6,4,0,19,6,13,22,Q,EU_CL,Highbury,London
2001/02,17,10,Liverpool,3,17,10,3,4,26,17,9,33,9,5,2,2,12,8,4,17,8,5,1,2,14,9,5,16,Q,EU_CL,Anfield,Liverpool
2001/02,17,9,Leeds United,4,18,8,8,2,26,17,9,32,9,4,4,1,16,10,6,16,9,4,4,1,10,7,3,16,Q,EU_CL,Elland Road,Leeds
2001/02,17,12,Manchester United,5,18,9,3,6,43,28,15,30,10,6,1,3,26,11,15,19,8,3,2,3,17,17,0,11,Q,EU_UC,Old Trafford,Manchester
2001/02,17,4,Chelsea,6,18,7,9,2,28,13,15,30,9,4,4,1,17,7,10,16,9,3,5,1,11,6,5,14,Q,EU_UC,Stamford Bridge,London
2001/02,17,21,Tottenham Hotspur,7,18,8,3,7,30,25,5,27,10,5,2,3,21,15,6,17,8,3,1,4,9,10,-1,10,,,White Hart Lane,London
2001/02,17,2,Aston Villa,8,18,7,6,5,24,22,2,27,9,5,3,1,11,6,5,18,9,2,3,4,13,16,-3,9,Q,EU_IT,Villa Park,Birmingham
2001/02,17,7,Everton,9,18,6,5,7,23,23,0,23,9,5,2,2,16,9,7,17,9,1,3,5,7,14,-7,6,,,Goodison Park,Liverpool
2001/02,17,34,Fulham,10,17,5,8,4,17,17,0,23,9,4,4,1,12,7,5,16,8,1,4,3,5,10,-5,7,Q,EU_IT,Craven Cottage,London
2001/02,17,29,Sunderland,11,18,6,5,7,14,17,-3,23,10,5,3,2,11,8,3,18,8,1,2,5,3,9,-6,5,,,Stadium of Light,Sunderland
2001/02,17,3,Blackburn Rovers,12,18,5,7,6,25,21,4,22,9,3,4,2,15,9,6,13,9,2,3,4,10,12,-2,9,Q,EU_UC,Ewood Park,Blackburn
2001/02,17,31,Charlton Athletic,13,18,5,7,6,21,22,-1,22,10,2,4,4,12,15,-3,10,8,3,3,2,9,7,2,12,,,The Valley,London
2001/02,17,27,Bolton Wanderers,14,18,5,6,7,21,26,-5,21,8,2,3,3,5,10,-5,9,10,3,3,4,16,16,0,12,,,Macron Stadium,Bolton
2001/02,17,25,West Ham United,15,18,5,6,7,20,30,-10,21,8,3,3,2,9,6,3,12,10,2,3,5,11,24,-13,9,,,Boleyn Ground,London
2001/02,17,13,Middlesbrough,16,17,5,4,8,17,23,-6,19,8,3,1,4,11,13,-2,10,9,2,3,4,6,10,-4,9,,,Riverside Stadium,Middlesbrough
2001/02,17,20,Southampton,17,17,5,1,11,18,30,-12,16,7,2,1,4,8,12,-4,7,10,3,0,7,10,18,-8,9,,,St. Mary's Stadium,Southampton
2001/02,17,28,Derby County,18,18,4,4,10,14,31,-17,16,10,4,3,3,11,10,1,15,8,0,1,7,3,21,-18,1,R,EN_D1,Pride Park,Derby
2001/02,17,26,Leicester City,19,18,3,6,9,12,32,-20,15,9,1,4,4,5,17,-12,7,9,2,2,5,7,15,-8,8,R,EN_D1,Filbert Street,Leicester
2001/02,17,8,Ipswich Town,20,18,2,6,10,17,28,-11,12,9,1,2,6,8,13,-5,5,9,1,4,4,9,15,-6,7,"R,Q","EN_D1,EU_UC",Portman Road,Ipswich
2001/02,18,23,Newcastle United,1,19,12,3,4,37,23,14,39,9,6,1,2,15,9,6,19,10,6,2,2,22,14,8,20,Q,EU_CL,St. James' Park,Newcastle
2001/02,18,1,Arsenal,2,19,10,6,3,39,23,16,36,9,4,2,3,20,17,3,14,10,6,4,0,19,6,13,22,Q,EU_CL,Highbury,London
2001/02,18,10,Liverpool,3,18,11,3,4,28,18,10,36,9,5,2,2,12,8,4,17,9,6,1,2,16,10,6,19,Q,EU_CL,Anfield,Liverpool
2001/02,18,9,Leeds United,4,19,9,8,2,29,17,12,35,9,4,4,1,16,10,6,16,10,5,4,1,13,7,6,19,Q,EU_CL,Elland Road,Leeds
2001/02,18,12,Manchester United,5,19,10,3,6,45,28,17,33,10,6,1,3,26,11,15,19,9,4,2,3,19,17,2,14,Q,EU_UC,Old Trafford,Manchester
2001/02,18,4,Chelsea,6,19,7,9,3,29,15,14,30,9,4,4,1,17,7,10,16,10,3,5,2,12,8,4,14,Q,EU_UC,Stamford Bridge,London
2001/02,18,21,Tottenham Hotspur,7,19,8,3,8,30,26,4,27,10,5,2,3,21,15,6,17,9,3,1,5,9,11,-2,10,,,White Hart Lane,London
2001/02,18,2,Aston Villa,8,19,7,6,6,25,24,1,27,10,5,3,2,12,8,4,18,9,2,3,4,13,16,-3,9,Q,EU_IT,Villa Park,Birmingham
2001/02,18,29,Sunderland,9,19,7,5,7,17,17,0,26,10,5,3,2,11,8,3,18,9,2,2,5,6,9,-3,8,,,Stadium of Light,Sunderland
2001/02,18,34,Fulham,10,18,5,9,4,17,17,0,24,10,4,5,1,12,7,5,17,8,1,4,3,5,10,-5,7,Q,EU_IT,Craven Cottage,London
2001/02,18,25,West Ham United,11,19,6,6,7,24,30,-6,24,9,4,3,2,13,6,7,15,10,2,3,5,11,24,-13,9,,,Boleyn Ground,London
2001/02,18,31,Charlton Athletic,12,19,5,8,6,21,22,-1,23,10,2,4,4,12,15,-3,10,9,3,4,2,9,7,2,13,,,The Valley,London
2001/02,18,7,Everton,13,19,6,5,8,23,25,-2,23,10,5,2,3,16,11,5,17,9,1,3,5,7,14,-7,6,,,Goodison Park,Liverpool
2001/02,18,3,Blackburn Rovers,14,19,5,7,7,25,24,1,22,10,3,4,3,15,12,3,13,9,2,3,4,10,12,-2,9,Q,EU_UC,Ewood Park,Blackburn
2001/02,18,27,Bolton Wanderers,15,19,5,6,8,21,29,-8,21,9,2,3,4,5,13,-8,9,10,3,3,4,16,16,0,12,,,Macron Stadium,Bolton
2001/02,18,13,Middlesbrough,16,18,5,4,9,17,26,-9,19,8,3,1,4,11,13,-2,10,10,2,3,5,6,13,-7,9,,,Riverside Stadium,Middlesbrough
2001/02,18,20,Southampton,17,18,6,1,11,19,30,-11,19,8,3,1,4,9,12,-3,10,10,3,0,7,10,18,-8,9,,,St. Mary's Stadium,Southampton
2001/02,18,28,Derby County,18,19,4,4,11,14,35,-21,16,10,4,3,3,11,10,1,15,9,0,1,8,3,25,-22,1,R,EN_D1,Pride Park,Derby
2001/02,18,8,Ipswich Town,19,19,3,6,10,19,28,-9,15,10,2,2,6,10,13,-3,8,9,1,4,4,9,15,-6,7,"R,Q","EN_D1,EU_UC",Portman Road,Ipswich
2001/02,18,26,Leicester City,20,19,3,6,10,12,34,-22,15,9,1,4,4,5,17,-12,7,10,2,2,6,7,17,-10,8,R,EN_D1,Filbert Street,Leicester
2001/02,19,1,Arsenal,1,20,11,6,3,41,24,17,39,10,5,2,3,22,18,4,17,10,6,4,0,19,6,13,22,Q,EU_CL,Highbury,London
2001/02,19,23,Newcastle United,2,20,12,3,5,38,25,13,39,10,6,1,3,16,11,5,19,10,6,2,2,22,14,8,20,Q,EU_CL,St. James' Park,Newcastle
2001/02,19,9,Leeds United,3,20,10,8,2,30,17,13,38,9,4,4,1,16,10,6,16,11,6,4,1,14,7,7,22,Q,EU_CL,Elland Road,Leeds
2001/02,19,10,Liverpool,4,19,11,4,4,29,19,10,37,9,5,2,2,12,8,4,17,10,6,2,2,17,11,6,20,Q,EU_CL,Anfield,Liverpool
2001/02,19,12,Manchester United,5,20,11,3,6,48,30,18,36,10,6,1,3,26,11,15,19,10,5,2,3,22,19,3,17,Q,EU_UC,Old Trafford,Manchester
2001/02,19,4,Chelsea,6,20,8,9,3,31,16,15,33,9,4,4,1,17,7,10,16,11,4,5,2,14,9,5,17,Q,EU_UC,Stamford Bridge,London
2001/02,19,21,Tottenham Hotspur,7,20,8,4,8,31,27,4,28,10,5,2,3,21,15,6,17,10,3,2,5,10,12,-2,11,,,White Hart Lane,London
2001/02,19,2,Aston Villa,8,20,7,7,6,26,25,1,28,11,5,4,2,13,9,4,19,9,2,3,4,13,16,-3,9,Q,EU_IT,Villa Park,Birmingham
2001/02,19,31,Charlton Athletic,9,20,6,8,6,24,22,2,26,10,2,4,4,12,15,-3,10,10,4,4,2,12,7,5,16,,,The Valley,London
2001/02,19,29,Sunderland,10,20,7,5,8,17,22,-5,26,10,5,3,2,11,8,3,18,10,2,2,6,6,14,-8,8,,,Stadium of Light,Sunderland
2001/02,19,25,West Ham United,11,20,6,7,7,25,31,-6,25,10,4,4,2,14,7,7,16,10,2,3,5,11,24,-13,9,,,Boleyn Ground,London
2001/02,19,34,Fulham,12,19,5,9,5,19,20,-1,24,11,4,5,2,14,10,4,17,8,1,4,3,5,10,-5,7,Q,EU_IT,Craven Cottage,London
2001/02,19,7,Everton,13,20,6,5,9,23,28,-5,23,11,5,2,4,16,14,2,17,9,1,3,5,7,14,-7,6,,,Goodison Park,Liverpool
2001/02,19,3,Blackburn Rovers,14,20,5,7,8,25,25,0,22,11,3,4,4,15,13,2,13,9,2,3,4,10,12,-2,9,Q,EU_UC,Ewood Park,Blackburn
2001/02,19,27,Bolton Wanderers,15,20,5,7,8,23,31,-8,22,10,2,4,4,7,15,-8,10,10,3,3,4,16,16,0,12,,,Macron Stadium,Bolton
2001/02,19,13,Middlesbrough,16,19,5,4,10,18,28,-10,19,8,3,1,4,11,13,-2,10,11,2,3,6,7,15,-8,9,,,Riverside Stadium,Middlesbrough
2001/02,19,20,Southampton,17,19,6,1,12,19,31,-12,19,9,3,1,5,9,13,-4,10,10,3,0,7,10,18,-8,9,,,St. Mary's Stadium,Southampton
2001/02,19,28,Derby County,18,20,5,4,11,15,35,-20,19,10,4,3,3,11,10,1,15,10,1,1,8,4,25,-21,4,R,EN_D1,Pride Park,Derby
2001/02,19,8,Ipswich Town,19,20,4,6,10,24,28,-4,18,11,3,2,6,15,13,2,11,9,1,4,4,9,15,-6,7,"R,Q","EN_D1,EU_UC",Portman Road,Ipswich
2001/02,19,26,Leicester City,20,20,3,7,10,14,36,-22,16,9,1,4,4,5,17,-12,7,11,2,3,6,9,19,-10,9,R,EN_D1,Filbert Street,Leicester
2001/02,20,9,Leeds United,1,21,11,8,2,33,17,16,41,10,5,4,1,19,10,9,19,11,6,4,1,14,7,7,22,Q,EU_CL,Elland Road,Leeds
2001/02,20,12,Manchester United,2,21,12,3,6,51,31,20,39,11,7,1,3,29,12,17,22,10,5,2,3,22,19,3,17,Q,EU_CL,Old Trafford,Manchester
2001/02,20,1,Arsenal,3,20,11,6,3,41,24,17,39,10,5,2,3,22,18,4,17,10,6,4,0,19,6,13,22,Q,EU_CL,Highbury,London
2001/02,20,23,Newcastle United,4,21,12,3,6,39,28,11,39,10,6,1,3,16,11,5,19,11,6,2,3,23,17,6,20,Q,EU_CL,St. James' Park,Newcastle
2001/02,20,10,Liverpool,5,21,11,5,5,30,22,8,38,10,5,3,2,13,9,4,18,11,6,2,3,17,13,4,20,Q,EU_UC,Anfield,Liverpool
2001/02,20,4,Chelsea,6,21,8,9,4,33,20,13,33,10,4,4,2,19,11,8,16,11,4,5,2,14,9,5,17,Q,EU_UC,Stamford Bridge,London
2001/02,20,21,Tottenham Hotspur,7,21,9,4,8,32,27,5,31,11,6,2,3,22,15,7,20,10,3,2,5,10,12,-2,11,,,White Hart Lane,London
2001/02,20,31,Charlton Athletic,8,21,7,8,6,27,24,3,29,11,3,4,4,15,17,-2,13,10,4,4,2,12,7,5,16,,,The Valley,London
2001/02,20,2,Aston Villa,9,21,7,8,6,27,26,1,29,11,5,4,2,13,9,4,19,10,2,4,4,14,17,-3,10,Q,EU_IT,Villa Park,Birmingham
2001/02,20,34,Fulham,10,20,6,9,5,20,20,0,27,11,4,5,2,14,10,4,17,9,2,4,3,6,10,-4,10,Q,EU_IT,Craven Cottage,London
2001/02,20,29,Sunderland,11,21,7,6,8,18,23,-5,27,11,5,4,2,12,9,3,19,10,2,2,6,6,14,-8,8,,,Stadium of Light,Sunderland
2001/02,20,20,Southampton,12,21,8,1,12,25,33,-8,25,10,4,1,5,11,13,-2,13,11,4,0,7,14,20,-6,12,,,St. Mary's Stadium,Southampton
2001/02,20,25,West Ham United,13,21,6,7,8,25,34,-9,25,10,4,4,2,14,7,7,16,11,2,3,6,11,27,-16,9,,,Boleyn Ground,London
2001/02,20,7,Everton,14,21,6,5,10,23,29,-6,23,11,5,2,4,16,14,2,17,10,1,3,6,7,15,-8,6,,,Goodison Park,Liverpool
2001/02,20,27,Bolton Wanderers,15,21,5,8,8,24,32,-8,23,10,2,4,4,7,15,-8,10,11,3,4,4,17,17,0,13,,,Macron Stadium,Bolton
2001/02,20,3,Blackburn Rovers,16,21,5,7,9,25,26,-1,22,11,3,4,4,15,13,2,13,10,2,3,5,10,13,-3,9,Q,EU_UC,Ewood Park,Blackburn
2001/02,20,13,Middlesbrough,17,20,6,4,10,19,28,-9,22,9,4,1,4,12,13,-1,13,11,2,3,6,7,15,-8,9,,,Riverside Stadium,Middlesbrough
2001/02,20,28,Derby County,18,21,5,4,12,15,36,-21,19,11,4,3,4,11,11,0,15,10,1,1,8,4,25,-21,4,R,EN_D1,Pride Park,Derby
2001/02,20,8,Ipswich Town,19,21,4,6,11,26,31,-5,18,11,3,2,6,15,13,2,11,10,1,4,5,11,18,-7,7,"R,Q","EN_D1,EU_UC",Portman Road,Ipswich
2001/02,20,26,Leicester City,20,20,3,7,10,14,36,-22,16,9,1,4,4,5,17,-12,7,11,2,3,6,9,19,-10,9,R,EN_D1,Filbert Street,Leicester
2001/02,21,12,Manchester United,1,22,13,3,6,54,32,22,42,11,7,1,3,29,12,17,22,11,6,2,3,25,20,5,20,Q,EU_CL,Old Trafford,Manchester
2001/02,21,23,Newcastle United,2,22,13,3,6,42,29,13,42,11,7,1,3,19,12,7,22,11,6,2,3,23,17,6,20,Q,EU_CL,St. James' Park,Newcastle
2001/02,21,9,Leeds United,3,22,11,8,3,34,20,14,41,10,5,4,1,19,10,9,19,12,6,4,2,15,10,5,22,Q,EU_CL,Elland Road,Leeds
2001/02,21,1,Arsenal,4,21,11,7,3,42,25,17,40,11,5,3,3,23,19,4,18,10,6,4,0,19,6,13,22,Q,EU_CL,Highbury,London
2001/02,21,10,Liverpool,5,22,11,6,5,31,23,8,39,10,5,3,2,13,9,4,18,12,6,3,3,18,14,4,21,Q,EU_UC,Anfield,Liverpool
2001/02,21,4,Chelsea,6,22,8,10,4,35,22,13,34,10,4,4,2,19,11,8,16,12,4,6,2,16,11,5,18,Q,EU_UC,Stamford Bridge,London
2001/02,21,2,Aston Villa,7,22,8,8,6,29,27,2,32,12,6,4,2,15,10,5,22,10,2,4,4,14,17,-3,10,Q,EU_IT,Villa Park,Birmingham
2001/02,21,21,Tottenham Hotspur,8,22,9,4,9,33,29,4,31,11,6,2,3,22,15,7,20,11,3,2,6,11,14,-3,11,,,White Hart Lane,London
2001/02,21,34,Fulham,9,21,7,9,5,22,21,1,30,12,5,5,2,16,11,5,20,9,2,4,3,6,10,-4,10,Q,EU_IT,Craven Cottage,London
2001/02,21,31,Charlton Athletic,10,22,7,8,7,28,28,0,29,11,3,4,4,15,17,-2,13,11,4,4,3,13,11,2,16,,,The Valley,London
2001/02,21,25,West Ham United,11,22,7,7,8,26,34,-8,28,11,5,4,2,15,7,8,19,11,2,3,6,11,27,-16,9,,,Boleyn Ground,London
2001/02,21,29,Sunderland,12,22,7,6,9,18,24,-6,27,11,5,4,2,12,9,3,19,11,2,2,7,6,15,-9,8,,,Stadium of Light,Sunderland
2001/02,21,7,Everton,13,22,7,5,10,24,29,-5,26,12,6,2,4,17,14,3,20,10,1,3,6,7,15,-8,6,,,Goodison Park,Liverpool
2001/02,21,3,Blackburn Rovers,14,22,6,7,9,29,27,2,25,12,4,4,4,19,14,5,16,10,2,3,5,10,13,-3,9,Q,EU_UC,Ewood Park,Blackburn
2001/02,21,20,Southampton,15,22,8,1,13,26,36,-10,25,11,4,1,6,12,16,-4,13,11,4,0,7,14,20,-6,12,,,St. Mary's Stadium,Southampton
2001/02,21,27,Bolton Wanderers,16,22,5,9,8,26,34,-8,24,11,2,5,4,9,17,-8,11,11,3,4,4,17,17,0,13,,,Macron Stadium,Bolton
2001/02,21,13,Middlesbrough,17,21,6,4,11,20,30,-10,22,9,4,1,4,12,13,-1,13,12,2,3,7,8,17,-9,9,,,Riverside Stadium,Middlesbrough
2001/02,21,8,Ipswich Town,18,22,5,6,11,28,32,-4,21,12,4,2,6,17,14,3,14,10,1,4,5,11,18,-7,7,"R,Q","EN_D1,EU_UC",Portman Road,Ipswich
2001/02,21,28,Derby County,19,22,5,4,13,16,38,-22,19,11,4,3,4,11,11,0,15,11,1,1,9,5,27,-22,4,R,EN_D1,Pride Park,Derby
2001/02,21,26,Leicester City,20,21,3,7,11,14,37,-23,16,9,1,4,4,5,17,-12,7,12,2,3,7,9,20,-11,9,R,EN_D1,Filbert Street,Leicester
2001/02,22,12,Manchester United,1,24,14,3,7,56,34,22,45,13,8,1,4,31,14,17,25,11,6,2,3,25,20,5,20,Q,EU_CL,Old Trafford,Manchester
2001/02,22,1,Arsenal,2,23,12,8,3,46,27,19,44,11,5,3,3,23,19,4,18,12,7,5,0,23,8,15,26,Q,EU_CL,Highbury,London
2001/02,22,23,Newcastle United,3,23,13,4,6,42,29,13,43,11,7,1,3,19,12,7,22,12,6,3,3,23,17,6,21,Q,EU_CL,St. James' Park,Newcastle
2001/02,22,10,Liverpool,4,24,12,7,5,33,24,9,43,11,5,4,2,14,10,4,19,13,7,3,3,19,14,5,24,Q,EU_CL,Anfield,Liverpool
2001/02,22,9,Leeds United,5,23,11,9,3,35,21,14,42,11,5,5,1,20,11,9,20,12,6,4,2,15,10,5,22,Q,EU_UC,Elland Road,Leeds
2001/02,22,4,Chelsea,6,23,9,10,4,40,23,17,37,11,5,4,2,24,12,12,19,12,4,6,2,16,11,5,18,Q,EU_UC,Stamford Bridge,London
2001/02,22,2,Aston Villa,7,23,9,8,6,31,28,3,35,12,6,4,2,15,10,5,22,11,3,4,4,16,18,-2,13,Q,EU_IT,Villa Park,Birmingham
2001/02,22,21,Tottenham Hotspur,8,23,9,5,9,34,30,4,32,12,6,3,3,23,16,7,21,11,3,2,6,11,14,-3,11,,,White Hart Lane,London
2001/02,22,34,Fulham,9,22,7,10,5,23,22,1,31,12,5,5,2,16,11,5,20,10,2,5,3,7,11,-4,11,Q,EU_IT,Craven Cottage,London
2001/02,22,31,Charlton Athletic,10,23,7,8,8,29,30,-1,29,12,3,4,5,16,19,-3,13,11,4,4,3,13,11,2,16,,,The Valley,London
2001/02,22,29,Sunderland,11,23,7,7,9,19,25,-6,28,12,5,5,2,13,10,3,20,11,2,2,7,6,15,-9,8,,,Stadium of Light,Sunderland
2001/02,22,25,West Ham United,12,23,7,7,9,27,39,-12,28,11,5,4,2,15,7,8,19,12,2,3,7,12,32,-20,9,,,Boleyn Ground,London
2001/02,22,7,Everton,13,23,7,6,10,25,30,-5,27,12,6,2,4,17,14,3,20,11,1,4,6,8,16,-8,7,,,Goodison Park,Liverpool
2001/02,22,20,Southampton,14,23,8,2,13,27,37,-10,26,11,4,1,6,12,16,-4,13,12,4,1,7,15,21,-6,13,,,St. Mary's Stadium,Southampton
2001/02,22,3,Blackburn Rovers,15,23,6,7,10,30,29,1,25,12,4,4,4,19,14,5,16,11,2,3,6,11,15,-4,9,Q,EU_UC,Ewood Park,Blackburn
2001/02,22,27,Bolton Wanderers,16,23,5,10,8,27,35,-8,25,11,2,5,4,9,17,-8,11,12,3,5,4,18,18,0,14,,,Macron Stadium,Bolton
2001/02,22,8,Ipswich Town,17,23,6,6,11,31,33,-2,24,12,4,2,6,17,14,3,14,11,2,4,5,14,19,-5,10,Q,EU_UC,Portman Road,Ipswich
2001/02,22,13,Middlesbrough,18,22,6,5,11,21,31,-10,23,10,4,2,4,13,14,-1,14,12,2,3,7,8,17,-9,9,R,EN_D1,Riverside Stadium,Middlesbrough
2001/02,22,28,Derby County,19,23,5,4,14,17,41,-24,19,12,4,3,5,12,14,-2,15,11,1,1,9,5,27,-22,4,R,EN_D1,Pride Park,Derby
2001/02,22,26,Leicester City,20,23,3,8,12,15,40,-25,17,11,1,5,5,6,20,-14,8,12,2,3,7,9,20,-11,9,R,EN_D1,Filbert Street,Leicester
2001/02,23,12,Manchester United,1,25,15,3,7,60,34,26,48,13,8,1,4,31,14,17,25,12,7,2,3,29,20,9,23,Q,EU_CL,Old Trafford,Manchester
2001/02,23,1,Arsenal,2,24,13,8,3,49,29,20,47,11,5,3,3,23,19,4,18,13,8,5,0,26,10,16,29,Q,EU_CL,Highbury,London
2001/02,23,23,Newcastle United,3,24,14,4,6,45,30,15,46,11,7,1,3,19,12,7,22,13,7,3,3,26,18,8,24,Q,EU_CL,St. James' Park,Newcastle
2001/02,23,10,Liverpool,4,25,13,7,5,34,24,10,46,12,6,4,2,15,10,5,22,13,7,3,3,19,14,5,24,Q,EU_CL,Anfield,Liverpool
2001/02,23,9,Leeds United,5,24,11,9,4,35,23,12,42,11,5,5,1,20,11,9,20,13,6,4,3,15,12,3,22,Q,EU_UC,Elland Road,Leeds
2001/02,23,4,Chelsea,6,24,10,10,4,42,23,19,40,12,6,4,2,26,12,14,22,12,4,6,2,16,11,5,18,Q,EU_UC,Stamford Bridge,London
2001/02,23,2,Aston Villa,7,24,9,9,6,31,28,3,36,13,6,5,2,15,10,5,23,11,3,4,4,16,18,-2,13,Q,EU_IT,Villa Park,Birmingham
2001/02,23,21,Tottenham Hotspur,8,24,9,5,10,35,33,2,32,13,6,3,4,24,19,5,21,11,3,2,6,11,14,-3,11,,,White Hart Lane,London
2001/02,23,31,Charlton Athletic,9,24,8,8,8,30,30,0,32,13,4,4,5,17,19,-2,16,11,4,4,3,13,11,2,16,,,The Valley,London
2001/02,23,34,Fulham,10,23,7,10,6,23,23,0,31,12,5,5,2,16,11,5,20,11,2,5,4,7,12,-5,11,Q,EU_IT,Craven Cottage,London
2001/02,23,20,Southampton,11,24,9,2,13,29,37,-8,29,12,5,1,6,14,16,-2,16,12,4,1,7,15,21,-6,13,,,St. Mary's Stadium,Southampton
2001/02,23,7,Everton,12,24,7,7,10,25,30,-5,28,12,6,2,4,17,14,3,20,12,1,5,6,8,16,-8,8,,,Goodison Park,Liverpool
2001/02,23,29,Sunderland,13,24,7,7,10,19,26,-7,28,13,5,5,3,13,11,2,20,11,2,2,7,6,15,-9,8,,,Stadium of Light,Sunderland
2001/02,23,25,West Ham United,14,24,7,7,10,27,41,-14,28,11,5,4,2,15,7,8,19,13,2,3,8,12,34,-22,9,,,Boleyn Ground,London
2001/02,23,8,Ipswich Town,15,24,7,6,11,32,33,-1,27,13,5,2,6,18,14,4,17,11,2,4,5,14,19,-5,10,Q,EU_UC,Portman Road,Ipswich
2001/02,23,13,Middlesbrough,16,23,7,5,11,22,31,-9,26,10,4,2,4,13,14,-1,14,13,3,3,7,9,17,-8,12,,,Riverside Stadium,Middlesbrough
2001/02,23,3,Blackburn Rovers,17,24,6,7,11,32,32,0,25,13,4,4,5,21,17,4,16,11,2,3,6,11,15,-4,9,Q,EU_UC,Ewood Park,Blackburn
2001/02,23,27,Bolton Wanderers,18,24,5,10,9,27,39,-12,25,12,2,5,5,9,21,-12,11,12,3,5,4,18,18,0,14,R,EN_D1,Macron Stadium,Bolton
2001/02,23,28,Derby County,19,24,5,4,15,17,42,-25,19,12,4,3,5,12,14,-2,15,12,1,1,10,5,28,-23,4,R,EN_D1,Pride Park,Derby
2001/02,23,26,Leicester City,20,24,3,8,13,15,41,-26,17,11,1,5,5,6,20,-14,8,13,2,3,8,9,21,-12,9,R,EN_D1,Filbert Street,Leicester
2001/02,24,12,Manchester United,1,26,16,3,7,64,35,29,51,14,9,1,4,35,15,20,28,12,7,2,3,29,20,9,23,Q,EU_CL,Old Trafford,Manchester
2001/02,24,23,Newcastle United,2,25,15,4,6,48,32,16,49,12,8,1,3,22,14,8,25,13,7,3,3,26,18,8,24,Q,EU_CL,St. James' Park,Newcastle
2001/02,24,10,Liverpool,3,26,14,7,5,38,24,14,49,12,6,4,2,15,10,5,22,14,8,3,3,23,14,9,27,Q,EU_CL,Anfield,Liverpool
2001/02,24,1,Arsenal,4,25,13,9,3,50,30,20,48,12,5,4,3,24,20,4,19,13,8,5,0,26,10,16,29,Q,EU_CL,Highbury,London
2001/02,24,4,Chelsea,5,25,11,10,4,45,25,20,43,12,6,4,2,26,12,14,22,13,5,6,2,19,13,6,21,Q,EU_UC,Stamford Bridge,London
2001/02,24,9,Leeds United,6,25,11,9,5,35,27,8,42,12,5,5,2,20,15,5,20,13,6,4,3,15,12,3,22,Q,EU_UC,Elland Road,Leeds
2001/02,24,2,Aston Villa,7,25,9,10,6,31,28,3,37,13,6,5,2,15,10,5,23,12,3,5,4,16,18,-2,14,Q,EU_IT,Villa Park,Birmingham
2001/02,24,31,Charlton Athletic,8,25,8,9,8,30,30,0,33,13,4,4,5,17,19,-2,16,12,4,5,3,13,11,2,17,,,The Valley,London
2001/02,24,21,Tottenham Hotspur,9,25,9,5,11,35,34,1,32,13,6,3,4,24,19,5,21,12,3,2,7,11,15,-4,11,,,White Hart Lane,London
2001/02,24,34,Fulham,10,24,7,11,6,23,23,0,32,13,5,6,2,16,11,5,21,11,2,5,4,7,12,-5,11,Q,EU_IT,Craven Cottage,London
2001/02,24,25,West Ham United,11,25,8,7,10,29,41,-12,31,12,6,4,2,17,7,10,22,13,2,3,8,12,34,-22,9,,,Boleyn Ground,London
2001/02,24,8,Ipswich Town,12,25,8,6,11,34,34,0,30,13,5,2,6,18,14,4,17,12,3,4,5,16,20,-4,13,Q,EU_UC,Portman Road,Ipswich
2001/02,24,20,Southampton,13,25,9,3,13,30,38,-8,30,12,5,1,6,14,16,-2,16,13,4,2,7,16,22,-6,14,,,St. Mary's Stadium,Southampton
2001/02,24,7,Everton,14,25,7,7,11,26,32,-6,28,13,6,2,5,18,16,2,20,12,1,5,6,8,16,-8,8,,,Goodison Park,Liverpool
2001/02,24,29,Sunderland,15,25,7,7,11,20,30,-10,28,13,5,5,3,13,11,2,20,12,2,2,8,7,19,-12,8,,,Stadium of Light,Sunderland
2001/02,24,13,Middlesbrough,16,24,7,6,11,22,31,-9,27,11,4,3,4,13,14,-1,15,13,3,3,7,9,17,-8,12,,,Riverside Stadium,Middlesbrough
2001/02,24,3,Blackburn Rovers,17,25,6,7,12,32,34,-2,25,13,4,4,5,21,17,4,16,12,2,3,7,11,17,-6,9,Q,EU_UC,Ewood Park,Blackburn
2001/02,24,27,Bolton Wanderers,18,25,5,10,10,29,42,-13,25,12,2,5,5,9,21,-12,11,13,3,5,5,20,21,-1,14,R,EN_D1,Macron Stadium,Bolton
2001/02,24,28,Derby County,19,25,6,4,15,18,42,-24,22,13,5,3,5,13,14,-1,18,12,1,1,10,5,28,-23,4,R,EN_D1,Pride Park,Derby
2001/02,24,26,Leicester City,20,25,3,8,14,17,44,-27,17,12,1,5,6,8,23,-15,8,13,2,3,8,9,21,-12,9,R,EN_D1,Filbert Street,Leicester
2001/02,25,12,Manchester United,1,27,17,3,7,66,35,31,54,14,9,1,4,35,15,20,28,13,8,2,3,31,20,11,26,Q,EU_CL,Old Trafford,Manchester
2001/02,25,10,Liverpool,2,27,15,7,5,44,24,20,52,12,6,4,2,15,10,5,22,15,9,3,3,29,14,15,30,Q,EU_CL,Anfield,Liverpool
2001/02,25,23,Newcastle United,3,26,16,4,6,51,33,18,52,13,9,1,3,25,15,10,28,13,7,3,3,26,18,8,24,Q,EU_CL,St. James' Park,Newcastle
2001/02,25,1,Arsenal,4,26,14,9,3,51,30,21,51,12,5,4,3,24,20,4,19,14,9,5,0,27,10,17,32,Q,EU_CL,Highbury,London
2001/02,25,4,Chelsea,5,26,11,11,4,46,26,20,44,12,6,4,2,26,12,14,22,14,5,7,2,20,14,6,22,Q,EU_UC,Stamford Bridge,London
2001/02,25,9,Leeds United,6,26,11,10,5,37,29,8,43,12,5,5,2,20,15,5,20,14,6,5,3,17,14,3,23,Q,EU_UC,Elland Road,Leeds
2001/02,25,2,Aston Villa,7,26,9,11,6,32,29,3,38,14,6,6,2,16,11,5,24,12,3,5,4,16,18,-2,14,Q,EU_IT,Villa Park,Birmingham
2001/02,25,21,Tottenham Hotspur,8,26,10,5,11,37,35,2,35,14,7,3,4,26,20,6,24,12,3,2,7,11,15,-4,11,,,White Hart Lane,London
2001/02,25,34,Fulham,9,26,8,11,7,26,25,1,35,14,6,6,2,18,11,7,24,12,2,5,5,8,14,-6,11,Q,EU_IT,Craven Cottage,London
2001/02,25,31,Charlton Athletic,10,26,8,9,9,30,32,-2,33,14,4,4,6,17,21,-4,16,12,4,5,3,13,11,2,17,,,The Valley,London
2001/02,25,13,Middlesbrough,11,26,8,7,11,26,34,-8,31,13,5,4,4,17,17,0,19,13,3,3,7,9,17,-8,12,,,Riverside Stadium,Middlesbrough
2001/02,25,29,Sunderland,12,26,8,7,11,21,30,-9,31,13,5,5,3,13,11,2,20,13,3,2,8,8,19,-11,11,,,Stadium of Light,Sunderland
2001/02,25,25,West Ham United,13,26,8,7,11,29,42,-13,31,12,6,4,2,17,7,10,22,14,2,3,9,12,35,-23,9,,,Boleyn Ground,London
2001/02,25,8,Ipswich Town,14,26,8,6,12,34,40,-6,30,14,5,2,7,18,20,-2,17,12,3,4,5,16,20,-4,13,Q,EU_UC,Portman Road,Ipswich
2001/02,25,20,Southampton,15,26,9,3,14,31,41,-10,30,12,5,1,6,14,16,-2,16,14,4,2,8,17,25,-8,14,,,St. Mary's Stadium,Southampton
2001/02,25,7,Everton,16,26,7,7,12,26,33,-7,28,14,6,2,6,18,17,1,20,12,1,5,6,8,16,-8,8,,,Goodison Park,Liverpool
2001/02,25,27,Bolton Wanderers,17,26,6,10,10,30,42,-12,28,13,3,5,5,10,21,-11,14,13,3,5,5,20,21,-1,14,,,Macron Stadium,Bolton
2001/02,25,3,Blackburn Rovers,18,26,6,7,13,32,36,-4,25,13,4,4,5,21,17,4,16,13,2,3,8,11,19,-8,9,"R,Q","EN_D1,EU_UC",Ewood Park,Blackburn
2001/02,25,28,Derby County,19,26,6,4,16,18,43,-25,22,14,5,3,6,13,15,-2,18,12,1,1,10,5,28,-23,4,R,EN_D1,Pride Park,Derby
2001/02,25,26,Leicester City,20,26,3,8,15,18,46,-28,17,12,1,5,6,8,23,-15,8,14,2,3,9,10,23,-13,9,R,EN_D1,Filbert Street,Leicester
2001/02,26,12,Manchester United,1,28,18,3,7,67,35,32,57,15,10,1,4,36,15,21,31,13,8,2,3,31,20,11,26,Q,EU_CL,Old Trafford,Manchester
2001/02,26,23,Newcastle United,2,27,17,4,6,52,33,19,55,13,9,1,3,25,15,10,28,14,8,3,3,27,18,9,27,Q,EU_CL,St. James' Park,Newcastle
2001/02,26,1,Arsenal,3,27,15,9,3,55,31,24,54,13,6,4,3,28,21,7,22,14,9,5,0,27,10,17,32,Q,EU_CL,Highbury,London
2001/02,26,10,Liverpool,4,28,15,8,5,45,25,20,53,13,6,5,2,16,11,5,23,15,9,3,3,29,14,15,30,Q,EU_CL,Anfield,Liverpool
2001/02,26,4,Chelsea,5,26,11,11,4,46,26,20,44,12,6,4,2,26,12,14,22,14,5,7,2,20,14,6,22,Q,EU_UC,Stamford Bridge,London
2001/02,26,9,Leeds United,6,27,11,11,5,37,29,8,44,13,5,6,2,20,15,5,21,14,6,5,3,17,14,3,23,Q,EU_UC,Elland Road,Leeds
2001/02,26,2,Aston Villa,7,27,9,11,7,32,30,2,38,14,6,6,2,16,11,5,24,13,3,5,5,16,19,-3,14,Q,EU_IT,Villa Park,Birmingham
2001/02,26,21,Tottenham Hotspur,8,26,10,5,11,37,35,2,35,14,7,3,4,26,20,6,24,12,3,2,7,11,15,-4,11,,,White Hart Lane,London
2001/02,26,34,Fulham,9,27,8,11,8,27,29,-2,35,14,6,6,2,18,11,7,24,13,2,5,6,9,18,-9,11,Q,EU_IT,Craven Cottage,London
2001/02,26,31,Charlton Athletic,10,27,8,10,9,30,32,-2,34,14,4,4,6,17,21,-4,16,13,4,6,3,13,11,2,18,,,The Valley,London
2001/02,26,25,West Ham United,11,27,9,7,11,30,42,-12,34,13,7,4,2,18,7,11,25,14,2,3,9,12,35,-23,9,,,Boleyn Ground,London
2001/02,26,13,Middlesbrough,12,27,8,7,12,26,35,-9,31,13,5,4,4,17,17,0,19,14,3,3,8,9,18,-9,12,,,Riverside Stadium,Middlesbrough
2001/02,26,20,Southampton,13,27,9,4,14,31,41,-10,31,13,5,2,6,14,16,-2,17,14,4,2,8,17,25,-8,14,,,St. Mary's Stadium,Southampton
2001/02,26,29,Sunderland,14,27,8,7,12,21,31,-10,31,14,5,5,4,13,12,1,20,13,3,2,8,8,19,-11,11,,,Stadium of Light,Sunderland
2001/02,26,8,Ipswich Town,15,26,8,6,12,34,40,-6,30,14,5,2,7,18,20,-2,17,12,3,4,5,16,20,-4,13,Q,EU_UC,Portman Road,Ipswich
2001/02,26,7,Everton,16,27,7,8,12,27,34,-7,29,14,6,2,6,18,17,1,20,13,1,6,6,9,17,-8,9,,,Goodison Park,Liverpool
2001/02,26,27,Bolton Wanderers,17,27,6,11,10,30,42,-12,29,13,3,5,5,10,21,-11,14,14,3,6,5,20,21,-1,15,,,Macron Stadium,Bolton
2001/02,26,3,Blackburn Rovers,18,26,6,7,13,32,36,-4,25,13,4,4,5,21,17,4,16,13,2,3,8,11,19,-8,9,"R,Q","EN_D1,EU_UC",Ewood Park,Blackburn
2001/02,26,28,Derby County,19,27,7,4,16,21,43,-22,25,14,5,3,6,13,15,-2,18,13,2,1,10,8,28,-20,7,R,EN_D1,Pride Park,Derby
2001/02,26,26,Leicester City,20,27,3,8,16,18,49,-31,17,13,1,5,7,8,26,-18,8,14,2,3,9,10,23,-13,9,R,EN_D1,Filbert Street,Leicester
2001/02,27,12,Manchester United,1,29,18,4,7,69,37,32,58,15,10,1,4,36,15,21,31,14,8,3,3,33,22,11,27,Q,EU_CL,Old Trafford,Manchester
2001/02,27,1,Arsenal,2,28,16,9,3,57,31,26,57,13,6,4,3,28,21,7,22,15,10,5,0,29,10,19,35,Q,EU_CL,Highbury,London
2001/02,27,10,Liverpool,3,29,16,8,5,47,25,22,56,13,6,5,2,16,11,5,23,16,10,3,3,31,14,17,33,Q,EU_CL,Anfield,Liverpool
2001/02,27,23,Newcastle United,4,28,17,4,7,52,35,17,55,14,9,1,4,25,17,8,28,14,8,3,3,27,18,9,27,Q,EU_CL,St. James' Park,Newcastle
2001/02,27,9,Leeds United,5,28,11,12,5,37,29,8,45,13,5,6,2,20,15,5,21,15,6,6,3,17,14,3,24,Q,EU_UC,Elland Road,Leeds
2001/02,27,4,Chelsea,6,27,11,11,5,47,28,19,44,12,6,4,2,26,12,14,22,15,5,7,3,21,16,5,22,Q,EU_UC,Stamford Bridge,London
2001/02,27,2,Aston Villa,7,28,10,11,7,34,31,3,41,15,7,6,2,18,12,6,27,13,3,5,5,16,19,-3,14,Q,EU_IT,Villa Park,Birmingham
2001/02,27,21,Tottenham Hotspur,8,27,11,5,11,39,36,3,38,15,8,3,4,28,21,7,27,12,3,2,7,11,15,-4,11,,,White Hart Lane,London
2001/02,27,31,Charlton Athletic,9,28,9,10,9,32,33,-1,37,15,5,4,6,19,22,-3,19,13,4,6,3,13,11,2,18,,,The Valley,London
2001/02,27,34,Fulham,10,28,8,11,9,27,31,-4,35,15,6,6,3,18,13,5,24,13,2,5,6,9,18,-9,11,Q,EU_IT,Craven Cottage,London
2001/02,27,20,Southampton,11,28,10,4,14,34,42,-8,34,13,5,2,6,14,16,-2,17,15,5,2,8,20,26,-6,17,,,St. Mary's Stadium,Southampton
2001/02,27,13,Middlesbrough,12,28,9,7,12,27,35,-8,34,14,6,4,4,18,17,1,22,14,3,3,8,9,18,-9,12,,,Riverside Stadium,Middlesbrough
2001/02,27,25,West Ham United,13,28,9,7,12,31,44,-13,34,13,7,4,2,18,7,11,25,15,2,3,10,13,37,-24,9,,,Boleyn Ground,London
2001/02,27,29,Sunderland,14,28,8,7,13,22,33,-11,31,14,5,5,4,13,12,1,20,14,3,2,9,9,21,-12,11,,,Stadium of Light,Sunderland
2001/02,27,7,Everton,15,28,7,9,12,27,34,-7,30,15,6,3,6,18,17,1,21,13,1,6,6,9,17,-8,9,,,Goodison Park,Liverpool
2001/02,27,8,Ipswich Town,16,27,8,6,13,35,43,-8,30,15,5,2,8,19,23,-4,17,12,3,4,5,16,20,-4,13,Q,EU_UC,Portman Road,Ipswich
2001/02,27,27,Bolton Wanderers,17,28,6,12,10,31,43,-12,30,14,3,6,5,11,22,-11,15,14,3,6,5,20,21,-1,15,,,Macron Stadium,Bolton
2001/02,27,3,Blackburn Rovers,18,27,6,8,13,33,37,-4,26,13,4,4,5,21,17,4,16,14,2,4,8,12,20,-8,10,"R,Q","EN_D1,EU_UC",Ewood Park,Blackburn
2001/02,27,28,Derby County,19,28,7,5,16,23,45,-22,26,15,5,4,6,15,17,-2,19,13,2,1,10,8,28,-20,7,R,EN_D1,Pride Park,Derby
2001/02,27,26,Leicester City,20,28,3,8,17,18,50,-32,17,13,1,5,7,8,26,-18,8,15,2,3,10,10,24,-14,9,R,EN_D1,Filbert Street,Leicester
2001/02,28,12,Manchester United,1,30,19,4,7,73,37,36,61,16,11,1,4,40,15,25,34,14,8,3,3,33,22,11,27,Q,EU_CL,Old Trafford,Manchester
2001/02,28,1,Arsenal,2,29,17,9,3,58,31,27,60,14,7,4,3,29,21,8,25,15,10,5,0,29,10,19,35,Q,EU_CL,Highbury,London
2001/02,28,10,Liverpool,3,30,17,8,5,50,25,25,59,14,7,5,2,19,11,8,26,16,10,3,3,31,14,17,33,Q,EU_CL,Anfield,Liverpool
2001/02,28,23,Newcastle United,4,29,17,4,8,52,38,14,55,14,9,1,4,25,17,8,28,15,8,3,4,27,21,6,27,Q,EU_CL,St. James' Park,Newcastle
2001/02,28,4,Chelsea,5,29,13,11,5,54,30,24,50,14,8,4,2,33,14,19,28,15,5,7,3,21,16,5,22,Q,EU_UC,Stamford Bridge,London
2001/02,28,9,Leeds United,6,29,12,12,5,39,29,10,48,14,6,6,2,22,15,7,24,15,6,6,3,17,14,3,24,Q,EU_UC,Elland Road,Leeds
2001/02,28,2,Aston Villa,7,29,10,11,8,34,34,0,41,15,7,6,2,18,12,6,27,14,3,5,6,16,22,-6,14,Q,EU_IT,Villa Park,Birmingham
2001/02,28,31,Charlton Athletic,8,29,9,11,9,33,34,-1,38,15,5,4,6,19,22,-3,19,14,4,7,3,14,12,2,19,,,The Valley,London
2001/02,28,21,Tottenham Hotspur,9,29,11,5,13,39,44,-5,38,15,8,3,4,28,21,7,27,14,3,2,9,11,23,-12,11,,,White Hart Lane,London
2001/02,28,25,West Ham United,10,29,10,7,12,32,44,-12,37,14,8,4,2,19,7,12,28,15,2,3,10,13,37,-24,9,,,Boleyn Ground,London
2001/02,28,34,Fulham,11,29,8,11,10,29,34,-5,35,15,6,6,3,18,13,5,24,14,2,5,7,11,21,-10,11,Q,EU_IT,Craven Cottage,London
2001/02,28,20,Southampton,12,29,10,5,14,35,43,-8,35,14,5,3,6,15,17,-2,18,15,5,2,8,20,26,-6,17,,,St. Mary's Stadium,Southampton
2001/02,28,13,Middlesbrough,13,29,9,8,12,28,36,-8,35,14,6,4,4,18,17,1,22,15,3,4,8,10,19,-9,13,,,Riverside Stadium,Middlesbrough
2001/02,28,29,Sunderland,14,29,9,7,13,23,33,-10,34,15,6,5,4,14,12,2,23,14,3,2,9,9,21,-12,11,,,Stadium of Light,Sunderland
2001/02,28,3,Blackburn Rovers,15,29,8,8,13,38,38,0,32,15,6,4,5,26,18,8,22,14,2,4,8,12,20,-8,10,Q,EU_UC,Ewood Park,Blackburn
2001/02,28,7,Everton,16,29,7,9,13,27,35,-8,30,15,6,3,6,18,17,1,21,14,1,6,7,9,18,-9,9,,,Goodison Park,Liverpool
2001/02,28,8,Ipswich Town,17,29,8,6,15,36,47,-11,30,15,5,2,8,19,23,-4,17,14,3,4,7,17,24,-7,13,Q,EU_UC,Portman Road,Ipswich
2001/02,28,27,Bolton Wanderers,18,29,6,12,11,31,44,-13,30,14,3,6,5,11,22,-11,15,15,3,6,6,20,22,-2,15,R,EN_D1,Macron Stadium,Bolton
2001/02,28,28,Derby County,19,29,7,5,17,23,46,-23,26,15,5,4,6,15,17,-2,19,14,2,1,11,8,29,-21,7,R,EN_D1,Pride Park,Derby
2001/02,28,26,Leicester City,20,29,3,9,17,19,51,-32,18,14,1,6,7,9,27,-18,9,15,2,3,10,10,24,-14,9,R,EN_D1,Filbert Street,Leicester
2001/02,29,12,Manchester United,1,31,20,4,7,78,40,38,64,16,11,1,4,40,15,25,34,15,9,3,3,38,25,13,30,Q,EU_CL,Old Trafford,Manchester
2001/02,29,1,Arsenal,2,30,18,9,3,60,32,28,63,14,7,4,3,29,21,8,25,16,11,5,0,31,11,20,38,Q,EU_CL,Highbury,London
2001/02,29,10,Liverpool,3,31,18,8,5,52,26,26,62,14,7,5,2,19,11,8,26,17,11,3,3,33,15,18,36,Q,EU_CL,Anfield,Liverpool
2001/02,29,23,Newcastle United,4,30,17,5,8,54,40,14,56,15,9,2,4,27,19,8,29,15,8,3,4,27,21,6,27,Q,EU_CL,St. James' Park,Newcastle
2001/02,29,4,Chelsea,5,30,14,11,5,58,30,28,53,15,9,4,2,37,14,23,31,15,5,7,3,21,16,5,22,Q,EU_UC,Stamford Bridge,London
2001/02,29,9,Leeds United,6,30,13,12,5,42,30,12,51,15,7,6,2,25,16,9,27,15,6,6,3,17,14,3,24,Q,EU_UC,Elland Road,Leeds
2001/02,29,31,Charlton Athletic,7,30,10,11,9,34,34,0,41,15,5,4,6,19,22,-3,19,15,5,7,3,15,12,3,22,,,The Valley,London
2001/02,29,2,Aston Villa,8,30,10,11,9,35,36,-1,41,16,7,6,3,19,14,5,27,14,3,5,6,16,22,-6,14,Q,EU_IT,Villa Park,Birmingham
2001/02,29,21,Tottenham Hotspur,9,30,11,5,14,39,45,-6,38,16,8,3,5,28,22,6,27,14,3,2,9,11,23,-12,11,,,White Hart Lane,London
2001/02,29,25,West Ham United,10,30,10,7,13,35,49,-14,37,15,8,4,3,22,12,10,28,15,2,3,10,13,37,-24,9,,,Boleyn Ground,London
2001/02,29,20,Southampton,11,30,10,6,14,37,45,-8,36,15,5,4,6,17,19,-2,19,15,5,2,8,20,26,-6,17,,,St. Mary's Stadium,Southampton
2001/02,29,34,Fulham,12,30,8,11,11,30,36,-6,35,15,6,6,3,18,13,5,24,15,2,5,8,12,23,-11,11,Q,EU_IT,Craven Cottage,London
2001/02,29,13,Middlesbrough,13,30,9,8,13,29,38,-9,35,15,6,4,5,19,19,0,22,15,3,4,8,10,19,-9,13,,,Riverside Stadium,Middlesbrough
2001/02,29,29,Sunderland,14,30,9,7,14,23,37,-14,34,15,6,5,4,14,12,2,23,15,3,2,10,9,25,-16,11,,,Stadium of Light,Sunderland
2001/02,29,7,Everton,15,30,8,9,13,29,36,-7,33,16,7,3,6,20,18,2,24,14,1,6,7,9,18,-9,9,,,Goodison Park,Liverpool
2001/02,29,3,Blackburn Rovers,16,30,8,8,14,39,41,-2,32,15,6,4,5,26,18,8,22,15,2,4,9,13,23,-10,10,Q,EU_UC,Ewood Park,Blackburn
2001/02,29,8,Ipswich Town,17,30,8,7,15,38,49,-11,31,15,5,2,8,19,23,-4,17,15,3,5,7,19,26,-7,14,Q,EU_UC,Portman Road,Ipswich
2001/02,29,27,Bolton Wanderers,18,30,6,12,12,32,47,-15,30,15,3,6,6,12,25,-13,15,15,3,6,6,20,22,-2,15,R,EN_D1,Macron Stadium,Bolton
2001/02,29,28,Derby County,19,30,8,5,17,26,47,-21,29,15,5,4,6,15,17,-2,19,15,3,1,11,11,30,-19,10,R,EN_D1,Pride Park,Derby
2001/02,29,26,Leicester City,20,30,3,10,17,21,53,-32,19,14,1,6,7,9,27,-18,9,16,2,4,10,12,26,-14,10,R,EN_D1,Filbert Street,Leicester
2001/02,30,10,Liverpool,1,32,19,8,5,53,26,27,65,15,8,5,2,20,11,9,29,17,11,3,3,33,15,18,36,Q,EU_CL,Anfield,Liverpool
2001/02,30,12,Manchester United,2,32,20,4,8,78,41,37,64,17,11,1,5,40,16,24,34,15,9,3,3,38,25,13,30,Q,EU_CL,Old Trafford,Manchester
2001/02,30,1,Arsenal,3,30,18,9,3,60,32,28,63,14,7,4,3,29,21,8,25,16,11,5,0,31,11,20,38,Q,EU_CL,Highbury,London
2001/02,30,23,Newcastle United,4,30,17,5,8,54,40,14,56,15,9,2,4,27,19,8,29,15,8,3,4,27,21,6,27,Q,EU_CL,St. James' Park,Newcastle
2001/02,30,9,Leeds United,5,31,14,12,5,44,30,14,54,15,7,6,2,25,16,9,27,16,7,6,3,19,14,5,27,Q,EU_UC,Elland Road,Leeds
2001/02,30,4,Chelsea,6,31,14,11,6,58,31,27,53,15,9,4,2,37,14,23,31,16,5,7,4,21,17,4,22,Q,EU_UC,Stamford Bridge,London
2001/02,30,2,Aston Villa,7,31,10,12,9,35,36,-1,42,16,7,6,3,19,14,5,27,15,3,6,6,16,22,-6,15,Q,EU_IT,Villa Park,Birmingham
2001/02,30,31,Charlton Athletic,8,31,10,11,10,35,36,-1,41,16,5,4,7,20,24,-4,19,15,5,7,3,15,12,3,22,,,The Valley,London
2001/02,30,21,Tottenham Hotspur,9,31,12,5,14,41,45,-4,41,16,8,3,5,28,22,6,27,15,4,2,9,13,23,-10,14,,,White Hart Lane,London
2001/02,30,13,Middlesbrough,10,31,10,8,13,30,38,-8,38,15,6,4,5,19,19,0,22,16,4,4,8,11,19,-8,16,,,Riverside Stadium,Middlesbrough
2001/02,30,20,Southampton,11,31,10,7,14,38,46,-8,37,15,5,4,6,17,19,-2,19,16,5,3,8,21,27,-6,18,,,St. Mary's Stadium,Southampton
2001/02,30,25,West Ham United,12,30,10,7,13,35,49,-14,37,15,8,4,3,22,12,10,28,15,2,3,10,13,37,-24,9,,,Boleyn Ground,London
2001/02,30,7,Everton,13,31,9,9,13,33,39,-6,36,16,7,3,6,20,18,2,24,15,2,6,7,13,21,-8,12,,,Goodison Park,Liverpool
2001/02,30,34,Fulham,14,31,8,11,12,30,38,-8,35,16,6,6,4,18,15,3,24,15,2,5,8,12,23,-11,11,Q,EU_IT,Craven Cottage,London
2001/02,30,29,Sunderland,15,31,9,8,14,24,38,-14,35,16,6,6,4,15,13,2,24,15,3,2,10,9,25,-16,11,,,Stadium of Light,Sunderland
2001/02,30,27,Bolton Wanderers,16,31,7,12,12,34,48,-14,33,15,3,6,6,12,25,-13,15,16,4,6,6,22,23,-1,18,,,Macron Stadium,Bolton
2001/02,30,3,Blackburn Rovers,17,30,8,8,14,39,41,-2,32,15,6,4,5,26,18,8,22,15,2,4,9,13,23,-10,10,Q,EU_UC,Ewood Park,Blackburn
2001/02,30,8,Ipswich Town,18,31,8,8,15,38,49,-11,32,16,5,3,8,19,23,-4,18,15,3,5,7,19,26,-7,14,"R,Q","EN_D1,EU_UC",Portman Road,Ipswich
2001/02,30,28,Derby County,19,31,8,5,18,29,51,-22,29,16,5,4,7,18,21,-3,19,15,3,1,11,11,30,-19,10,R,EN_D1,Pride Park,Derby
2001/02,30,26,Leicester City,20,31,3,10,18,21,55,-34,19,15,1,6,8,9,29,-20,9,16,2,4,10,12,26,-14,10,R,EN_D1,Filbert Street,Leicester
2001/02,31,10,Liverpool,1,33,20,8,5,55,26,29,68,16,9,5,2,22,11,11,32,17,11,3,3,33,15,18,36,Q,EU_CL,Anfield,Liverpool
2001/02,31,12,Manchester United,2,33,21,4,8,82,44,38,67,17,11,1,5,40,16,24,34,16,10,3,3,42,28,14,33,Q,EU_CL,Old Trafford,Manchester
2001/02,31,1,Arsenal,3,31,19,9,3,63,32,31,66,15,8,4,3,32,21,11,28,16,11,5,0,31,11,20,38,Q,EU_CL,Highbury,London
2001/02,31,23,Newcastle United,4,31,18,5,8,60,42,18,59,16,10,2,4,33,21,12,32,15,8,3,4,27,21,6,27,Q,EU_CL,St. James' Park,Newcastle
2001/02,31,4,Chelsea,5,32,15,11,6,60,32,28,56,16,10,4,2,39,15,24,34,16,5,7,4,21,17,4,22,Q,EU_UC,Stamford Bridge,London
2001/02,31,9,Leeds United,6,32,14,12,6,47,34,13,54,16,7,6,3,28,20,8,27,16,7,6,3,19,14,5,27,Q,EU_UC,Elland Road,Leeds
2001/02,31,2,Aston Villa,7,32,10,12,10,37,39,-2,42,16,7,6,3,19,14,5,27,16,3,6,7,18,25,-7,15,Q,EU_IT,Villa Park,Birmingham
2001/02,31,21,Tottenham Hotspur,8,32,12,6,14,42,46,-4,42,16,8,3,5,28,22,6,27,16,4,3,9,14,24,-10,15,,,White Hart Lane,London
2001/02,31,31,Charlton Athletic,9,32,10,11,11,35,38,-3,41,16,5,4,7,20,24,-4,19,16,5,7,4,15,14,1,22,,,The Valley,London
2001/02,31,25,West Ham United,10,31,11,7,13,38,50,-12,40,16,9,4,3,25,13,12,31,15,2,3,10,13,37,-24,9,,,Boleyn Ground,London
2001/02,31,13,Middlesbrough,11,32,10,9,13,31,39,-8,39,16,6,5,5,20,20,0,23,16,4,4,8,11,19,-8,16,,,Riverside Stadium,Middlesbrough
2001/02,31,20,Southampton,12,32,10,8,14,39,47,-8,38,16,5,5,6,18,20,-2,20,16,5,3,8,21,27,-6,18,,,St. Mary's Stadium,Southampton
2001/02,31,34,Fulham,13,32,8,12,12,31,39,-8,36,16,6,6,4,18,15,3,24,16,2,6,8,13,24,-11,12,Q,EU_IT,Craven Cottage,London
2001/02,31,7,Everton,14,32,9,9,14,35,45,-10,36,16,7,3,6,20,18,2,24,16,2,6,8,15,27,-12,12,,,Goodison Park,Liverpool
2001/02,31,27,Bolton Wanderers,15,32,8,12,12,37,50,-13,36,16,4,6,6,15,27,-12,18,16,4,6,6,22,23,-1,18,,,Macron Stadium,Bolton
2001/02,31,29,Sunderland,16,32,9,8,15,24,41,-17,35,16,6,6,4,15,13,2,24,16,3,2,11,9,28,-19,11,,,Stadium of Light,Sunderland
2001/02,31,3,Blackburn Rovers,17,31,8,8,15,40,43,-3,32,15,6,4,5,26,18,8,22,16,2,4,10,14,25,-11,10,Q,EU_UC,Ewood Park,Blackburn
2001/02,31,8,Ipswich Town,18,32,8,8,16,39,52,-13,32,16,5,3,8,19,23,-4,18,16,3,5,8,20,29,-9,14,"R,Q","EN_D1,EU_UC",Portman Road,Ipswich
2001/02,31,28,Derby County,19,32,8,5,19,30,53,-23,29,16,5,4,7,18,21,-3,19,16,3,1,12,12,32,-20,10,R,EN_D1,Pride Park,Derby
2001/02,31,26,Leicester City,20,32,4,10,18,23,56,-33,22,16,2,6,8,11,30,-19,12,16,2,4,10,12,26,-14,10,R,EN_D1,Filbert Street,Leicester
2001/02,32,1,Arsenal,1,32,20,9,3,66,32,34,69,15,8,4,3,32,21,11,28,17,12,5,0,34,11,23,41,Q,EU_CL,Highbury,London
2001/02,32,10,Liverpool,2,33,20,8,5,55,26,29,68,16,9,5,2,22,11,11,32,17,11,3,3,33,15,18,36,Q,EU_CL,Anfield,Liverpool
2001/02,32,12,Manchester United,3,33,21,4,8,82,44,38,67,17,11,1,5,40,16,24,34,16,10,3,3,42,28,14,33,Q,EU_CL,Old Trafford,Manchester
2001/02,32,23,Newcastle United,4,32,18,6,8,61,43,18,60,16,10,2,4,33,21,12,32,16,8,4,4,28,22,6,28,Q,EU_CL,St. James' Park,Newcastle
2001/02,32,4,Chelsea,5,33,15,12,6,60,32,28,57,16,10,4,2,39,15,24,34,17,5,8,4,21,17,4,23,Q,EU_UC,Stamford Bridge,London
2001/02,32,9,Leeds United,6,33,14,12,7,48,36,12,54,16,7,6,3,28,20,8,27,17,7,6,4,20,16,4,27,Q,EU_UC,Elland Road,Leeds
2001/02,32,21,Tottenham Hotspur,7,33,13,6,14,44,47,-3,45,17,9,3,5,30,23,7,30,16,4,3,9,14,24,-10,15,,,White Hart Lane,London
2001/02,32,2,Aston Villa,8,33,10,13,10,38,40,-2,43,17,7,7,3,20,15,5,28,16,3,6,7,18,25,-7,15,Q,EU_IT,Villa Park,Birmingham
2001/02,32,25,West Ham United,9,32,12,7,13,39,50,-11,43,16,9,4,3,25,13,12,31,16,3,3,10,14,37,-23,12,,,Boleyn Ground,London
2001/02,32,13,Middlesbrough,10,33,11,9,13,32,39,-7,42,16,6,5,5,20,20,0,23,17,5,4,8,12,19,-7,19,,,Riverside Stadium,Middlesbrough
2001/02,32,31,Charlton Athletic,11,33,10,11,12,35,41,-6,41,17,5,4,8,20,27,-7,19,16,5,7,4,15,14,1,22,,,The Valley,London
2001/02,32,7,Everton,12,33,10,9,14,38,46,-8,39,17,8,3,6,23,19,4,27,16,2,6,8,15,27,-12,12,,,Goodison Park,Liverpool
2001/02,32,20,Southampton,13,33,10,8,15,39,49,-10,38,16,5,5,6,18,20,-2,20,17,5,3,9,21,29,-8,18,,,St. Mary's Stadium,Southampton
2001/02,32,29,Sunderland,14,33,10,8,15,26,42,-16,38,17,7,6,4,17,14,3,27,16,3,2,11,9,28,-19,11,,,Stadium of Light,Sunderland
2001/02,32,34,Fulham,15,33,8,12,13,31,40,-9,36,17,6,6,5,18,16,2,24,16,2,6,8,13,24,-11,12,Q,EU_IT,Craven Cottage,London
2001/02,32,27,Bolton Wanderers,16,33,8,12,13,38,53,-15,36,16,4,6,6,15,27,-12,18,17,4,6,7,23,26,-3,18,,,Macron Stadium,Bolton
2001/02,32,3,Blackburn Rovers,17,32,9,8,15,42,43,-1,35,16,7,4,5,28,18,10,25,16,2,4,10,14,25,-11,10,Q,EU_UC,Ewood Park,Blackburn
2001/02,32,8,Ipswich Town,18,33,8,9,16,39,52,-13,33,17,5,4,8,19,23,-4,19,16,3,5,8,20,29,-9,14,"R,Q","EN_D1,EU_UC",Portman Road,Ipswich
2001/02,32,28,Derby County,19,33,8,5,20,30,54,-24,29,17,5,4,8,18,22,-4,19,16,3,1,12,12,32,-20,10,R,EN_D1,Pride Park,Derby
2001/02,32,26,Leicester City,20,33,4,10,19,24,58,-34,22,16,2,6,8,11,30,-19,12,17,2,4,11,13,28,-15,10,R,EN_D1,Filbert Street,Leicester
2001/02,33,1,Arsenal,1,33,21,9,3,68,33,35,72,16,9,4,3,34,22,12,31,17,12,5,0,34,11,23,41,Q,EU_CL,Highbury,London
2001/02,33,12,Manchester United,2,34,22,4,8,83,44,39,70,17,11,1,5,40,16,24,34,17,11,3,3,43,28,15,36,Q,EU_CL,Old Trafford,Manchester
2001/02,33,10,Liverpool,3,33,20,8,5,55,26,29,68,16,9,5,2,22,11,11,32,17,11,3,3,33,15,18,36,Q,EU_CL,Anfield,Liverpool
2001/02,33,4,Chelsea,4,35,16,13,6,63,32,31,61,17,11,4,2,42,15,27,37,18,5,9,4,21,17,4,24,Q,EU_CL,Stamford Bridge,London
2001/02,33,23,Newcastle United,5,33,18,7,8,62,44,18,61,17,10,3,4,34,22,12,33,16,8,4,4,28,22,6,28,Q,EU_UC,St. James' Park,Newcastle
2001/02,33,9,Leeds United,6,34,15,12,7,50,36,14,57,17,8,6,3,30,20,10,30,17,7,6,4,20,16,4,27,Q,EU_UC,Elland Road,Leeds
2001/02,33,25,West Ham United,7,33,13,7,13,41,50,-9,46,17,10,4,3,27,13,14,34,16,3,3,10,14,37,-23,12,,,Boleyn Ground,London
2001/02,33,21,Tottenham Hotspur,8,34,13,6,15,45,49,-4,45,17,9,3,5,30,23,7,30,17,4,3,10,15,26,-11,15,,,White Hart Lane,London
2001/02,33,13,Middlesbrough,9,34,12,9,13,34,40,-6,45,17,7,5,5,22,21,1,26,17,5,4,8,12,19,-7,19,,,Riverside Stadium,Middlesbrough
2001/02,33,2,Aston Villa,10,34,10,13,11,39,42,-3,43,17,7,7,3,20,15,5,28,17,3,6,8,19,27,-8,15,Q,EU_IT,Villa Park,Birmingham
2001/02,33,20,Southampton,11,34,11,8,15,41,49,-8,41,17,6,5,6,20,20,0,23,17,5,3,9,21,29,-8,18,,,St. Mary's Stadium,Southampton
2001/02,33,31,Charlton Athletic,12,34,10,11,13,35,43,-8,41,17,5,4,8,20,27,-7,19,17,5,7,5,15,16,-1,22,,,The Valley,London
2001/02,33,7,Everton,13,34,10,9,15,38,49,-11,39,17,8,3,6,23,19,4,27,17,2,6,9,15,30,-15,12,,,Goodison Park,Liverpool
2001/02,33,27,Bolton Wanderers,14,34,9,12,13,42,54,-12,39,17,5,6,6,19,28,-9,21,17,4,6,7,23,26,-3,18,,,Macron Stadium,Bolton
2001/02,33,29,Sunderland,15,34,10,8,16,26,44,-18,38,17,7,6,4,17,14,3,27,17,3,2,12,9,30,-21,11,,,Stadium of Light,Sunderland
2001/02,33,34,Fulham,16,34,8,13,13,32,41,-9,37,17,6,6,5,18,16,2,24,17,2,7,8,14,25,-11,13,Q,EU_IT,Craven Cottage,London
2001/02,33,3,Blackburn Rovers,17,33,9,9,15,42,43,-1,36,17,7,5,5,28,18,10,26,16,2,4,10,14,25,-11,10,Q,EU_UC,Ewood Park,Blackburn
2001/02,33,8,Ipswich Town,18,34,8,9,17,40,56,-16,33,17,5,4,8,19,23,-4,19,17,3,5,9,21,33,-12,14,"R,Q","EN_D1,EU_UC",Portman Road,Ipswich
2001/02,33,28,Derby County,19,34,8,5,21,30,56,-26,29,17,5,4,8,18,22,-4,19,17,3,1,13,12,34,-22,10,R,EN_D1,Pride Park,Derby
2001/02,33,26,Leicester City,20,34,4,10,20,24,59,-35,22,17,2,6,9,11,31,-20,12,17,2,4,11,13,28,-15,10,R,EN_D1,Filbert Street,Leicester
2001/02,34,1,Arsenal,1,33,21,9,3,68,33,35,72,16,9,4,3,34,22,12,31,17,12,5,0,34,11,23,41,Q,EU_CL,Highbury,London
2001/02,34,10,Liverpool,2,34,21,8,5,56,26,30,71,16,9,5,2,22,11,11,32,18,12,3,3,34,15,19,39,Q,EU_CL,Anfield,Liverpool
2001/02,34,12,Manchester United,3,34,22,4,8,83,44,39,70,17,11,1,5,40,16,24,34,17,11,3,3,43,28,15,36,Q,EU_CL,Old Trafford,Manchester
2001/02,34,23,Newcastle United,4,34,19,7,8,65,46,19,64,17,10,3,4,34,22,12,33,17,9,4,4,31,24,7,31,Q,EU_CL,St. James' Park,Newcastle
2001/02,34,4,Chelsea,5,35,16,13,6,63,32,31,61,17,11,4,2,42,15,27,37,18,5,9,4,21,17,4,24,Q,EU_UC,Stamford Bridge,London
2001/02,34,9,Leeds United,6,35,16,12,7,51,36,15,60,17,8,6,3,30,20,10,30,18,8,6,4,21,16,5,30,Q,EU_UC,Elland Road,Leeds
2001/02,34,25,West Ham United,7,34,13,8,13,42,51,-9,47,17,10,4,3,27,13,14,34,17,3,4,10,15,38,-23,13,,,Boleyn Ground,London
2001/02,34,21,Tottenham Hotspur,8,35,13,7,15,46,50,-4,46,18,9,4,5,31,24,7,31,17,4,3,10,15,26,-11,15,,,White Hart Lane,London
2001/02,34,13,Middlesbrough,9,34,12,9,13,34,40,-6,45,17,7,5,5,22,21,1,26,17,5,4,8,12,19,-7,19,,,Riverside Stadium,Middlesbrough
2001/02,34,2,Aston Villa,10,35,10,13,12,39,43,-4,43,18,7,7,4,20,16,4,28,17,3,6,8,19,27,-8,15,Q,EU_IT,Villa Park,Birmingham
2001/02,34,20,Southampton,11,35,11,9,15,42,50,-8,42,17,6,5,6,20,20,0,23,18,5,4,9,22,30,-8,19,,,St. Mary's Stadium,Southampton
2001/02,34,31,Charlton Athletic,12,35,10,12,13,36,44,-8,42,18,5,5,8,21,28,-7,20,17,5,7,5,15,16,-1,22,,,The Valley,London
2001/02,34,7,Everton,13,35,10,10,15,40,51,-11,40,18,8,4,6,25,21,4,28,17,2,6,9,15,30,-15,12,,,Goodison Park,Liverpool
2001/02,34,27,Bolton Wanderers,14,34,9,12,13,42,54,-12,39,17,5,6,6,19,28,-9,21,17,4,6,7,23,26,-3,18,,,Macron Stadium,Bolton
2001/02,34,29,Sunderland,15,35,10,8,17,26,45,-19,38,18,7,6,5,17,15,2,27,17,3,2,12,9,30,-21,11,,,Stadium of Light,Sunderland
2001/02,34,34,Fulham,16,34,8,13,13,32,41,-9,37,17,6,6,5,18,16,2,24,17,2,7,8,14,25,-11,13,Q,EU_IT,Craven Cottage,London
2001/02,34,3,Blackburn Rovers,17,33,9,9,15,42,43,-1,36,17,7,5,5,28,18,10,26,16,2,4,10,14,25,-11,10,Q,EU_UC,Ewood Park,Blackburn
2001/02,34,8,Ipswich Town,18,34,8,9,17,40,56,-16,33,17,5,4,8,19,23,-4,19,17,3,5,9,21,33,-12,14,"R,Q","EN_D1,EU_UC",Portman Road,Ipswich
2001/02,34,28,Derby County,19,35,8,5,22,32,59,-27,29,18,5,4,9,20,25,-5,19,17,3,1,13,12,34,-22,10,R,EN_D1,Pride Park,Derby
2001/02,34,26,Leicester City,20,35,4,11,20,26,61,-35,23,17,2,6,9,11,31,-20,12,18,2,5,11,15,30,-15,11,R,EN_D1,Filbert Street,Leicester
2001/02,35,1,Arsenal,1,34,22,9,3,70,33,37,75,17,10,4,3,36,22,14,34,17,12,5,0,34,11,23,41,Q,EU_CL,Highbury,London
2001/02,35,10,Liverpool,2,35,22,8,5,58,26,32,74,17,10,5,2,24,11,13,35,18,12,3,3,34,15,19,39,Q,EU_CL,Anfield,Liverpool
2001/02,35,12,Manchester United,3,35,23,4,8,86,44,42,73,17,11,1,5,40,16,24,34,18,12,3,3,46,28,18,39,Q,EU_CL,Old Trafford,Manchester
2001/02,35,23,Newcastle United,4,35,20,7,8,68,46,22,67,18,11,3,4,37,22,15,36,17,9,4,4,31,24,7,31,Q,EU_CL,St. James' Park,Newcastle
2001/02,35,4,Chelsea,5,36,16,13,7,63,35,28,61,18,11,4,3,42,18,24,37,18,5,9,4,21,17,4,24,Q,EU_UC,Stamford Bridge,London
2001/02,35,9,Leeds United,6,36,16,12,8,51,37,14,60,18,8,6,4,30,21,9,30,18,8,6,4,21,16,5,30,Q,EU_UC,Elland Road,Leeds
2001/02,35,25,West Ham United,7,35,14,8,13,45,51,-6,50,18,11,4,3,30,13,17,37,17,3,4,10,15,38,-23,13,,,Boleyn Ground,London
2001/02,35,21,Tottenham Hotspur,8,36,13,8,15,47,51,-4,47,18,9,4,5,31,24,7,31,18,4,4,10,16,27,-11,16,,,White Hart Lane,London
2001/02,35,13,Middlesbrough,9,35,12,9,14,35,43,-8,45,18,7,5,6,23,24,-1,26,17,5,4,8,12,19,-7,19,,,Riverside Stadium,Middlesbrough
2001/02,35,2,Aston Villa,10,36,10,14,12,41,45,-4,44,18,7,7,4,20,16,4,28,18,3,7,8,21,29,-8,16,Q,EU_IT,Villa Park,Birmingham
2001/02,35,7,Everton,11,36,11,10,15,41,51,-10,43,18,8,4,6,25,21,4,28,18,3,6,9,16,30,-14,15,,,Goodison Park,Liverpool
2001/02,35,20,Southampton,12,36,11,9,16,42,51,-9,42,18,6,5,7,20,21,-1,23,18,5,4,9,22,30,-8,19,,,St. Mary's Stadium,Southampton
2001/02,35,31,Charlton Athletic,13,36,10,12,14,36,47,-11,42,18,5,5,8,21,28,-7,20,18,5,7,6,15,19,-4,22,,,The Valley,London
2001/02,35,34,Fulham,14,35,9,13,13,33,41,-8,40,17,6,6,5,18,16,2,24,18,3,7,8,15,25,-10,16,Q,EU_IT,Craven Cottage,London
2001/02,35,27,Bolton Wanderers,15,35,9,13,13,43,55,-12,40,18,5,7,6,20,29,-9,22,17,4,6,7,23,26,-3,18,,,Macron Stadium,Bolton
2001/02,35,3,Blackburn Rovers,16,34,10,9,15,45,44,1,39,17,7,5,5,28,18,10,26,17,3,4,10,17,26,-9,13,Q,EU_UC,Ewood Park,Blackburn
2001/02,35,29,Sunderland,17,36,10,8,18,26,48,-22,38,18,7,6,5,17,15,2,27,18,3,2,13,9,33,-24,11,,,Stadium of Light,Sunderland
2001/02,35,8,Ipswich Town,18,35,8,9,18,40,58,-18,33,17,5,4,8,19,23,-4,19,18,3,5,10,21,35,-14,14,"R,Q","EN_D1,EU_UC",Portman Road,Ipswich
2001/02,35,28,Derby County,19,36,8,5,23,32,61,-29,29,18,5,4,9,20,25,-5,19,18,3,1,14,12,36,-24,10,R,EN_D1,Pride Park,Derby
2001/02,35,26,Leicester City,20,36,4,12,20,28,63,-35,24,18,2,7,9,13,33,-20,13,18,2,5,11,15,30,-15,11,R,EN_D1,Filbert Street,Leicester
2001/02,36,1,Arsenal,1,35,23,9,3,72,33,39,78,18,11,4,3,38,22,16,37,17,12,5,0,34,11,23,41,Q,EU_CL,Highbury,London
2001/02,36,10,Liverpool,2,35,22,8,5,58,26,32,74,17,10,5,2,24,11,13,35,18,12,3,3,34,15,19,39,Q,EU_CL,Anfield,Liverpool
2001/02,36,12,Manchester United,3,35,23,4,8,86,44,42,73,17,11,1,5,40,16,24,34,18,12,3,3,46,28,18,39,Q,EU_CL,Old Trafford,Manchester
2001/02,36,23,Newcastle United,4,36,20,8,8,70,48,22,68,18,11,3,4,37,22,15,36,18,9,5,4,33,26,7,32,Q,EU_CL,St. James' Park,Newcastle
2001/02,36,4,Chelsea,5,36,16,13,7,63,35,28,61,18,11,4,3,42,18,24,37,18,5,9,4,21,17,4,24,Q,EU_UC,Stamford Bridge,London
2001/02,36,9,Leeds United,6,36,16,12,8,51,37,14,60,18,8,6,4,30,21,9,30,18,8,6,4,21,16,5,30,Q,EU_UC,Elland Road,Leeds
2001/02,36,25,West Ham United,7,36,14,8,14,45,53,-8,50,18,11,4,3,30,13,17,37,18,3,4,11,15,40,-25,13,,,Boleyn Ground,London
2001/02,36,21,Tottenham Hotspur,8,36,13,8,15,47,51,-4,47,18,9,4,5,31,24,7,31,18,4,4,10,16,27,-11,16,,,White Hart Lane,London
2001/02,36,13,Middlesbrough,9,36,12,9,15,35,44,-9,45,18,7,5,6,23,24,-1,26,18,5,4,9,12,20,-8,19,,,Riverside Stadium,Middlesbrough
2001/02,36,2,Aston Villa,10,36,10,14,12,41,45,-4,44,18,7,7,4,20,16,4,28,18,3,7,8,21,29,-8,16,Q,EU_IT,Villa Park,Birmingham
2001/02,36,34,Fulham,11,36,10,13,13,36,41,-5,43,18,7,6,5,21,16,5,27,18,3,7,8,15,25,-10,16,Q,EU_IT,Craven Cottage,London
2001/02,36,7,Everton,12,36,11,10,15,41,51,-10,43,18,8,4,6,25,21,4,28,18,3,6,9,16,30,-14,15,,,Goodison Park,Liverpool
2001/02,36,20,Southampton,13,36,11,9,16,42,51,-9,42,18,6,5,7,20,21,-1,23,18,5,4,9,22,30,-8,19,,,St. Mary's Stadium,Southampton
2001/02,36,31,Charlton Athletic,14,36,10,12,14,36,47,-11,42,18,5,5,8,21,28,-7,20,18,5,7,6,15,19,-4,22,,,The Valley,London
2001/02,36,3,Blackburn Rovers,15,35,10,10,15,47,46,1,40,18,7,6,5,30,20,10,27,17,3,4,10,17,26,-9,13,Q,EU_UC,Ewood Park,Blackburn
2001/02,36,27,Bolton Wanderers,16,36,9,13,14,43,58,-15,40,18,5,7,6,20,29,-9,22,18,4,6,8,23,29,-6,18,,,Macron Stadium,Bolton
2001/02,36,29,Sunderland,17,36,10,8,18,26,48,-22,38,18,7,6,5,17,15,2,27,18,3,2,13,9,33,-24,11,,,Stadium of Light,Sunderland
2001/02,36,8,Ipswich Town,18,36,9,9,18,41,58,-17,36,18,6,4,8,20,23,-3,22,18,3,5,10,21,35,-14,14,"R,Q","EN_D1,EU_UC",Portman Road,Ipswich
2001/02,36,28,Derby County,19,36,8,5,23,32,61,-29,29,18,5,4,9,20,25,-5,19,18,3,1,14,12,36,-24,10,R,EN_D1,Pride Park,Derby
2001/02,36,26,Leicester City,20,36,4,12,20,28,63,-35,24,18,2,7,9,13,33,-20,13,18,2,5,11,15,30,-15,11,R,EN_D1,Filbert Street,Leicester
2001/02,37,1,Arsenal,1,37,25,9,3,75,33,42,84,18,11,4,3,38,22,16,37,19,14,5,0,37,11,26,47,Q,EU_CL,Highbury,London
2001/02,37,10,Liverpool,2,37,23,8,6,62,30,32,77,18,11,5,2,28,14,14,38,19,12,3,4,34,16,18,39,Q,EU_CL,Anfield,Liverpool
2001/02,37,12,Manchester United,3,37,24,4,9,87,45,42,76,18,11,1,6,40,17,23,34,19,13,3,3,47,28,19,42,Q,EU_CL,Old Trafford,Manchester
2001/02,37,23,Newcastle United,4,37,21,8,8,73,49,24,71,19,12,3,4,40,23,17,39,18,9,5,4,33,26,7,32,Q,EU_CL,St. James' Park,Newcastle
2001/02,37,4,Chelsea,5,37,17,13,7,65,35,30,64,18,11,4,3,42,18,24,37,19,6,9,4,23,17,6,27,Q,EU_UC,Stamford Bridge,London
2001/02,37,9,Leeds United,6,37,17,12,8,52,37,15,63,18,8,6,4,30,21,9,30,19,9,6,4,22,16,6,33,Q,EU_UC,Elland Road,Leeds
2001/02,37,21,Tottenham Hotspur,7,37,14,8,15,48,51,-3,50,19,10,4,5,32,24,8,34,18,4,4,10,16,27,-11,16,,,White Hart Lane,London
2001/02,37,25,West Ham United,8,37,14,8,15,46,56,-10,50,18,11,4,3,30,13,17,37,19,3,4,12,16,43,-27,13,,,Boleyn Ground,London
2001/02,37,2,Aston Villa,9,37,11,14,12,43,46,-3,47,19,8,7,4,22,17,5,31,18,3,7,8,21,29,-8,16,Q,EU_IT,Villa Park,Birmingham
2001/02,37,13,Middlesbrough,10,37,12,9,16,35,46,-11,45,19,7,5,7,23,26,-3,26,18,5,4,9,12,20,-8,19,,,Riverside Stadium,Middlesbrough
2001/02,37,34,Fulham,11,37,10,14,13,36,41,-5,44,19,7,7,5,21,16,5,28,18,3,7,8,15,25,-10,16,Q,EU_IT,Craven Cottage,London
2001/02,37,3,Blackburn Rovers,12,37,11,10,16,52,51,1,43,18,7,6,5,30,20,10,27,19,4,4,11,22,31,-9,16,Q,EU_UC,Ewood Park,Blackburn
2001/02,37,7,Everton,13,37,11,10,16,42,53,-11,43,19,8,4,7,26,23,3,28,18,3,6,9,16,30,-14,15,,,Goodison Park,Liverpool
2001/02,37,31,Charlton Athletic,14,37,10,13,14,38,49,-11,43,19,5,6,8,23,30,-7,21,18,5,7,6,15,19,-4,22,,,The Valley,London
2001/02,37,20,Southampton,15,37,11,9,17,43,53,-10,42,18,6,5,7,20,21,-1,23,19,5,4,10,23,32,-9,19,,,St. Mary's Stadium,Southampton
2001/02,37,27,Bolton Wanderers,16,37,9,13,15,43,60,-17,40,19,5,7,7,20,31,-11,22,18,4,6,8,23,29,-6,18,,,Macron Stadium,Bolton
2001/02,37,29,Sunderland,17,37,10,9,18,28,50,-22,39,18,7,6,5,17,15,2,27,19,3,3,13,11,35,-24,12,,,Stadium of Light,Sunderland
2001/02,37,8,Ipswich Town,18,37,9,9,19,41,59,-18,36,19,6,4,9,20,24,-4,22,18,3,5,10,21,35,-14,14,"R,Q","EN_D1,EU_UC",Portman Road,Ipswich
2001/02,37,28,Derby County,19,37,8,5,24,32,62,-30,29,19,5,4,10,20,26,-6,19,18,3,1,14,12,36,-24,10,R,EN_D1,Pride Park,Derby
2001/02,37,26,Leicester City,20,37,4,13,20,28,63,-35,25,18,2,7,9,13,33,-20,13,19,2,6,11,15,30,-15,12,R,EN_D1,Filbert Street,Leicester
2001/02,38,1,Arsenal,1,38,26,9,3,79,36,43,87,19,12,4,3,42,25,17,40,19,14,5,0,37,11,26,47,Q,EU_CL,Highbury,London
2001/02,38,10,Liverpool,2,38,24,8,6,67,30,37,80,19,12,5,2,33,14,19,41,19,12,3,4,34,16,18,39,Q,EU_CL,Anfield,Liverpool
2001/02,38,12,Manchester United,3,38,24,5,9,87,45,42,77,19,11,2,6,40,17,23,35,19,13,3,3,47,28,19,42,Q,EU_CL,Old Trafford,Manchester
2001/02,38,23,Newcastle United,4,38,21,8,9,74,52,22,71,19,12,3,4,40,23,17,39,19,9,5,5,34,29,5,32,Q,EU_CL,St. James' Park,Newcastle
2001/02,38,9,Leeds United,5,38,18,12,8,53,37,16,66,19,9,6,4,31,21,10,33,19,9,6,4,22,16,6,33,Q,EU_UC,Elland Road,Leeds
2001/02,38,4,Chelsea,6,38,17,13,8,66,38,28,64,19,11,4,4,43,21,22,37,19,6,9,4,23,17,6,27,Q,EU_UC,Stamford Bridge,London
2001/02,38,25,West Ham United,7,38,15,8,15,48,57,-9,53,19,12,4,3,32,14,18,40,19,3,4,12,16,43,-27,13,,,Boleyn Ground,London
2001/02,38,2,Aston Villa,8,38,12,14,12,46,47,-1,50,19,8,7,4,22,17,5,31,19,4,7,8,24,30,-6,19,Q,EU_IT,Villa Park,Birmingham
2001/02,38,21,Tottenham Hotspur,9,38,14,8,16,49,53,-4,50,19,10,4,5,32,24,8,34,19,4,4,11,17,29,-12,16,,,White Hart Lane,London
2001/02,38,3,Blackburn Rovers,10,38,12,10,16,55,51,4,46,19,8,6,5,33,20,13,30,19,4,4,11,22,31,-9,16,Q,EU_UC,Ewood Park,Blackburn
2001/02,38,20,Southampton,11,38,12,9,17,46,54,-8,45,19,7,5,7,23,22,1,26,19,5,4,10,23,32,-9,19,,,St. Mary's Stadium,Southampton
2001/02,38,13,Middlesbrough,12,38,12,9,17,35,47,-12,45,19,7,5,7,23,26,-3,26,19,5,4,10,12,21,-9,19,,,Riverside Stadium,Middlesbrough
2001/02,38,34,Fulham,13,38,10,14,14,36,44,-8,44,19,7,7,5,21,16,5,28,19,3,7,9,15,28,-13,16,Q,EU_IT,Craven Cottage,London
2001/02,38,31,Charlton Athletic,14,38,10,14,14,38,49,-11,44,19,5,6,8,23,30,-7,21,19,5,8,6,15,19,-4,23,,,The Valley,London
2001/02,38,7,Everton,15,38,11,10,17,45,57,-12,43,19,8,4,7,26,23,3,28,19,3,6,10,19,34,-15,15,,,Goodison Park,Liverpool
2001/02,38,27,Bolton Wanderers,16,38,9,13,16,44,62,-18,40,19,5,7,7,20,31,-11,22,19,4,6,9,24,31,-7,18,,,Macron Stadium,Bolton
2001/02,38,29,Sunderland,17,38,10,10,18,29,51,-22,40,19,7,7,5,18,16,2,28,19,3,3,13,11,35,-24,12,,,Stadium of Light,Sunderland
2001/02,38,8,Ipswich Town,18,38,9,9,20,41,64,-23,36,19,6,4,9,20,24,-4,22,19,3,5,11,21,40,-19,14,"R,Q","EN_D1,EU_UC",Portman Road,Ipswich
2001/02,38,28,Derby County,19,38,8,6,24,33,63,-30,30,19,5,4,10,20,26,-6,19,19,3,2,14,13,37,-24,11,R,EN_D1,Pride Park,Derby
2001/02,38,26,Leicester City,20,38,5,13,20,30,64,-34,28,19,3,7,9,15,34,-19,16,19,2,6,11,15,30,-15,12,R,EN_D1,Filbert Street,Leicester
