season,match_week,team_id,team_name,position,played,won,drawn,lost,goals_for,goals_against,goal_difference,points,home_played,home_won,home_drawn,home_lost,home_goals_for,home_goals_against,home_goal_difference,home_points,away_played,away_won,away_drawn,away_lost,away_goals_for,away_goals_against,away_goal_difference,away_points,annotation_types,annotation_destinations,stadium_name,stadium_city
2003/04,1,3,Blackburn Rovers,1,1,1,0,0,5,1,4,3,1,1,0,0,5,1,4,3,0,0,0,0,0,0,0,0,Q,EU_CL,Ewood Park,Blackburn
2003/04,1,12,Manchester United,2,1,1,0,0,4,0,4,3,1,1,0,0,4,0,4,3,0,0,0,0,0,0,0,0,Q,EU_CL,Old Trafford,Manchester
2003/04,1,11,Manchester City,3,1,1,0,0,3,0,3,3,0,0,0,0,0,0,0,0,1,1,0,0,3,0,3,3,Q,EU_CL,Etihad Stadium,Manchester
2003/04,1,34,Fulham,4,1,1,0,0,3,2,1,3,1,1,0,0,3,2,1,3,0,0,0,0,0,0,0,0,Q,EU_CL,Loftus Road,London
2003/04,1,1,Arsenal,5,1,1,0,0,2,1,1,3,1,1,0,0,2,1,1,3,0,0,0,0,0,0,0,0,Q,EU_UC,Highbury,London
2003/04,1,4,Chelsea,6,1,1,0,0,2,1,1,3,0,0,0,0,0,0,0,0,1,1,0,0,2,1,1,3,,,Stamford Bridge,London
2003/04,1,37,Portsmouth,7,1,1,0,0,2,1,1,3,1,1,0,0,2,1,1,3,0,0,0,0,0,0,0,0,,,Fratton Park,Portsmouth
2003/04,1,35,Birmingham City,8,1,1,0,0,1,0,1,3,1,1,0,0,1,0,1,3,0,0,0,0,0,0,0,0,,,St Andrews,Birmingham
2003/04,1,9,Leeds United,9,1,0,1,0,2,2,0,1,1,0,1,0,2,2,0,1,0,0,0,0,0,0,0,0,,,Elland Road,Leeds
2003/04,1,26,Leicester City,10,1,0,1,0,2,2,0,1,1,0,1,0,2,2,0,1,0,0,0,0,0,0,0,0,,,King Power Stadium,Leicester
2003/04,1,23,Newcastle United,11,1,0,1,0,2,2,0,1,0,0,0,0,0,0,0,0,1,0,1,0,2,2,0,1,,,Sports Direct Arena,Newcastle
2003/04,1,20,Southampton,12,1,0,1,0,2,2,0,1,0,0,0,0,0,0,0,0,1,0,1,0,2,2,0,1,,,The Friends Provident St Mary's Stadium,Southampton
2003/04,1,13,Middlesbrough,13,1,0,0,1,2,3,-1,0,0,0,0,0,0,0,0,0,1,0,0,1,2,3,-1,0,Q,EU_UC,Riverside Stadium,Middlesbrough
2003/04,1,2,Aston Villa,14,1,0,0,1,1,2,-1,0,0,0,0,0,0,0,0,0,1,0,0,1,1,2,-1,0,,,Villa Park,Birmingham
2003/04,1,7,Everton,15,1,0,0,1,1,2,-1,0,0,0,0,0,0,0,0,0,1,0,0,1,1,2,-1,0,,,Goodison Park,Liverpool
2003/04,1,10,Liverpool,16,1,0,0,1,1,2,-1,0,1,0,0,1,1,2,-1,0,0,0,0,0,0,0,0,0,,,Anfield,Liverpool
2003/04,1,21,Tottenham Hotspur,17,1,0,0,1,0,1,-1,0,0,0,0,0,0,0,0,0,1,0,0,1,0,1,-1,0,,,White Hart Lane,London
2003/04,1,31,Charlton Athletic,18,1,0,0,1,0,3,-3,0,1,0,0,1,0,3,-3,0,0,0,0,0,0,0,0,0,R,EN_D1,The Valley,London
2003/04,1,38,Wolverhampton Wanderers,19,1,0,0,1,1,5,-4,0,0,0,0,0,0,0,0,0,1,0,0,1,1,5,-4,0,R,EN_D1,Molineux,Wolverhampton
2003/04,1,27,Bolton Wanderers,20,1,0,0,1,0,4,-4,0,0,0,0,0,0,0,0,0,1,0,0,1,0,4,-4,0,R,EN_D1,Macron Stadium,Bolton
2003/04,2,1,Arsenal,1,3,3,0,0,8,1,7,9,2,2,0,0,4,1,3,6,1,1,0,0,4,0,4,3,Q,EU_CL,Highbury,London
2003/04,2,12,Manchester United,2,3,3,0,0,7,1,6,9,2,2,0,0,5,0,5,6,1,1,0,0,2,1,1,3,Q,EU_CL,Old Trafford,Manchester
2003/04,2,37,Portsmouth,3,3,2,1,0,7,2,5,7,2,2,0,0,6,1,5,6,1,0,1,0,1,1,0,1,Q,EU_CL,Fratton Park,Portsmouth
2003/04,2,11,Manchester City,4,3,2,1,0,7,3,4,7,1,0,1,0,1,1,0,1,2,2,0,0,6,2,4,6,Q,EU_CL,Etihad Stadium,Manchester
2003/04,2,4,Chelsea,5,2,2,0,0,4,2,2,6,1,1,0,0,2,1,1,3,1,1,0,0,2,1,1,3,Q,EU_UC,Stamford Bridge,London
2003/04,2,3,Blackburn Rovers,6,3,1,1,1,9,6,3,4,2,1,0,1,7,4,3,3,1,0,1,0,2,2,0,1,,,Ewood Park,Blackburn
2003/04,2,31,Charlton Athletic,7,3,1,1,1,6,5,1,4,2,0,1,1,2,5,-3,1,1,1,0,0,4,0,4,3,,,The Valley,London
2003/04,2,7,Everton,8,3,1,1,1,6,5,1,4,1,1,0,0,3,1,2,3,2,0,1,1,3,4,-1,1,,,Goodison Park,Liverpool
2003/04,2,35,Birmingham City,9,2,1,1,0,1,0,1,4,1,1,0,0,1,0,1,3,1,0,1,0,0,0,0,1,,,St Andrews,Birmingham
2003/04,2,21,Tottenham Hotspur,10,3,1,1,1,2,2,0,4,1,1,0,0,2,1,1,3,2,0,1,1,0,1,-1,1,,,White Hart Lane,London
2003/04,2,20,Southampton,11,3,0,3,0,2,2,0,3,1,0,1,0,0,0,0,1,2,0,2,0,2,2,0,2,,,The Friends Provident St Mary's Stadium,Southampton
2003/04,2,34,Fulham,12,2,1,0,1,4,5,-1,3,1,1,0,0,3,2,1,3,1,0,0,1,1,3,-2,0,,,Loftus Road,London
2003/04,2,9,Leeds United,13,3,0,2,1,3,4,-1,2,2,0,2,0,2,2,0,2,1,0,0,1,1,2,-1,0,,,Elland Road,Leeds
2003/04,2,26,Leicester City,14,3,0,2,1,3,4,-1,2,2,0,2,0,2,2,0,2,1,0,0,1,1,2,-1,0,,,King Power Stadium,Leicester
2003/04,2,10,Liverpool,15,3,0,2,1,1,2,-1,2,2,0,1,1,1,2,-1,1,1,0,1,0,0,0,0,1,,,Anfield,Liverpool
2003/04,2,23,Newcastle United,16,2,0,1,1,3,4,-1,1,1,0,0,1,1,2,-1,0,1,0,1,0,2,2,0,1,,,Sports Direct Arena,Newcastle
2003/04,2,2,Aston Villa,17,3,0,1,2,1,4,-3,1,1,0,1,0,0,0,0,1,2,0,0,2,1,4,-3,0,,,Villa Park,Birmingham
2003/04,2,13,Middlesbrough,18,3,0,1,2,2,7,-5,1,1,0,0,1,0,4,-4,0,2,0,1,1,2,3,-1,1,"R,Q","EN_D1,EU_UC",Riverside Stadium,Middlesbrough
2003/04,2,27,Bolton Wanderers,19,3,0,1,2,2,10,-8,1,1,0,1,0,2,2,0,1,2,0,0,2,0,8,-8,0,R,EN_D1,Macron Stadium,Bolton
2003/04,2,38,Wolverhampton Wanderers,20,3,0,0,3,1,10,-9,0,1,0,0,1,0,4,-4,0,2,0,0,2,1,6,-5,0,R,EN_D1,Molineux,Wolverhampton
2003/04,3,1,Arsenal,1,4,4,0,0,10,2,8,12,2,2,0,0,4,1,3,6,2,2,0,0,6,1,5,6,Q,EU_CL,Highbury,London
2003/04,3,12,Manchester United,2,4,3,0,1,7,2,5,9,2,2,0,0,5,0,5,6,2,1,0,1,2,2,0,3,Q,EU_CL,Old Trafford,Manchester
2003/04,3,37,Portsmouth,3,4,2,2,0,7,2,5,8,2,2,0,0,6,1,5,6,2,0,2,0,1,1,0,2,Q,EU_CL,Fratton Park,Portsmouth
2003/04,3,11,Manchester City,4,4,2,1,1,8,5,3,7,2,0,1,1,2,3,-1,1,2,2,0,0,6,2,4,6,Q,EU_CL,Etihad Stadium,Manchester
2003/04,3,4,Chelsea,5,3,2,1,0,6,4,2,7,2,1,1,0,4,3,1,4,1,1,0,0,2,1,1,3,Q,EU_UC,Stamford Bridge,London
2003/04,3,35,Birmingham City,6,3,2,1,0,2,0,2,7,1,1,0,0,1,0,1,3,2,1,1,0,1,0,1,4,,,St Andrews,Birmingham
2003/04,3,34,Fulham,7,3,2,0,1,7,5,2,6,1,1,0,0,3,2,1,3,2,1,0,1,4,3,1,3,,,Loftus Road,London
2003/04,3,20,Southampton,8,4,1,3,0,3,2,1,6,2,1,1,0,1,0,1,4,2,0,2,0,2,2,0,2,,,The Friends Provident St Mary's Stadium,Southampton
2003/04,3,3,Blackburn Rovers,9,4,1,2,1,11,8,3,5,2,1,0,1,7,4,3,3,2,0,2,0,4,4,0,2,,,Ewood Park,Blackburn
2003/04,3,10,Liverpool,10,4,1,2,1,4,2,2,5,2,0,1,1,1,2,-1,1,2,1,1,0,3,0,3,4,,,Anfield,Liverpool
2003/04,3,31,Charlton Athletic,11,4,1,2,1,6,5,1,5,2,0,1,1,2,5,-3,1,2,1,1,0,4,0,4,4,,,The Valley,London
2003/04,3,9,Leeds United,12,4,1,2,1,6,6,0,5,2,0,2,0,2,2,0,2,2,1,0,1,4,4,0,3,,,Elland Road,Leeds
2003/04,3,2,Aston Villa,13,4,1,1,2,4,5,-1,4,2,1,1,0,3,1,2,4,2,0,0,2,1,4,-3,0,,,Villa Park,Birmingham
2003/04,3,7,Everton,14,4,1,1,2,6,8,-2,4,2,1,0,1,3,4,-1,3,2,0,1,1,3,4,-1,1,,,Goodison Park,Liverpool
2003/04,3,21,Tottenham Hotspur,15,4,1,1,2,2,5,-3,4,2,1,0,1,2,4,-2,3,2,0,1,1,0,1,-1,1,,,White Hart Lane,London
2003/04,3,26,Leicester City,16,4,0,2,2,4,7,-3,2,2,0,2,0,2,2,0,2,2,0,0,2,2,5,-3,0,,,King Power Stadium,Leicester
2003/04,3,27,Bolton Wanderers,17,4,0,2,2,2,10,-8,2,2,0,2,0,2,2,0,2,2,0,0,2,0,8,-8,0,,,Macron Stadium,Bolton
2003/04,3,23,Newcastle United,18,3,0,1,2,3,5,-2,1,2,0,0,2,1,3,-2,0,1,0,1,0,2,2,0,1,R,EN_D1,Sports Direct Arena,Newcastle
2003/04,3,13,Middlesbrough,19,4,0,1,3,4,10,-6,1,2,0,0,2,2,7,-5,0,2,0,1,1,2,3,-1,1,"R,Q","EN_D1,EU_UC",Riverside Stadium,Middlesbrough
2003/04,3,38,Wolverhampton Wanderers,20,4,0,1,3,1,10,-9,1,2,0,1,1,0,4,-4,1,2,0,0,2,1,6,-5,0,R,EN_D1,Molineux,Wolverhampton
2003/04,4,1,Arsenal,1,5,4,1,0,11,3,8,13,3,2,1,0,5,2,3,7,2,2,0,0,6,1,5,6,Q,EU_CL,Highbury,London
2003/04,4,12,Manchester United,2,5,4,0,1,9,2,7,12,2,2,0,0,5,0,5,6,3,2,0,1,4,2,2,6,Q,EU_CL,Old Trafford,Manchester
2003/04,4,11,Manchester City,3,5,3,1,1,12,6,6,10,3,1,1,1,6,4,2,4,2,2,0,0,6,2,4,6,Q,EU_CL,Etihad Stadium,Manchester
2003/04,4,4,Chelsea,4,4,3,1,0,10,6,4,10,3,2,1,0,8,5,3,7,1,1,0,0,2,1,1,3,Q,EU_CL,Stamford Bridge,London
2003/04,4,37,Portsmouth,5,5,2,3,0,8,3,5,9,2,2,0,0,6,1,5,6,3,0,3,0,2,2,0,3,Q,EU_UC,Fratton Park,Portsmouth
2003/04,4,20,Southampton,6,5,2,3,0,5,2,3,9,3,2,1,0,3,0,3,7,2,0,2,0,2,2,0,2,,,The Friends Provident St Mary's Stadium,Southampton
2003/04,4,10,Liverpool,7,5,2,2,1,7,3,4,8,2,0,1,1,1,2,-1,1,3,2,1,0,6,1,5,7,,,Anfield,Liverpool
2003/04,4,35,Birmingham City,8,4,2,2,0,4,2,2,8,2,1,1,0,3,2,1,4,2,1,1,0,1,0,1,4,,,St Andrews,Birmingham
2003/04,4,34,Fulham,9,4,2,1,1,9,7,2,7,1,1,0,0,3,2,1,3,3,1,1,1,6,5,1,4,,,Loftus Road,London
2003/04,4,3,Blackburn Rovers,10,5,1,2,2,12,11,1,5,3,1,0,2,8,7,1,3,2,0,2,0,4,4,0,2,,,Ewood Park,Blackburn
2003/04,4,26,Leicester City,11,5,1,2,2,8,7,1,5,3,1,2,0,6,2,4,5,2,0,0,2,2,5,-3,0,,,King Power Stadium,Leicester
2003/04,4,31,Charlton Athletic,12,5,1,2,2,6,7,-1,5,3,0,1,2,2,7,-5,1,2,1,1,0,4,0,4,4,,,The Valley,London
2003/04,4,7,Everton,13,5,1,2,2,8,10,-2,5,3,1,1,1,5,6,-1,4,2,0,1,1,3,4,-1,1,,,Goodison Park,Liverpool
2003/04,4,9,Leeds United,14,5,1,2,2,6,10,-4,5,2,0,2,0,2,2,0,2,3,1,0,2,4,8,-4,3,,,Elland Road,Leeds
2003/04,4,27,Bolton Wanderers,15,5,1,2,2,4,10,-6,5,3,1,2,0,4,2,2,5,2,0,0,2,0,8,-8,0,,,Macron Stadium,Bolton
2003/04,4,2,Aston Villa,16,5,1,1,3,5,9,-4,4,2,1,1,0,3,1,2,4,3,0,0,3,2,8,-6,0,,,Villa Park,Birmingham
2003/04,4,21,Tottenham Hotspur,17,5,1,1,3,4,9,-5,4,2,1,0,1,2,4,-2,3,3,0,1,2,2,5,-3,1,,,White Hart Lane,London
2003/04,4,23,Newcastle United,18,4,0,2,2,5,7,-2,2,2,0,0,2,1,3,-2,0,2,0,2,0,4,4,0,2,R,EN_D1,Sports Direct Arena,Newcastle
2003/04,4,13,Middlesbrough,19,5,0,1,4,4,12,-8,1,2,0,0,2,2,7,-5,0,3,0,1,2,2,5,-3,1,"R,Q","EN_D1,EU_UC",Riverside Stadium,Middlesbrough
2003/04,4,38,Wolverhampton Wanderers,20,5,0,1,4,1,12,-11,1,2,0,1,1,0,4,-4,1,3,0,0,3,1,8,-7,0,R,EN_D1,Molineux,Wolverhampton
2003/04,5,1,Arsenal,1,6,4,2,0,11,3,8,14,3,2,1,0,5,2,3,7,3,2,1,0,6,1,5,7,Q,EU_CL,Highbury,London
2003/04,5,4,Chelsea,2,5,4,1,0,15,6,9,13,3,2,1,0,8,5,3,7,2,2,0,0,7,1,6,6,Q,EU_CL,Stamford Bridge,London
2003/04,5,12,Manchester United,3,6,4,1,1,9,2,7,13,3,2,1,0,5,0,5,7,3,2,0,1,4,2,2,6,Q,EU_CL,Old Trafford,Manchester
2003/04,5,20,Southampton,4,6,3,3,0,8,3,5,12,3,2,1,0,3,0,3,7,3,1,2,0,5,3,2,5,Q,EU_CL,The Friends Provident St Mary's Stadium,Southampton
2003/04,5,11,Manchester City,5,6,3,2,1,14,8,6,11,3,1,1,1,6,4,2,4,3,2,1,0,8,4,4,7,Q,EU_UC,Etihad Stadium,Manchester
2003/04,5,10,Liverpool,6,6,3,2,1,9,4,5,11,3,1,1,1,3,3,0,4,3,2,1,0,6,1,5,7,,,Anfield,Liverpool
2003/04,5,35,Birmingham City,7,5,3,2,0,6,2,4,11,2,1,1,0,3,2,1,4,3,2,1,0,3,0,3,7,,,St Andrews,Birmingham
2003/04,5,37,Portsmouth,8,6,2,3,1,9,5,4,9,3,2,0,1,7,3,4,6,3,0,3,0,2,2,0,3,,,Fratton Park,Portsmouth
2003/04,5,3,Blackburn Rovers,9,6,2,2,2,14,12,2,8,3,1,0,2,8,7,1,3,3,1,2,0,6,5,1,5,,,Ewood Park,Blackburn
2003/04,5,34,Fulham,10,5,2,2,1,11,9,2,8,2,1,1,0,5,4,1,4,3,1,1,1,6,5,1,4,,,Loftus Road,London
2003/04,5,2,Aston Villa,11,6,2,1,3,7,10,-3,7,3,2,1,0,5,2,3,7,3,0,0,3,2,8,-6,0,,,Villa Park,Birmingham
2003/04,5,27,Bolton Wanderers,12,6,1,3,2,4,10,-6,6,3,1,2,0,4,2,2,5,3,0,1,2,0,8,-8,1,,,Macron Stadium,Bolton
2003/04,5,26,Leicester City,13,6,1,2,3,9,9,0,5,3,1,2,0,6,2,4,5,3,0,0,3,3,7,-4,0,,,King Power Stadium,Leicester
2003/04,5,31,Charlton Athletic,14,6,1,2,3,7,9,-2,5,3,0,1,2,2,7,-5,1,3,1,1,1,5,2,3,4,,,The Valley,London
2003/04,5,7,Everton,15,6,1,2,3,8,11,-3,5,3,1,1,1,5,6,-1,4,3,0,1,2,3,5,-2,1,,,Goodison Park,Liverpool
2003/04,5,9,Leeds United,16,6,1,2,3,6,12,-6,5,3,0,2,1,2,4,-2,2,3,1,0,2,4,8,-4,3,,,Elland Road,Leeds
2003/04,5,13,Middlesbrough,17,6,1,1,4,5,12,-7,4,3,1,0,2,3,7,-4,3,3,0,1,2,2,5,-3,1,Q,EU_UC,Riverside Stadium,Middlesbrough
2003/04,5,21,Tottenham Hotspur,18,6,1,1,4,5,12,-7,4,3,1,0,2,3,7,-4,3,3,0,1,2,2,5,-3,1,R,EN_D1,White Hart Lane,London
2003/04,5,23,Newcastle United,19,5,0,3,2,5,7,-2,3,3,0,1,2,1,3,-2,1,2,0,2,0,4,4,0,2,R,EN_D1,Sports Direct Arena,Newcastle
2003/04,5,38,Wolverhampton Wanderers,20,6,0,1,5,1,17,-16,1,3,0,1,2,0,9,-9,1,3,0,0,3,1,8,-7,0,R,EN_D1,Molineux,Wolverhampton
2003/04,6,1,Arsenal,1,7,5,2,0,14,5,9,17,4,3,1,0,8,4,4,10,3,2,1,0,6,1,5,7,Q,EU_CL,Highbury,London
2003/04,6,4,Chelsea,2,6,5,1,0,16,6,10,16,4,3,1,0,9,5,4,10,2,2,0,0,7,1,6,6,Q,EU_CL,Stamford Bridge,London
2003/04,6,12,Manchester United,3,7,5,1,1,13,3,10,16,3,2,1,0,5,0,5,7,4,3,0,1,8,3,5,9,Q,EU_CL,Old Trafford,Manchester
2003/04,6,35,Birmingham City,4,6,4,2,0,8,2,6,14,3,2,1,0,5,2,3,7,3,2,1,0,3,0,3,7,Q,EU_CL,St Andrews,Birmingham
2003/04,6,11,Manchester City,5,7,3,3,1,14,8,6,12,4,1,2,1,6,4,2,5,3,2,1,0,8,4,4,7,Q,EU_UC,Etihad Stadium,Manchester
2003/04,6,20,Southampton,6,7,3,3,1,8,4,4,12,4,2,1,1,3,1,2,7,3,1,2,0,5,3,2,5,,,The Friends Provident St Mary's Stadium,Southampton
2003/04,6,34,Fulham,7,6,3,2,1,13,9,4,11,2,1,1,0,5,4,1,4,4,2,1,1,8,5,3,7,,,Loftus Road,London
2003/04,6,10,Liverpool,8,7,3,2,2,11,7,4,11,3,1,1,1,3,3,0,4,4,2,1,1,8,4,4,7,,,Anfield,Liverpool
2003/04,6,37,Portsmouth,9,7,2,3,2,9,7,2,9,3,2,0,1,7,3,4,6,4,0,3,1,2,4,-2,3,,,Fratton Park,Portsmouth
2003/04,6,7,Everton,10,7,2,2,3,12,11,1,8,4,2,1,1,9,6,3,7,3,0,1,2,3,5,-2,1,,,Goodison Park,Liverpool
2003/04,6,3,Blackburn Rovers,11,7,2,2,3,14,14,0,8,4,1,0,3,8,9,-1,3,3,1,2,0,6,5,1,5,,,Ewood Park,Blackburn
2003/04,6,31,Charlton Athletic,12,7,2,2,3,10,11,-1,8,4,1,1,2,5,9,-4,4,3,1,1,1,5,2,3,4,,,The Valley,London
2003/04,6,2,Aston Villa,13,7,2,1,4,7,11,-4,7,3,2,1,0,5,2,3,7,4,0,0,4,2,9,-7,0,,,Villa Park,Birmingham
2003/04,6,13,Middlesbrough,14,7,2,1,4,6,12,-6,7,3,1,0,2,3,7,-4,3,4,1,1,2,3,5,-2,4,Q,EU_UC,Riverside Stadium,Middlesbrough
2003/04,6,27,Bolton Wanderers,15,7,1,4,2,5,11,-6,7,4,1,3,0,5,3,2,6,3,0,1,2,0,8,-8,1,,,Macron Stadium,Bolton
2003/04,6,26,Leicester City,16,7,1,2,4,10,13,-3,5,4,1,2,1,7,6,1,5,3,0,0,3,3,7,-4,0,,,King Power Stadium,Leicester
2003/04,6,21,Tottenham Hotspur,17,7,1,2,4,5,12,-7,5,3,1,0,2,3,7,-4,3,4,0,2,2,2,5,-3,2,,,White Hart Lane,London
2003/04,6,9,Leeds United,18,7,1,2,4,6,16,-10,5,3,0,2,1,2,4,-2,2,4,1,0,3,4,12,-8,3,R,EN_D1,Elland Road,Leeds
2003/04,6,23,Newcastle United,19,6,0,3,3,7,10,-3,3,3,0,1,2,1,3,-2,1,3,0,2,1,6,7,-1,2,R,EN_D1,Sports Direct Arena,Newcastle
2003/04,6,38,Wolverhampton Wanderers,20,7,0,2,5,2,18,-16,2,3,0,1,2,0,9,-9,1,4,0,1,3,2,9,-7,1,R,EN_D1,Molineux,Wolverhampton
2003/04,7,4,Chelsea,1,8,6,2,0,18,7,11,20,4,3,1,0,9,5,4,10,4,3,1,0,9,2,7,10,Q,EU_CL,Stamford Bridge,London
2003/04,7,1,Arsenal,2,8,6,2,0,16,6,10,20,4,3,1,0,8,4,4,10,4,3,1,0,8,2,6,10,Q,EU_CL,Highbury,London
2003/04,7,12,Manchester United,3,8,6,1,1,16,3,13,19,4,3,1,0,8,0,8,10,4,3,0,1,8,3,5,9,Q,EU_CL,Old Trafford,Manchester
2003/04,7,35,Birmingham City,4,8,4,3,1,8,5,3,15,4,2,2,0,5,2,3,8,4,2,1,1,3,3,0,7,Q,EU_CL,St Andrews,Birmingham
2003/04,7,34,Fulham,5,7,4,2,1,15,9,6,14,3,2,1,0,7,4,3,7,4,2,1,1,8,5,3,7,Q,EU_UC,Loftus Road,London
2003/04,7,11,Manchester City,6,8,3,3,2,14,9,5,12,4,1,2,1,6,4,2,5,4,2,1,1,8,5,3,7,,,Etihad Stadium,Manchester
2003/04,7,20,Southampton,7,8,3,3,2,8,5,3,12,4,2,1,1,3,1,2,7,4,1,2,1,5,4,1,5,,,The Friends Provident St Mary's Stadium,Southampton
2003/04,7,10,Liverpool,8,8,3,2,3,12,9,3,11,4,1,1,2,4,5,-1,4,4,2,1,1,8,4,4,7,,,Anfield,Liverpool
2003/04,7,31,Charlton Athletic,9,8,3,2,3,12,12,0,11,4,1,1,2,5,9,-4,4,4,2,1,1,7,3,4,7,,,The Valley,London
2003/04,7,37,Portsmouth,10,8,2,3,3,10,9,1,9,4,2,0,2,8,5,3,6,4,0,3,1,2,4,-2,3,,,Fratton Park,Portsmouth
2003/04,7,3,Blackburn Rovers,11,8,2,2,4,15,16,-1,8,4,1,0,3,8,9,-1,3,4,1,2,1,7,7,0,5,,,Ewood Park,Blackburn
2003/04,7,7,Everton,12,8,2,2,4,12,14,-2,8,4,2,1,1,9,6,3,7,4,0,1,3,3,8,-5,1,,,Goodison Park,Liverpool
2003/04,7,2,Aston Villa,13,8,2,2,4,8,12,-4,8,4,2,2,0,6,3,3,8,4,0,0,4,2,9,-7,0,,,Villa Park,Birmingham
2003/04,7,21,Tottenham Hotspur,14,8,2,2,4,8,12,-4,8,4,2,0,2,6,7,-1,6,4,0,2,2,2,5,-3,2,,,White Hart Lane,London
2003/04,7,27,Bolton Wanderers,15,8,1,5,2,6,12,-6,8,4,1,3,0,5,3,2,6,4,0,2,2,1,9,-8,2,,,Macron Stadium,Bolton
2003/04,7,9,Leeds United,16,8,2,2,4,8,17,-9,8,4,1,2,1,4,5,-1,5,4,1,0,3,4,12,-8,3,,,Elland Road,Leeds
2003/04,7,13,Middlesbrough,17,8,2,1,5,7,14,-7,7,4,1,0,3,4,9,-5,3,4,1,1,2,3,5,-2,4,Q,EU_UC,Riverside Stadium,Middlesbrough
2003/04,7,23,Newcastle United,18,7,1,3,3,8,10,-2,6,4,1,1,2,2,3,-1,4,3,0,2,1,6,7,-1,2,R,EN_D1,Sports Direct Arena,Newcastle
2003/04,7,26,Leicester City,19,8,1,2,5,10,15,-5,5,4,1,2,1,7,6,1,5,4,0,0,4,3,9,-6,0,R,EN_D1,King Power Stadium,Leicester
2003/04,7,38,Wolverhampton Wanderers,20,8,1,2,5,3,18,-15,5,4,1,1,2,1,9,-8,4,4,0,1,3,2,9,-7,1,R,EN_D1,Molineux,Wolverhampton
2003/04,8,1,Arsenal,1,9,7,2,0,18,7,11,23,5,4,1,0,10,5,5,13,4,3,1,0,8,2,6,10,Q,EU_CL,Highbury,London
2003/04,8,12,Manchester United,2,9,7,1,1,17,3,14,22,4,3,1,0,8,0,8,10,5,4,0,1,9,3,6,12,Q,EU_CL,Old Trafford,Manchester
2003/04,8,4,Chelsea,3,9,6,2,1,19,9,10,20,4,3,1,0,9,5,4,10,5,3,1,1,10,4,6,10,Q,EU_CL,Stamford Bridge,London
2003/04,8,35,Birmingham City,4,9,4,4,1,8,5,3,16,5,2,3,0,5,2,3,9,4,2,1,1,3,3,0,7,Q,EU_CL,St Andrews,Birmingham
2003/04,8,11,Manchester City,5,9,4,3,2,20,11,9,15,5,2,2,1,12,6,6,8,4,2,1,1,8,5,3,7,Q,EU_UC,Etihad Stadium,Manchester
2003/04,8,34,Fulham,6,9,4,3,2,17,12,5,15,5,2,2,1,9,7,2,8,4,2,1,1,8,5,3,7,,,Loftus Road,London
2003/04,8,31,Charlton Athletic,7,9,4,2,3,13,12,1,14,4,1,1,2,5,9,-4,4,5,3,1,1,8,3,5,10,,,The Valley,London
2003/04,8,20,Southampton,8,9,3,4,2,8,5,3,13,4,2,1,1,3,1,2,7,5,1,3,1,5,4,1,6,,,The Friends Provident St Mary's Stadium,Southampton
2003/04,8,37,Portsmouth,9,9,3,3,3,11,9,2,12,5,3,0,2,9,5,4,9,4,0,3,1,2,4,-2,3,,,Fratton Park,Portsmouth
2003/04,8,23,Newcastle United,10,9,3,3,3,12,12,0,12,4,1,1,2,2,3,-1,4,5,2,2,1,10,9,1,8,,,Sports Direct Arena,Newcastle
2003/04,8,10,Liverpool,11,9,3,2,4,12,10,2,11,4,1,1,2,4,5,-1,4,5,2,1,2,8,5,3,7,,,Anfield,Liverpool
2003/04,8,21,Tottenham Hotspur,12,9,3,2,4,10,13,-3,11,4,2,0,2,6,7,-1,6,5,1,2,2,4,6,-2,5,,,White Hart Lane,London
2003/04,8,7,Everton,13,9,2,3,4,12,14,-2,9,5,2,2,1,9,6,3,8,4,0,1,3,3,8,-5,1,,,Goodison Park,Liverpool
2003/04,8,2,Aston Villa,14,9,2,3,4,8,12,-4,9,4,2,2,0,6,3,3,8,5,0,1,4,2,9,-7,1,,,Villa Park,Birmingham
2003/04,8,3,Blackburn Rovers,15,9,2,2,5,15,17,-2,8,5,1,0,4,8,10,-2,3,4,1,2,1,7,7,0,5,,,Ewood Park,Blackburn
2003/04,8,27,Bolton Wanderers,16,9,1,5,3,8,18,-10,8,4,1,3,0,5,3,2,6,5,0,2,3,3,15,-12,2,,,Macron Stadium,Bolton
2003/04,8,9,Leeds United,17,9,2,2,5,8,18,-10,8,5,1,2,2,4,6,-2,5,4,1,0,3,4,12,-8,3,,,Elland Road,Leeds
2003/04,8,13,Middlesbrough,18,9,2,1,6,7,15,-8,7,5,1,0,4,4,10,-6,3,4,1,1,2,3,5,-2,4,"R,Q","EN_D1,EU_UC",Riverside Stadium,Middlesbrough
2003/04,8,38,Wolverhampton Wanderers,19,9,1,3,5,3,18,-15,6,4,1,1,2,1,9,-8,4,5,0,2,3,2,9,-7,2,R,EN_D1,Molineux,Wolverhampton
2003/04,8,26,Leicester City,20,9,1,2,6,11,17,-6,5,5,1,2,2,8,8,0,5,4,0,0,4,3,9,-6,0,R,EN_D1,King Power Stadium,Leicester
2003/04,9,1,Arsenal,1,10,7,3,0,19,8,11,24,5,4,1,0,10,5,5,13,5,3,2,0,9,3,6,11,Q,EU_CL,Highbury,London
2003/04,9,4,Chelsea,2,10,7,2,1,20,9,11,23,5,4,1,0,10,5,5,13,5,3,1,1,10,4,6,10,Q,EU_CL,Stamford Bridge,London
2003/04,9,12,Manchester United,3,10,7,1,2,18,6,12,22,5,3,1,1,9,3,6,10,5,4,0,1,9,3,6,12,Q,EU_CL,Old Trafford,Manchester
2003/04,9,35,Birmingham City,4,10,5,4,1,9,5,4,19,5,2,3,0,5,2,3,9,5,3,1,1,4,3,1,10,Q,EU_CL,St Andrews,Birmingham
2003/04,9,34,Fulham,5,10,5,3,2,20,13,7,18,5,2,2,1,9,7,2,8,5,3,1,1,11,6,5,10,Q,EU_UC,Loftus Road,London
2003/04,9,20,Southampton,6,10,4,4,2,10,5,5,16,5,3,1,1,5,1,4,10,5,1,3,1,5,4,1,6,,,The Friends Provident St Mary's Stadium,Southampton
2003/04,9,11,Manchester City,7,10,4,3,3,20,12,8,15,5,2,2,1,12,6,6,8,5,2,1,2,8,6,2,7,,,Etihad Stadium,Manchester
2003/04,9,23,Newcastle United,8,10,4,3,3,15,12,3,15,5,2,1,2,5,3,2,7,5,2,2,1,10,9,1,8,,,Sports Direct Arena,Newcastle
2003/04,9,31,Charlton Athletic,9,10,4,3,3,14,13,1,15,5,1,2,2,6,10,-4,5,5,3,1,1,8,3,5,10,,,The Valley,London
2003/04,9,10,Liverpool,10,10,4,2,4,15,11,4,14,5,2,1,2,7,6,1,7,5,2,1,2,8,5,3,7,,,Anfield,Liverpool
2003/04,9,37,Portsmouth,11,10,3,3,4,11,12,-1,12,5,3,0,2,9,5,4,9,5,0,3,2,2,7,-5,3,,,Fratton Park,Portsmouth
2003/04,9,21,Tottenham Hotspur,12,10,3,3,4,10,13,-3,12,5,2,1,2,6,7,-1,7,5,1,2,2,4,6,-2,5,,,White Hart Lane,London
2003/04,9,7,Everton,13,10,2,4,4,12,14,-2,10,5,2,2,1,9,6,3,8,5,0,2,3,3,8,-5,2,,,Goodison Park,Liverpool
2003/04,9,2,Aston Villa,14,10,2,4,4,8,12,-4,10,5,2,3,0,6,3,3,9,5,0,1,4,2,9,-7,1,,,Villa Park,Birmingham
2003/04,9,38,Wolverhampton Wanderers,15,10,2,3,5,7,21,-14,9,5,2,1,2,5,12,-7,7,5,0,2,3,2,9,-7,2,,,Molineux,Wolverhampton
2003/04,9,3,Blackburn Rovers,16,10,2,2,6,15,19,-4,8,5,1,0,4,8,10,-2,3,5,1,2,2,7,9,-2,5,,,Ewood Park,Blackburn
2003/04,9,13,Middlesbrough,17,10,2,2,6,7,15,-8,8,5,1,0,4,4,10,-6,3,5,1,2,2,3,5,-2,5,Q,EU_UC,Riverside Stadium,Middlesbrough
2003/04,9,27,Bolton Wanderers,18,10,1,5,4,8,19,-11,8,5,1,3,1,5,4,1,6,5,0,2,3,3,15,-12,2,R,EN_D1,Macron Stadium,Bolton
2003/04,9,9,Leeds United,19,10,2,2,6,9,21,-12,8,5,1,2,2,4,6,-2,5,5,1,0,4,5,15,-10,3,R,EN_D1,Elland Road,Leeds
2003/04,9,26,Leicester City,20,10,1,2,7,14,21,-7,5,5,1,2,2,8,8,0,5,5,0,0,5,6,13,-7,0,R,EN_D1,King Power Stadium,Leicester
2003/04,10,1,Arsenal,1,11,8,3,0,23,9,14,27,5,4,1,0,10,5,5,13,6,4,2,0,13,4,9,14,Q,EU_CL,Highbury,London
2003/04,10,4,Chelsea,2,11,8,2,1,21,9,12,26,5,4,1,0,10,5,5,13,6,4,1,1,11,4,7,13,Q,EU_CL,Stamford Bridge,London
2003/04,10,12,Manchester United,3,11,8,1,2,21,6,15,25,6,4,1,1,12,3,9,13,5,4,0,1,9,3,6,12,Q,EU_CL,Old Trafford,Manchester
2003/04,10,35,Birmingham City,4,11,5,4,2,10,7,3,19,6,2,3,1,6,4,2,9,5,3,1,1,4,3,1,10,Q,EU_CL,St Andrews,Birmingham
2003/04,10,11,Manchester City,5,11,5,3,3,22,12,10,18,5,2,2,1,12,6,6,8,6,3,1,2,10,6,4,10,Q,EU_UC,Etihad Stadium,Manchester
2003/04,10,34,Fulham,6,11,5,3,3,21,15,6,18,6,2,2,2,10,9,1,8,5,3,1,1,11,6,5,10,,,Loftus Road,London
2003/04,10,31,Charlton Athletic,7,11,5,3,3,16,14,2,18,5,1,2,2,6,10,-4,5,6,4,1,1,10,4,6,13,,,The Valley,London
2003/04,10,10,Liverpool,8,11,5,2,4,17,12,5,17,5,2,1,2,7,6,1,7,6,3,1,2,10,6,4,10,,,Anfield,Liverpool
2003/04,10,23,Newcastle United,9,11,4,4,3,16,13,3,16,6,2,2,2,6,4,2,8,5,2,2,1,10,9,1,8,,,Sports Direct Arena,Newcastle
2003/04,10,20,Southampton,10,11,4,4,3,10,7,3,16,6,3,1,2,5,3,2,10,5,1,3,1,5,4,1,6,,,The Friends Provident St Mary's Stadium,Southampton
2003/04,10,37,Portsmouth,11,11,3,3,5,11,15,-4,12,5,3,0,2,9,5,4,9,6,0,3,3,2,10,-8,3,,,Fratton Park,Portsmouth
2003/04,10,21,Tottenham Hotspur,12,11,3,3,5,10,14,-4,12,6,2,1,3,6,8,-2,7,5,1,2,2,4,6,-2,5,,,White Hart Lane,London
2003/04,10,2,Aston Villa,13,11,2,5,4,9,13,-4,11,5,2,3,0,6,3,3,9,6,0,2,4,3,10,-7,2,,,Villa Park,Birmingham
2003/04,10,13,Middlesbrough,14,11,3,2,6,9,15,-6,11,6,2,0,4,6,10,-4,6,5,1,2,2,3,5,-2,5,Q,EU_UC,Riverside Stadium,Middlesbrough
2003/04,10,27,Bolton Wanderers,15,11,2,5,4,9,19,-10,11,5,1,3,1,5,4,1,6,6,1,2,3,4,15,-11,5,,,Macron Stadium,Bolton
2003/04,10,7,Everton,16,11,2,4,5,12,15,-3,10,6,2,2,2,9,7,2,8,5,0,2,3,3,8,-5,2,,,Goodison Park,Liverpool
2003/04,10,38,Wolverhampton Wanderers,17,11,2,3,6,7,23,-16,9,5,2,1,2,5,12,-7,7,6,0,2,4,2,11,-9,2,,,Molineux,Wolverhampton
2003/04,10,26,Leicester City,18,11,2,2,7,16,21,-5,8,6,2,2,2,10,8,2,8,5,0,0,5,6,13,-7,0,R,EN_D1,King Power Stadium,Leicester
2003/04,10,3,Blackburn Rovers,19,11,2,2,7,15,21,-6,8,5,1,0,4,8,10,-2,3,6,1,2,3,7,11,-4,5,R,EN_D1,Ewood Park,Blackburn
2003/04,10,9,Leeds United,20,11,2,2,7,10,25,-15,8,6,1,2,3,5,10,-5,5,5,1,0,4,5,15,-10,3,R,EN_D1,Elland Road,Leeds
2003/04,11,1,Arsenal,1,12,9,3,0,25,10,15,30,6,5,1,0,12,6,6,16,6,4,2,0,13,4,9,14,Q,EU_CL,Highbury,London
2003/04,11,4,Chelsea,2,12,9,2,1,26,9,17,29,6,5,1,0,15,5,10,16,6,4,1,1,11,4,7,13,Q,EU_CL,Stamford Bridge,London
2003/04,11,12,Manchester United,3,12,9,1,2,23,7,16,28,6,4,1,1,12,3,9,13,6,5,0,1,11,4,7,15,Q,EU_CL,Old Trafford,Manchester
2003/04,11,31,Charlton Athletic,4,12,6,3,3,19,15,4,21,6,2,2,2,9,11,-2,8,6,4,1,1,10,4,6,13,Q,EU_CL,The Valley,London
2003/04,11,35,Birmingham City,5,12,5,5,2,11,8,3,20,6,2,3,1,6,4,2,9,6,3,2,1,5,4,1,11,Q,EU_UC,St Andrews,Birmingham
2003/04,11,11,Manchester City,6,12,5,3,4,22,15,7,18,6,2,2,2,12,9,3,8,6,3,1,2,10,6,4,10,,,Etihad Stadium,Manchester
2003/04,11,34,Fulham,7,12,5,3,4,22,18,4,18,6,2,2,2,10,9,1,8,6,3,1,2,12,9,3,10,,,Loftus Road,London
2003/04,11,10,Liverpool,8,12,5,2,5,18,14,4,17,6,2,1,3,8,8,0,7,6,3,1,2,10,6,4,10,,,Anfield,Liverpool
2003/04,11,20,Southampton,9,12,4,5,3,10,7,3,17,6,3,1,2,5,3,2,10,6,1,4,1,5,4,1,7,,,The Friends Provident St Mary's Stadium,Southampton
2003/04,11,23,Newcastle United,10,12,4,4,4,16,18,-2,16,6,2,2,2,6,4,2,8,6,2,2,2,10,14,-4,8,,,Sports Direct Arena,Newcastle
2003/04,11,37,Portsmouth,11,12,4,3,5,17,16,1,15,6,4,0,2,15,6,9,12,6,0,3,3,2,10,-8,3,,,Fratton Park,Portsmouth
2003/04,11,13,Middlesbrough,12,12,4,2,6,11,15,-4,14,6,2,0,4,6,10,-4,6,6,2,2,2,5,5,0,8,Q,EU_UC,Riverside Stadium,Middlesbrough
2003/04,11,21,Tottenham Hotspur,13,12,3,3,6,11,16,-5,12,6,2,1,3,6,8,-2,7,6,1,2,3,5,8,-3,5,,,White Hart Lane,London
2003/04,11,27,Bolton Wanderers,14,12,2,6,4,9,19,-10,12,6,1,4,1,5,4,1,7,6,1,2,3,4,15,-11,5,,,Macron Stadium,Bolton
2003/04,11,26,Leicester City,15,12,3,2,7,19,21,-2,11,6,2,2,2,10,8,2,8,6,1,0,5,9,13,-4,3,,,King Power Stadium,Leicester
2003/04,11,3,Blackburn Rovers,16,12,3,2,7,17,22,-5,11,6,2,0,4,10,11,-1,6,6,1,2,3,7,11,-4,5,,,Ewood Park,Blackburn
2003/04,11,2,Aston Villa,17,12,2,5,5,9,15,-6,11,6,2,3,1,6,5,1,9,6,0,2,4,3,10,-7,2,,,Villa Park,Birmingham
2003/04,11,7,Everton,18,12,2,4,6,13,17,-4,10,6,2,2,2,9,7,2,8,6,0,2,4,4,10,-6,2,R,EN_D1,Goodison Park,Liverpool
2003/04,11,38,Wolverhampton Wanderers,19,12,2,4,6,8,24,-16,10,6,2,2,2,6,13,-7,8,6,0,2,4,2,11,-9,2,R,EN_D1,Molineux,Wolverhampton
2003/04,11,9,Leeds United,20,12,2,2,8,11,31,-20,8,6,1,2,3,5,10,-5,5,6,1,0,5,6,21,-15,3,R,EN_D1,Elland Road,Leeds
2003/04,12,1,Arsenal,1,13,10,3,0,28,10,18,33,6,5,1,0,12,6,6,16,7,5,2,0,16,4,12,17,Q,EU_CL,Highbury,London
2003/04,12,4,Chelsea,2,13,10,2,1,27,9,18,32,6,5,1,0,15,5,10,16,7,5,1,1,12,4,8,16,Q,EU_CL,Stamford Bridge,London
2003/04,12,12,Manchester United,3,13,10,1,2,25,8,17,31,7,5,1,1,14,4,10,16,6,5,0,1,11,4,7,15,Q,EU_CL,Old Trafford,Manchester
2003/04,12,31,Charlton Athletic,4,13,6,4,3,20,16,4,22,6,2,2,2,9,11,-2,8,7,4,2,1,11,5,6,14,Q,EU_CL,The Valley,London
2003/04,12,34,Fulham,5,13,6,3,4,24,18,6,21,7,3,2,2,12,9,3,11,6,3,1,2,12,9,3,10,Q,EU_UC,Loftus Road,London
2003/04,12,35,Birmingham City,6,13,5,5,3,11,11,0,20,7,2,3,2,6,7,-1,9,6,3,2,1,5,4,1,11,,,St Andrews,Birmingham
2003/04,12,23,Newcastle United,7,13,5,4,4,19,18,1,19,7,3,2,2,9,4,5,11,6,2,2,2,10,14,-4,8,,,Sports Direct Arena,Newcastle
2003/04,12,11,Manchester City,8,13,5,3,5,22,18,4,18,6,2,2,2,12,9,3,8,7,3,1,3,10,9,1,10,,,Etihad Stadium,Manchester
2003/04,12,10,Liverpool,9,13,5,3,5,18,14,4,18,6,2,1,3,8,8,0,7,7,3,2,2,10,6,4,11,,,Anfield,Liverpool
2003/04,12,20,Southampton,10,13,4,5,4,10,8,2,17,7,3,1,3,5,4,1,10,6,1,4,1,5,4,1,7,,,The Friends Provident St Mary's Stadium,Southampton
2003/04,12,37,Portsmouth,11,13,4,3,6,17,18,-1,15,6,4,0,2,15,6,9,12,7,0,3,4,2,12,-10,3,,,Fratton Park,Portsmouth
2003/04,12,21,Tottenham Hotspur,12,13,4,3,6,13,17,-4,15,7,3,1,3,8,9,-1,10,6,1,2,3,5,8,-3,5,,,White Hart Lane,London
2003/04,12,13,Middlesbrough,13,13,4,3,6,11,15,-4,15,7,2,1,4,6,10,-4,7,6,2,2,2,5,5,0,8,Q,EU_UC,Riverside Stadium,Middlesbrough
2003/04,12,27,Bolton Wanderers,14,13,3,6,4,11,19,-8,15,6,1,4,1,5,4,1,7,7,2,2,3,6,15,-9,8,,,Macron Stadium,Bolton
2003/04,12,7,Everton,15,13,3,4,6,15,17,-2,13,7,3,2,2,11,7,4,11,6,0,2,4,4,10,-6,2,,,Goodison Park,Liverpool
2003/04,12,26,Leicester City,16,13,3,3,7,20,22,-2,12,7,2,3,2,11,9,2,9,6,1,0,5,9,13,-4,3,,,King Power Stadium,Leicester
2003/04,12,3,Blackburn Rovers,17,13,3,2,8,18,24,-6,11,6,2,0,4,10,11,-1,6,7,1,2,4,8,13,-5,5,,,Ewood Park,Blackburn
2003/04,12,2,Aston Villa,18,13,2,5,6,10,17,-7,11,6,2,3,1,6,5,1,9,7,0,2,5,4,12,-8,2,R,EN_D1,Villa Park,Birmingham
2003/04,12,38,Wolverhampton Wanderers,19,13,2,4,7,8,26,-18,10,6,2,2,2,6,13,-7,8,7,0,2,5,2,13,-11,2,R,EN_D1,Molineux,Wolverhampton
2003/04,12,9,Leeds United,20,13,2,2,9,11,33,-22,8,7,1,2,4,5,12,-7,5,6,1,0,5,6,21,-15,3,R,EN_D1,Elland Road,Leeds
2003/04,13,4,Chelsea,1,14,11,2,1,28,9,19,35,7,6,1,0,16,5,11,19,7,5,1,1,12,4,8,16,Q,EU_CL,Stamford Bridge,London
2003/04,13,1,Arsenal,2,14,10,4,0,28,10,18,34,7,5,2,0,12,6,6,17,7,5,2,0,16,4,12,17,Q,EU_CL,Highbury,London
2003/04,13,12,Manchester United,3,14,10,1,3,25,9,16,31,7,5,1,1,14,4,10,16,7,5,0,2,11,5,6,15,Q,EU_CL,Old Trafford,Manchester
2003/04,13,34,Fulham,4,14,6,4,4,24,18,6,22,7,3,2,2,12,9,3,11,7,3,2,2,12,9,3,11,Q,EU_CL,Loftus Road,London
2003/04,13,31,Charlton Athletic,5,14,6,4,4,20,17,3,22,7,2,2,3,9,12,-3,8,7,4,2,1,11,5,6,14,Q,EU_UC,The Valley,London
2003/04,13,10,Liverpool,6,14,6,3,5,21,15,6,21,7,3,1,3,11,9,2,10,7,3,2,2,10,6,4,11,,,Anfield,Liverpool
2003/04,13,23,Newcastle United,7,14,5,5,4,20,19,1,20,7,3,2,2,9,4,5,11,7,2,3,2,11,15,-4,9,,,Sports Direct Arena,Newcastle
2003/04,13,35,Birmingham City,8,14,5,5,4,12,14,-2,20,7,2,3,2,6,7,-1,9,7,3,2,2,6,7,-1,11,,,St Andrews,Birmingham
2003/04,13,11,Manchester City,9,14,5,3,6,22,19,3,18,7,2,2,3,12,10,2,8,7,3,1,3,10,9,1,10,,,Etihad Stadium,Manchester
2003/04,13,13,Middlesbrough,10,14,5,3,6,12,15,-3,18,7,2,1,4,6,10,-4,7,7,3,2,2,6,5,1,11,Q,EU_UC,Riverside Stadium,Middlesbrough
2003/04,13,27,Bolton Wanderers,11,14,4,6,4,13,19,-6,18,7,2,4,1,7,4,3,10,7,2,2,3,6,15,-9,8,,,Macron Stadium,Bolton
2003/04,13,20,Southampton,12,14,4,5,5,10,9,1,17,7,3,1,3,5,4,1,10,7,1,4,2,5,5,0,7,,,The Friends Provident St Mary's Stadium,Southampton
2003/04,13,26,Leicester City,13,14,4,3,7,22,22,0,15,7,2,3,2,11,9,2,9,7,2,0,5,11,13,-2,6,,,King Power Stadium,Leicester
2003/04,13,37,Portsmouth,14,14,4,3,7,17,20,-3,15,7,4,0,3,15,8,7,12,7,0,3,4,2,12,-10,3,,,Fratton Park,Portsmouth
2003/04,13,21,Tottenham Hotspur,15,14,4,3,7,13,18,-5,15,7,3,1,3,8,9,-1,10,7,1,2,4,5,9,-4,5,,,White Hart Lane,London
2003/04,13,3,Blackburn Rovers,16,14,4,2,8,19,24,-5,14,7,3,0,4,11,11,0,9,7,1,2,4,8,13,-5,5,,,Ewood Park,Blackburn
2003/04,13,2,Aston Villa,17,14,3,5,6,11,17,-6,14,7,3,3,1,7,5,2,12,7,0,2,5,4,12,-8,2,,,Villa Park,Birmingham
2003/04,13,7,Everton,18,14,3,4,7,15,19,-4,13,7,3,2,2,11,7,4,11,7,0,2,5,4,12,-8,2,R,EN_D1,Goodison Park,Liverpool
2003/04,13,38,Wolverhampton Wanderers,19,14,2,5,7,9,27,-18,11,7,2,3,2,7,14,-7,9,7,0,2,5,2,13,-11,2,R,EN_D1,Molineux,Wolverhampton
2003/04,13,9,Leeds United,20,14,3,2,9,12,33,-21,11,7,1,2,4,5,12,-7,5,7,2,0,5,7,21,-14,6,R,EN_D1,Elland Road,Leeds
2003/04,14,4,Chelsea,1,15,11,3,1,29,10,19,36,7,6,1,0,16,5,11,19,8,5,2,1,13,5,8,17,Q,EU_CL,Stamford Bridge,London
2003/04,14,1,Arsenal,2,15,10,5,0,29,11,18,35,7,5,2,0,12,6,6,17,8,5,3,0,17,5,12,18,Q,EU_CL,Highbury,London
2003/04,14,12,Manchester United,3,15,11,1,3,29,9,20,34,8,6,1,1,18,4,14,19,7,5,0,2,11,5,6,15,Q,EU_CL,Old Trafford,Manchester
2003/04,14,34,Fulham,4,15,7,4,4,26,19,7,25,8,4,2,2,14,10,4,14,7,3,2,2,12,9,3,11,Q,EU_CL,Loftus Road,London
2003/04,14,10,Liverpool,5,15,6,4,5,22,16,6,22,7,3,1,3,11,9,2,10,8,3,3,2,11,7,4,12,Q,EU_UC,Anfield,Liverpool
2003/04,14,31,Charlton Athletic,6,15,6,4,5,22,20,2,22,7,2,2,3,9,12,-3,8,8,4,2,2,13,8,5,14,,,The Valley,London
2003/04,14,23,Newcastle United,7,15,5,6,4,21,20,1,21,8,3,3,2,10,5,5,12,7,2,3,2,11,15,-4,9,,,Sports Direct Arena,Newcastle
2003/04,14,20,Southampton,8,15,5,5,5,13,11,2,20,8,4,1,3,8,6,2,13,7,1,4,2,5,5,0,7,,,The Friends Provident St Mary's Stadium,Southampton
2003/04,14,35,Birmingham City,9,15,5,5,5,12,18,-6,20,8,2,3,3,6,11,-5,9,7,3,2,2,6,7,-1,11,,,St Andrews,Birmingham
2003/04,14,11,Manchester City,10,15,5,4,6,22,19,3,19,7,2,2,3,12,10,2,8,8,3,2,3,10,9,1,11,,,Etihad Stadium,Manchester
2003/04,14,13,Middlesbrough,11,15,5,4,6,12,15,-3,19,8,2,2,4,6,10,-4,8,7,3,2,2,6,5,1,11,Q,EU_UC,Riverside Stadium,Middlesbrough
2003/04,14,21,Tottenham Hotspur,12,15,5,3,7,18,20,-2,18,8,4,1,3,13,11,2,13,7,1,2,4,5,9,-4,5,,,White Hart Lane,London
2003/04,14,27,Bolton Wanderers,13,15,4,6,5,14,21,-7,18,7,2,4,1,7,4,3,10,8,2,2,4,7,17,-10,8,,,Macron Stadium,Bolton
2003/04,14,3,Blackburn Rovers,14,15,5,2,8,23,24,-1,17,7,3,0,4,11,11,0,9,8,2,2,4,12,13,-1,8,,,Ewood Park,Blackburn
2003/04,14,26,Leicester City,15,15,4,4,7,23,23,0,16,8,2,4,2,12,10,2,10,7,2,0,5,11,13,-2,6,,,King Power Stadium,Leicester
2003/04,14,37,Portsmouth,16,15,4,4,7,17,20,-3,16,7,4,0,3,15,8,7,12,8,0,4,4,2,12,-10,4,,,Fratton Park,Portsmouth
2003/04,14,7,Everton,17,15,3,5,7,15,19,-4,14,8,3,3,2,11,7,4,12,7,0,2,5,4,12,-8,2,,,Goodison Park,Liverpool
2003/04,14,2,Aston Villa,18,15,3,5,7,11,21,-10,14,7,3,3,1,7,5,2,12,8,0,2,6,4,16,-12,2,R,EN_D1,Villa Park,Birmingham
2003/04,14,9,Leeds United,19,15,3,3,9,13,34,-21,12,8,1,3,4,6,13,-7,6,7,2,0,5,7,21,-14,6,R,EN_D1,Elland Road,Leeds
2003/04,14,38,Wolverhampton Wanderers,20,15,2,5,8,11,32,-21,11,7,2,3,2,7,14,-7,9,8,0,2,6,4,18,-14,2,R,EN_D1,Molineux,Wolverhampton
2003/04,15,1,Arsenal,1,16,11,5,0,30,11,19,38,8,6,2,0,13,6,7,20,8,5,3,0,17,5,12,18,Q,EU_CL,Highbury,London
2003/04,15,12,Manchester United,2,16,12,1,3,32,10,22,37,9,7,1,1,21,5,16,22,7,5,0,2,11,5,6,15,Q,EU_CL,Old Trafford,Manchester
2003/04,15,4,Chelsea,3,16,11,3,2,30,12,18,36,8,6,1,1,17,7,10,19,8,5,2,1,13,5,8,17,Q,EU_CL,Stamford Bridge,London
2003/04,15,34,Fulham,4,16,7,4,5,28,22,6,25,8,4,2,2,14,10,4,14,8,3,2,3,14,12,2,11,Q,EU_CL,Loftus Road,London
2003/04,15,23,Newcastle United,5,16,6,6,4,25,20,5,24,9,4,3,2,14,5,9,15,7,2,3,2,11,15,-4,9,Q,EU_UC,Sports Direct Arena,Newcastle
2003/04,15,20,Southampton,6,16,6,5,5,15,12,3,23,8,4,1,3,8,6,2,13,8,2,4,2,7,6,1,10,,,The Friends Provident St Mary's Stadium,Southampton
2003/04,15,31,Charlton Athletic,7,16,6,5,5,22,20,2,23,7,2,2,3,9,12,-3,8,9,4,3,2,13,8,5,15,,,The Valley,London
2003/04,15,35,Birmingham City,8,16,6,5,5,14,18,-4,23,8,2,3,3,6,11,-5,9,8,4,2,2,8,7,1,14,,,St Andrews,Birmingham
2003/04,15,10,Liverpool,9,16,6,4,6,23,18,5,22,8,3,1,4,12,11,1,10,8,3,3,2,11,7,4,12,,,Anfield,Liverpool
2003/04,15,27,Bolton Wanderers,10,16,5,6,5,16,22,-6,21,7,2,4,1,7,4,3,10,9,3,2,4,9,18,-9,11,,,Macron Stadium,Bolton
2003/04,15,13,Middlesbrough,11,16,5,5,6,12,15,-3,20,9,2,3,4,6,10,-4,9,7,3,2,2,6,5,1,11,Q,EU_UC,Riverside Stadium,Middlesbrough
2003/04,15,11,Manchester City,12,16,5,4,7,23,22,1,19,7,2,2,3,12,10,2,8,9,3,2,4,11,12,-1,11,,,Etihad Stadium,Manchester
2003/04,15,21,Tottenham Hotspur,13,16,5,3,8,18,24,-6,18,8,4,1,3,13,11,2,13,8,1,2,5,5,13,-8,5,,,White Hart Lane,London
2003/04,15,3,Blackburn Rovers,14,16,5,2,9,23,25,-2,17,7,3,0,4,11,11,0,9,9,2,2,5,12,14,-2,8,,,Ewood Park,Blackburn
2003/04,15,7,Everton,15,16,4,5,7,17,20,-3,17,8,3,3,2,11,7,4,12,8,1,2,5,6,13,-7,5,,,Goodison Park,Liverpool
2003/04,15,2,Aston Villa,16,16,4,5,7,14,23,-9,17,8,4,3,1,10,7,3,15,8,0,2,6,4,16,-12,2,,,Villa Park,Birmingham
2003/04,15,26,Leicester City,17,16,4,4,8,23,25,-2,16,9,2,4,3,12,12,0,10,7,2,0,5,11,13,-2,6,,,King Power Stadium,Leicester
2003/04,15,37,Portsmouth,18,16,4,4,8,18,22,-4,16,8,4,0,4,16,10,6,12,8,0,4,4,2,12,-10,4,R,EN_D1,Fratton Park,Portsmouth
2003/04,15,9,Leeds United,19,16,4,3,9,16,36,-20,15,9,2,3,4,9,15,-6,9,7,2,0,5,7,21,-14,6,R,EN_D1,Elland Road,Leeds
2003/04,15,38,Wolverhampton Wanderers,20,16,2,5,9,13,35,-22,11,7,2,3,2,7,14,-7,9,9,0,2,7,6,21,-15,2,R,EN_D1,Molineux,Wolverhampton
2003/04,16,12,Manchester United,1,17,13,1,3,34,11,23,40,9,7,1,1,21,5,16,22,8,6,0,2,13,6,7,18,Q,EU_CL,Old Trafford,Manchester
2003/04,16,1,Arsenal,2,17,11,6,0,31,12,19,39,8,6,2,0,13,6,7,20,9,5,4,0,18,6,12,19,Q,EU_CL,Highbury,London
2003/04,16,4,Chelsea,3,17,12,3,2,31,12,19,39,8,6,1,1,17,7,10,19,9,6,2,1,14,5,9,20,Q,EU_CL,Stamford Bridge,London
2003/04,16,20,Southampton,4,17,7,5,5,18,12,6,26,9,5,1,3,11,6,5,16,8,2,4,2,7,6,1,10,Q,EU_CL,The Friends Provident St Mary's Stadium,Southampton
2003/04,16,34,Fulham,5,17,7,4,6,28,23,5,25,9,4,2,3,14,11,3,14,8,3,2,3,14,12,2,11,Q,EU_UC,Loftus Road,London
2003/04,16,23,Newcastle United,6,17,6,7,4,25,20,5,25,9,4,3,2,14,5,9,15,8,2,4,2,11,15,-4,10,,,Sports Direct Arena,Newcastle
2003/04,16,31,Charlton Athletic,7,17,6,6,5,22,20,2,24,8,2,3,3,9,12,-3,9,9,4,3,2,13,8,5,15,,,The Valley,London
2003/04,16,35,Birmingham City,8,16,6,5,5,14,18,-4,23,8,2,3,3,6,11,-5,9,8,4,2,2,8,7,1,14,,,St Andrews,Birmingham
2003/04,16,10,Liverpool,9,16,6,4,6,23,18,5,22,8,3,1,4,12,11,1,10,8,3,3,2,11,7,4,12,,,Anfield,Liverpool
2003/04,16,27,Bolton Wanderers,10,17,5,7,5,17,23,-6,22,8,2,5,1,8,5,3,11,9,3,2,4,9,18,-9,11,,,Macron Stadium,Bolton
2003/04,16,11,Manchester City,11,17,5,5,7,24,23,1,20,8,2,3,3,13,11,2,9,9,3,2,4,11,12,-1,11,,,Etihad Stadium,Manchester
2003/04,16,7,Everton,12,17,5,5,7,20,22,-2,20,9,4,3,2,14,9,5,15,8,1,2,5,6,13,-7,5,,,Goodison Park,Liverpool
2003/04,16,13,Middlesbrough,13,16,5,5,6,12,15,-3,20,9,2,3,4,6,10,-4,9,7,3,2,2,6,5,1,11,Q,EU_UC,Riverside Stadium,Middlesbrough
2003/04,16,2,Aston Villa,14,17,5,5,7,16,23,-7,20,8,4,3,1,10,7,3,15,9,1,2,6,6,16,-10,5,,,Villa Park,Birmingham
2003/04,16,21,Tottenham Hotspur,15,17,5,3,9,19,26,-7,18,9,4,1,4,14,13,1,13,8,1,2,5,5,13,-8,5,,,White Hart Lane,London
2003/04,16,3,Blackburn Rovers,16,17,5,2,10,23,27,-4,17,8,3,0,5,11,13,-2,9,9,2,2,5,12,14,-2,8,,,Ewood Park,Blackburn
2003/04,16,26,Leicester City,17,17,4,4,9,25,28,-3,16,9,2,4,3,12,12,0,10,8,2,0,6,13,16,-3,6,,,King Power Stadium,Leicester
2003/04,16,37,Portsmouth,18,17,4,4,9,18,25,-7,16,8,4,0,4,16,10,6,12,9,0,4,5,2,15,-13,4,R,EN_D1,Fratton Park,Portsmouth
2003/04,16,9,Leeds United,19,17,4,4,9,17,37,-20,16,9,2,3,4,9,15,-6,9,8,2,1,5,8,22,-14,7,R,EN_D1,Elland Road,Leeds
2003/04,16,38,Wolverhampton Wanderers,20,16,2,5,9,13,35,-22,11,7,2,3,2,7,14,-7,9,9,0,2,7,6,21,-15,2,R,EN_D1,Molineux,Wolverhampton
2003/04,17,12,Manchester United,1,18,14,1,3,37,13,24,43,10,8,1,1,24,7,17,25,8,6,0,2,13,6,7,18,Q,EU_CL,Old Trafford,Manchester
2003/04,17,1,Arsenal,2,18,12,6,0,34,12,22,42,9,7,2,0,16,6,10,23,9,5,4,0,18,6,12,19,Q,EU_CL,Highbury,London
2003/04,17,4,Chelsea,3,18,12,3,3,33,16,17,39,8,6,1,1,17,7,10,19,10,6,2,2,16,9,7,20,Q,EU_CL,Stamford Bridge,London
2003/04,17,34,Fulham,4,18,8,4,6,30,23,7,28,10,5,2,3,16,11,5,17,8,3,2,3,14,12,2,11,Q,EU_CL,Loftus Road,London
2003/04,17,31,Charlton Athletic,5,18,7,6,5,26,22,4,27,9,3,3,3,13,14,-1,12,9,4,3,2,13,8,5,15,Q,EU_UC,The Valley,London
2003/04,17,23,Newcastle United,6,18,6,8,4,26,21,5,26,9,4,3,2,14,5,9,15,9,2,5,2,12,16,-4,11,,,Sports Direct Arena,Newcastle
2003/04,17,20,Southampton,7,18,7,5,6,18,14,4,26,9,5,1,3,11,6,5,16,9,2,4,3,7,8,-1,10,,,The Friends Provident St Mary's Stadium,Southampton
2003/04,17,35,Birmingham City,8,17,7,5,5,16,19,-3,26,9,3,3,3,8,12,-4,12,8,4,2,2,8,7,1,14,,,St Andrews,Birmingham
2003/04,17,10,Liverpool,9,17,7,4,6,26,19,7,25,9,4,1,4,15,12,3,13,8,3,3,2,11,7,4,12,,,Anfield,Liverpool
2003/04,17,27,Bolton Wanderers,10,18,5,7,6,18,26,-8,22,8,2,5,1,8,5,3,11,10,3,2,5,10,21,-11,11,,,Macron Stadium,Bolton
2003/04,17,13,Middlesbrough,11,17,5,6,6,14,17,-3,21,9,2,3,4,6,10,-4,9,8,3,3,2,8,7,1,12,Q,EU_UC,Riverside Stadium,Middlesbrough
2003/04,17,2,Aston Villa,12,18,5,6,7,16,23,-7,21,8,4,3,1,10,7,3,15,10,1,3,6,6,16,-10,6,,,Villa Park,Birmingham
2003/04,17,11,Manchester City,13,18,5,5,8,25,25,0,20,8,2,3,3,13,11,2,9,10,3,2,5,12,14,-2,11,,,Etihad Stadium,Manchester
2003/04,17,7,Everton,14,18,5,5,8,22,25,-3,20,9,4,3,2,14,9,5,15,9,1,2,6,8,16,-8,5,,,Goodison Park,Liverpool
2003/04,17,37,Portsmouth,15,18,5,4,9,20,25,-5,19,9,5,0,4,18,10,8,15,9,0,4,5,2,15,-13,4,,,Fratton Park,Portsmouth
2003/04,17,3,Blackburn Rovers,16,18,5,3,10,25,29,-4,18,9,3,1,5,13,15,-2,10,9,2,2,5,12,14,-2,8,,,Ewood Park,Blackburn
2003/04,17,21,Tottenham Hotspur,17,18,5,3,10,19,28,-9,18,9,4,1,4,14,13,1,13,9,1,2,6,5,15,-10,5,,,White Hart Lane,London
2003/04,17,26,Leicester City,18,18,4,5,9,26,29,-3,17,10,2,5,3,13,13,0,11,8,2,0,6,13,16,-3,6,R,EN_D1,King Power Stadium,Leicester
2003/04,17,9,Leeds United,19,18,4,5,9,17,37,-20,17,10,2,4,4,9,15,-6,10,8,2,1,5,8,22,-14,7,R,EN_D1,Elland Road,Leeds
2003/04,17,38,Wolverhampton Wanderers,20,17,2,5,10,13,38,-25,11,7,2,3,2,7,14,-7,9,10,0,2,8,6,24,-18,2,R,EN_D1,Molineux,Wolverhampton
2003/04,18,12,Manchester United,1,19,15,1,3,38,13,25,46,10,8,1,1,24,7,17,25,9,7,0,2,14,6,8,21,Q,EU_CL,Old Trafford,Manchester
2003/04,18,1,Arsenal,2,19,13,6,0,35,12,23,45,9,7,2,0,16,6,10,23,10,6,4,0,19,6,13,22,Q,EU_CL,Highbury,London
2003/04,18,4,Chelsea,3,19,13,3,3,36,16,20,42,9,7,1,1,20,7,13,22,10,6,2,2,16,9,7,20,Q,EU_CL,Stamford Bridge,London
2003/04,18,31,Charlton Athletic,4,19,8,6,5,27,22,5,30,9,3,3,3,13,14,-1,12,10,5,3,2,14,8,6,18,Q,EU_CL,The Valley,London
2003/04,18,34,Fulham,5,19,8,4,7,30,26,4,28,10,5,2,3,16,11,5,17,9,3,2,4,14,15,-1,11,Q,EU_UC,Loftus Road,London
2003/04,18,10,Liverpool,6,18,7,5,6,28,21,7,26,9,4,1,4,15,12,3,13,9,3,4,2,13,9,4,13,,,Anfield,Liverpool
2003/04,18,23,Newcastle United,7,19,6,8,5,26,22,4,26,10,4,3,3,14,6,8,15,9,2,5,2,12,16,-4,11,,,Sports Direct Arena,Newcastle
2003/04,18,20,Southampton,8,19,7,5,7,18,15,3,26,10,5,1,4,11,7,4,16,9,2,4,3,7,8,-1,10,,,The Friends Provident St Mary's Stadium,Southampton
2003/04,18,35,Birmingham City,9,18,7,5,6,16,20,-4,26,9,3,3,3,8,12,-4,12,9,4,2,3,8,8,0,14,,,St Andrews,Birmingham
2003/04,18,2,Aston Villa,10,19,6,6,7,19,23,-4,24,9,5,3,1,13,7,6,18,10,1,3,6,6,16,-10,6,,,Villa Park,Birmingham
2003/04,18,7,Everton,11,19,6,5,8,23,25,-2,23,10,5,3,2,15,9,6,18,9,1,2,6,8,16,-8,5,,,Goodison Park,Liverpool
2003/04,18,27,Bolton Wanderers,12,19,5,8,6,20,28,-8,23,9,2,6,1,10,7,3,12,10,3,2,5,10,21,-11,11,,,Macron Stadium,Bolton
2003/04,18,11,Manchester City,13,19,5,6,8,27,27,0,21,9,2,4,3,15,13,2,10,10,3,2,5,12,14,-2,11,,,Etihad Stadium,Manchester
2003/04,18,3,Blackburn Rovers,14,19,6,3,10,26,29,-3,21,9,3,1,5,13,15,-2,10,10,3,2,5,13,14,-1,11,,,Ewood Park,Blackburn
2003/04,18,13,Middlesbrough,15,18,5,6,7,14,18,-4,21,10,2,3,5,6,11,-5,9,8,3,3,2,8,7,1,12,Q,EU_UC,Riverside Stadium,Middlesbrough
2003/04,18,37,Portsmouth,16,19,5,4,10,20,28,-8,19,9,5,0,4,18,10,8,15,10,0,4,6,2,18,-16,4,,,Fratton Park,Portsmouth
2003/04,18,26,Leicester City,17,19,4,6,9,28,31,-3,18,10,2,5,3,13,13,0,11,9,2,1,6,15,18,-3,7,,,King Power Stadium,Leicester
2003/04,18,21,Tottenham Hotspur,18,19,5,3,11,19,29,-10,18,10,4,1,5,14,14,0,13,9,1,2,6,5,15,-10,5,R,EN_D1,White Hart Lane,London
2003/04,18,9,Leeds United,19,19,4,5,10,18,40,-22,17,10,2,4,4,9,15,-6,10,9,2,1,6,9,25,-16,7,R,EN_D1,Elland Road,Leeds
2003/04,18,38,Wolverhampton Wanderers,20,18,3,5,10,16,39,-23,14,8,3,3,2,10,15,-5,12,10,0,2,8,6,24,-18,2,R,EN_D1,Molineux,Wolverhampton
2003/04,19,12,Manchester United,1,20,16,1,3,40,14,26,49,10,8,1,1,24,7,17,25,10,8,0,2,16,7,9,24,Q,EU_CL,Old Trafford,Manchester
2003/04,19,1,Arsenal,2,20,13,7,0,36,13,23,46,9,7,2,0,16,6,10,23,11,6,5,0,20,7,13,23,Q,EU_CL,Highbury,London
2003/04,19,4,Chelsea,3,20,13,3,4,36,17,19,42,10,7,1,2,20,8,12,22,10,6,2,2,16,9,7,20,Q,EU_CL,Stamford Bridge,London
2003/04,19,31,Charlton Athletic,4,20,8,7,5,28,23,5,31,9,3,3,3,13,14,-1,12,11,5,4,2,15,9,6,19,Q,EU_CL,The Valley,London
2003/04,19,10,Liverpool,5,19,8,5,6,29,21,8,29,9,4,1,4,15,12,3,13,10,4,4,2,14,9,5,16,Q,EU_UC,Anfield,Liverpool
2003/04,19,23,Newcastle United,6,20,7,8,5,27,22,5,29,11,5,3,3,15,6,9,18,9,2,5,2,12,16,-4,11,,,Sports Direct Arena,Newcastle
2003/04,19,34,Fulham,7,20,8,4,8,31,28,3,28,10,5,2,3,16,11,5,17,10,3,2,5,15,17,-2,11,,,Loftus Road,London
2003/04,19,20,Southampton,8,20,7,6,7,18,15,3,27,11,5,2,4,11,7,4,17,9,2,4,3,7,8,-1,10,,,The Friends Provident St Mary's Stadium,Southampton
2003/04,19,2,Aston Villa,9,20,7,6,7,21,24,-3,27,10,6,3,1,15,8,7,21,10,1,3,6,6,16,-10,6,,,Villa Park,Birmingham
2003/04,19,35,Birmingham City,10,19,7,5,7,17,24,-7,26,9,3,3,3,8,12,-4,12,10,4,2,4,9,12,-3,14,,,St Andrews,Birmingham
2003/04,19,7,Everton,11,20,6,6,8,24,26,-2,24,11,5,4,2,16,10,6,19,9,1,2,6,8,16,-8,5,,,Goodison Park,Liverpool
2003/04,19,13,Middlesbrough,12,19,6,6,7,16,19,-3,24,11,3,3,5,8,12,-4,12,8,3,3,2,8,7,1,12,Q,EU_UC,Riverside Stadium,Middlesbrough
2003/04,19,27,Bolton Wanderers,13,20,5,8,7,21,30,-9,23,10,2,6,2,11,9,2,12,10,3,2,5,10,21,-11,11,,,Macron Stadium,Bolton
2003/04,19,11,Manchester City,14,20,5,7,8,28,28,0,22,10,2,5,3,16,14,2,11,10,3,2,5,12,14,-2,11,,,Etihad Stadium,Manchester
2003/04,19,3,Blackburn Rovers,15,20,6,4,10,28,31,-3,22,9,3,1,5,13,15,-2,10,11,3,3,5,15,16,-1,12,,,Ewood Park,Blackburn
2003/04,19,21,Tottenham Hotspur,16,20,6,3,11,23,30,-7,21,11,5,1,5,18,15,3,16,9,1,2,6,5,15,-10,5,,,White Hart Lane,London
2003/04,19,26,Leicester City,17,20,4,7,9,28,31,-3,19,10,2,5,3,13,13,0,11,10,2,2,6,15,18,-3,8,,,King Power Stadium,Leicester
2003/04,19,37,Portsmouth,18,20,5,4,11,21,30,-9,19,9,5,0,4,18,10,8,15,11,0,4,7,3,20,-17,4,R,EN_D1,Fratton Park,Portsmouth
2003/04,19,9,Leeds United,19,20,4,5,11,18,41,-23,17,10,2,4,4,9,15,-6,10,10,2,1,7,9,26,-17,7,R,EN_D1,Elland Road,Leeds
2003/04,19,38,Wolverhampton Wanderers,20,19,3,6,10,18,41,-23,15,9,3,4,2,12,17,-5,13,10,0,2,8,6,24,-18,2,R,EN_D1,Molineux,Wolverhampton
2003/04,20,12,Manchester United,1,21,16,2,3,40,14,26,50,11,8,2,1,24,7,17,26,10,8,0,2,16,7,9,24,Q,EU_CL,Old Trafford,Manchester
2003/04,20,1,Arsenal,2,21,14,7,0,40,14,26,49,10,8,2,0,20,7,13,26,11,6,5,0,20,7,13,23,Q,EU_CL,Highbury,London
2003/04,20,4,Chelsea,3,21,14,3,4,40,17,23,45,10,7,1,2,20,8,12,22,11,7,2,2,20,9,11,23,Q,EU_CL,Stamford Bridge,London
2003/04,20,31,Charlton Athletic,4,21,9,7,5,30,23,7,34,10,4,3,3,15,14,1,15,11,5,4,2,15,9,6,19,Q,EU_CL,The Valley,London
2003/04,20,10,Liverpool,5,20,9,5,6,30,21,9,32,10,5,1,4,16,12,4,16,10,4,4,2,14,9,5,16,Q,EU_UC,Anfield,Liverpool
2003/04,20,34,Fulham,6,21,9,4,8,33,29,4,31,11,6,2,3,18,12,6,20,10,3,2,5,15,17,-2,11,,,Loftus Road,London
2003/04,20,23,Newcastle United,7,21,7,9,5,27,22,5,30,11,5,3,3,15,6,9,18,10,2,6,2,12,16,-4,12,,,Sports Direct Arena,Newcastle
2003/04,20,35,Birmingham City,8,20,8,5,7,19,25,-6,29,10,4,3,3,10,13,-3,15,10,4,2,4,9,12,-3,14,,,St Andrews,Birmingham
2003/04,20,20,Southampton,9,21,7,6,8,19,17,2,27,11,5,2,4,11,7,4,17,10,2,4,4,8,10,-2,10,,,The Friends Provident St Mary's Stadium,Southampton
2003/04,20,2,Aston Villa,10,21,7,6,8,21,25,-4,27,10,6,3,1,15,8,7,21,11,1,3,7,6,17,-11,6,,,Villa Park,Birmingham
2003/04,20,27,Bolton Wanderers,11,21,6,8,7,25,33,-8,26,10,2,6,2,11,9,2,12,11,4,2,5,14,24,-10,14,,,Macron Stadium,Bolton
2003/04,20,7,Everton,12,21,6,6,9,25,28,-3,24,11,5,4,2,16,10,6,19,10,1,2,7,9,18,-9,5,,,Goodison Park,Liverpool
2003/04,20,21,Tottenham Hotspur,13,21,7,3,11,24,30,-6,24,11,5,1,5,18,15,3,16,10,2,2,6,6,15,-9,8,,,White Hart Lane,London
2003/04,20,13,Middlesbrough,14,20,6,6,8,17,23,-6,24,11,3,3,5,8,12,-4,12,9,3,3,3,9,11,-2,12,Q,EU_UC,Riverside Stadium,Middlesbrough
2003/04,20,11,Manchester City,15,21,5,7,9,30,32,-2,22,10,2,5,3,16,14,2,11,11,3,2,6,14,18,-4,11,,,Etihad Stadium,Manchester
2003/04,20,3,Blackburn Rovers,16,21,6,4,11,31,35,-4,22,10,3,1,6,16,19,-3,10,11,3,3,5,15,16,-1,12,,,Ewood Park,Blackburn
2003/04,20,37,Portsmouth,17,21,6,4,11,25,32,-7,22,10,6,0,4,22,12,10,18,11,0,4,7,3,20,-17,4,,,Fratton Park,Portsmouth
2003/04,20,26,Leicester City,18,21,4,7,10,28,35,-7,19,11,2,5,4,13,17,-4,11,10,2,2,6,15,18,-3,8,R,EN_D1,King Power Stadium,Leicester
2003/04,20,9,Leeds United,19,21,4,5,12,18,42,-24,17,11,2,4,5,9,16,-7,10,10,2,1,7,9,26,-17,7,R,EN_D1,Elland Road,Leeds
2003/04,20,38,Wolverhampton Wanderers,20,20,3,6,11,18,43,-25,15,9,3,4,2,12,17,-5,13,11,0,2,9,6,26,-20,2,R,EN_D1,Molineux,Wolverhampton
2003/04,21,1,Arsenal,1,22,15,7,0,42,14,28,52,10,8,2,0,20,7,13,26,12,7,5,0,22,7,15,26,Q,EU_CL,Highbury,London
2003/04,21,12,Manchester United,2,22,16,2,4,40,15,25,50,11,8,2,1,24,7,17,26,11,8,0,3,16,8,8,24,Q,EU_CL,Old Trafford,Manchester
2003/04,21,4,Chelsea,3,22,14,4,4,40,17,23,46,11,7,2,2,20,8,12,23,11,7,2,2,20,9,11,23,Q,EU_CL,Stamford Bridge,London
2003/04,21,31,Charlton Athletic,4,22,10,7,5,31,23,8,37,10,4,3,3,15,14,1,15,12,6,4,2,16,9,7,22,Q,EU_CL,The Valley,London
2003/04,21,10,Liverpool,5,22,9,6,7,32,24,8,33,10,5,1,4,16,12,4,16,12,4,5,3,16,12,4,17,Q,EU_UC,Anfield,Liverpool
2003/04,21,23,Newcastle United,6,22,8,9,5,30,23,7,33,12,6,3,3,18,7,11,21,10,2,6,2,12,16,-4,12,,,Sports Direct Arena,Newcastle
2003/04,21,34,Fulham,7,22,9,4,9,34,32,2,31,11,6,2,3,18,12,6,20,11,3,2,6,16,20,-4,11,,,Loftus Road,London
2003/04,21,20,Southampton,8,22,8,6,8,21,18,3,30,12,6,2,4,13,8,5,20,10,2,4,4,8,10,-2,10,,,The Friends Provident St Mary's Stadium,Southampton
2003/04,21,35,Birmingham City,9,21,8,6,7,19,25,-6,30,10,4,3,3,10,13,-3,15,11,4,3,4,9,12,-3,15,,,St Andrews,Birmingham
2003/04,21,27,Bolton Wanderers,10,22,7,8,7,26,33,-7,29,11,3,6,2,12,9,3,15,11,4,2,5,14,24,-10,14,,,Macron Stadium,Bolton
2003/04,21,21,Tottenham Hotspur,11,22,8,3,11,26,31,-5,27,12,6,1,5,20,16,4,19,10,2,2,6,6,15,-9,8,,,White Hart Lane,London
2003/04,21,2,Aston Villa,12,22,7,6,9,21,27,-6,27,11,6,3,2,15,10,5,21,11,1,3,7,6,17,-11,6,,,Villa Park,Birmingham
2003/04,21,13,Middlesbrough,13,21,6,7,8,20,26,-6,25,12,3,4,5,11,15,-4,13,9,3,3,3,9,11,-2,12,Q,EU_UC,Riverside Stadium,Middlesbrough
2003/04,21,7,Everton,14,22,6,6,10,25,29,-4,24,12,5,4,3,16,11,5,19,10,1,2,7,9,18,-9,5,,,Goodison Park,Liverpool
2003/04,21,11,Manchester City,15,22,5,8,9,31,33,-2,23,11,2,6,3,17,15,2,12,11,3,2,6,14,18,-4,11,,,Etihad Stadium,Manchester
2003/04,21,3,Blackburn Rovers,16,22,6,5,11,32,36,-4,23,10,3,1,6,16,19,-3,10,12,3,4,5,16,17,-1,13,,,Ewood Park,Blackburn
2003/04,21,37,Portsmouth,17,22,6,4,12,25,33,-8,22,10,6,0,4,22,12,10,18,12,0,4,8,3,21,-18,4,,,Fratton Park,Portsmouth
2003/04,21,26,Leicester City,18,22,4,8,10,31,38,-7,20,11,2,5,4,13,17,-4,11,11,2,3,6,18,21,-3,9,R,EN_D1,King Power Stadium,Leicester
2003/04,21,38,Wolverhampton Wanderers,19,22,4,7,11,20,44,-24,19,11,4,5,2,14,18,-4,17,11,0,2,9,6,26,-20,2,R,EN_D1,Molineux,Wolverhampton
2003/04,21,9,Leeds United,20,22,4,5,13,19,44,-25,17,11,2,4,5,9,16,-7,10,11,2,1,8,10,28,-18,7,R,EN_D1,Elland Road,Leeds
2003/04,22,1,Arsenal,1,23,16,7,0,44,15,29,55,11,9,2,0,22,8,14,29,12,7,5,0,22,7,15,26,Q,EU_CL,Highbury,London
2003/04,22,12,Manchester United,2,23,17,2,4,43,17,26,53,12,9,2,1,27,9,18,29,11,8,0,3,16,8,8,24,Q,EU_CL,Old Trafford,Manchester
2003/04,22,4,Chelsea,3,23,15,4,4,43,19,24,49,11,7,2,2,20,8,12,23,12,8,2,2,23,11,12,26,Q,EU_CL,Stamford Bridge,London
2003/04,22,31,Charlton Athletic,4,23,10,7,6,32,25,7,37,11,4,3,4,16,16,0,15,12,6,4,2,16,9,7,22,Q,EU_CL,The Valley,London
2003/04,22,10,Liverpool,5,23,9,7,7,32,24,8,34,11,5,2,4,16,12,4,17,12,4,5,3,16,12,4,17,Q,EU_UC,Anfield,Liverpool
2003/04,22,23,Newcastle United,6,23,8,10,5,31,24,7,34,12,6,3,3,18,7,11,21,11,2,7,2,13,17,-4,13,,,Sports Direct Arena,Newcastle
2003/04,22,34,Fulham,7,23,10,4,9,36,33,3,34,12,7,2,3,20,13,7,23,11,3,2,6,16,20,-4,11,,,Loftus Road,London
2003/04,22,27,Bolton Wanderers,8,23,8,8,7,28,34,-6,32,11,3,6,2,12,9,3,15,12,5,2,5,16,25,-9,17,,,Macron Stadium,Bolton
2003/04,22,35,Birmingham City,9,22,8,7,7,20,26,-6,31,11,4,4,3,11,14,-3,16,11,4,3,4,9,12,-3,15,,,St Andrews,Birmingham
2003/04,22,20,Southampton,10,23,8,6,9,23,21,2,30,12,6,2,4,13,8,5,20,11,2,4,5,10,13,-3,10,,,The Friends Provident St Mary's Stadium,Southampton
2003/04,22,2,Aston Villa,11,23,8,6,9,26,27,-1,30,11,6,3,2,15,10,5,21,12,2,3,7,11,17,-6,9,,,Villa Park,Birmingham
2003/04,22,13,Middlesbrough,12,22,7,7,8,23,26,-3,28,12,3,4,5,11,15,-4,13,10,4,3,3,12,11,1,15,Q,EU_UC,Riverside Stadium,Middlesbrough
2003/04,22,21,Tottenham Hotspur,13,23,8,3,12,27,33,-6,27,12,6,1,5,20,16,4,19,11,2,2,7,7,17,-10,8,,,White Hart Lane,London
2003/04,22,7,Everton,14,23,6,7,10,25,29,-4,25,12,5,4,3,16,11,5,19,11,1,3,7,9,18,-9,6,,,Goodison Park,Liverpool
2003/04,22,11,Manchester City,15,23,5,8,10,32,35,-3,23,11,2,6,3,17,15,2,12,12,3,2,7,15,20,-5,11,,,Etihad Stadium,Manchester
2003/04,22,3,Blackburn Rovers,16,23,6,5,12,34,39,-5,23,11,3,1,7,18,22,-4,10,12,3,4,5,16,17,-1,13,,,Ewood Park,Blackburn
2003/04,22,37,Portsmouth,17,23,6,5,12,25,33,-8,23,11,6,1,4,22,12,10,19,12,0,4,8,3,21,-18,4,,,Fratton Park,Portsmouth
2003/04,22,26,Leicester City,18,23,4,8,11,31,43,-12,20,12,2,5,5,13,22,-9,11,11,2,3,6,18,21,-3,9,R,EN_D1,King Power Stadium,Leicester
2003/04,22,38,Wolverhampton Wanderers,19,23,4,8,11,20,44,-24,20,11,4,5,2,14,18,-4,17,12,0,3,9,6,26,-20,3,R,EN_D1,Molineux,Wolverhampton
2003/04,22,9,Leeds United,20,23,4,5,14,19,47,-28,17,12,2,4,6,9,19,-10,10,11,2,1,8,10,28,-18,7,R,EN_D1,Elland Road,Leeds
2003/04,23,1,Arsenal,1,24,17,7,0,47,16,31,58,11,9,2,0,22,8,14,29,13,8,5,0,25,8,17,29,Q,EU_CL,Highbury,London
2003/04,23,12,Manchester United,2,24,18,2,4,47,20,27,56,12,9,2,1,27,9,18,29,12,9,0,3,20,11,9,27,Q,EU_CL,Old Trafford,Manchester
2003/04,23,4,Chelsea,3,24,16,4,4,44,19,25,52,12,8,2,2,21,8,13,26,12,8,2,2,23,11,12,26,Q,EU_CL,Stamford Bridge,London
2003/04,23,23,Newcastle United,4,24,9,10,5,34,25,9,37,13,7,3,3,21,8,13,24,11,2,7,2,13,17,-4,13,Q,EU_CL,Sports Direct Arena,Newcastle
2003/04,23,31,Charlton Athletic,5,24,10,7,7,32,26,6,37,11,4,3,4,16,16,0,15,13,6,4,3,16,10,6,22,Q,EU_UC,The Valley,London
2003/04,23,10,Liverpool,6,24,9,8,7,34,26,8,35,11,5,2,4,16,12,4,17,13,4,6,3,18,14,4,18,,,Anfield,Liverpool
2003/04,23,34,Fulham,7,24,10,5,9,36,33,3,35,12,7,2,3,20,13,7,23,12,3,3,6,16,20,-4,12,,,Loftus Road,London
2003/04,23,2,Aston Villa,8,24,9,6,9,28,27,1,33,12,7,3,2,17,10,7,24,12,2,3,7,11,17,-6,9,,,Villa Park,Birmingham
2003/04,23,27,Bolton Wanderers,9,24,8,9,7,30,36,-6,33,12,3,7,2,14,11,3,16,12,5,2,5,16,25,-9,17,,,Macron Stadium,Bolton
2003/04,23,35,Birmingham City,10,23,8,8,7,20,26,-6,32,11,4,4,3,11,14,-3,16,12,4,4,4,9,12,-3,16,,,St Andrews,Birmingham
2003/04,23,20,Southampton,11,24,8,7,9,23,21,2,31,13,6,3,4,13,8,5,21,11,2,4,5,10,13,-3,10,,,The Friends Provident St Mary's Stadium,Southampton
2003/04,23,21,Tottenham Hotspur,12,24,9,3,12,31,36,-5,30,13,7,1,5,24,19,5,22,11,2,2,7,7,17,-10,8,,,White Hart Lane,London
2003/04,23,13,Middlesbrough,13,23,7,7,9,23,27,-4,28,13,3,4,6,11,16,-5,13,10,4,3,3,12,11,1,15,Q,EU_UC,Riverside Stadium,Middlesbrough
2003/04,23,3,Blackburn Rovers,14,24,7,5,12,35,39,-4,26,11,3,1,7,18,22,-4,10,13,4,4,5,17,17,0,16,,,Ewood Park,Blackburn
2003/04,23,7,Everton,15,24,6,7,11,28,33,-5,25,13,5,4,4,19,15,4,19,11,1,3,7,9,18,-9,6,,,Goodison Park,Liverpool
2003/04,23,11,Manchester City,16,24,5,9,10,32,35,-3,24,12,2,7,3,17,15,2,13,12,3,2,7,15,20,-5,11,,,Etihad Stadium,Manchester
2003/04,23,37,Portsmouth,17,24,6,5,13,28,37,-9,23,11,6,1,4,22,12,10,19,13,0,4,9,6,25,-19,4,,,Fratton Park,Portsmouth
2003/04,23,26,Leicester City,18,24,4,8,12,32,46,-14,20,12,2,5,5,13,22,-9,11,12,2,3,7,19,24,-5,9,R,EN_D1,King Power Stadium,Leicester
2003/04,23,38,Wolverhampton Wanderers,19,24,4,8,12,21,47,-26,20,12,4,5,3,15,21,-6,17,12,0,3,9,6,26,-20,3,R,EN_D1,Molineux,Wolverhampton
2003/04,23,9,Leeds United,20,24,4,5,15,19,49,-30,17,12,2,4,6,9,19,-10,10,12,2,1,9,10,30,-20,7,R,EN_D1,Elland Road,Leeds
2003/04,24,1,Arsenal,1,25,18,7,0,49,16,33,61,12,10,2,0,24,8,16,32,13,8,5,0,25,8,17,29,Q,EU_CL,Highbury,London
2003/04,24,12,Manchester United,2,25,18,2,5,49,23,26,56,13,9,2,2,29,12,17,29,12,9,0,3,20,11,9,27,Q,EU_CL,Old Trafford,Manchester
2003/04,24,4,Chelsea,3,25,17,4,4,46,19,27,55,12,8,2,2,21,8,13,26,13,9,2,2,25,11,14,29,Q,EU_CL,Stamford Bridge,London
2003/04,24,10,Liverpool,4,25,10,8,7,36,27,9,38,12,6,2,4,18,13,5,20,13,4,6,3,18,14,4,18,Q,EU_CL,Anfield,Liverpool
2003/04,24,23,Newcastle United,5,25,9,11,5,35,26,9,38,13,7,3,3,21,8,13,24,12,2,8,2,14,18,-4,14,Q,EU_UC,Sports Direct Arena,Newcastle
2003/04,24,31,Charlton Athletic,6,25,10,7,8,34,30,4,37,12,4,3,5,18,20,-2,15,13,6,4,3,16,10,6,22,,,The Valley,London
2003/04,24,2,Aston Villa,7,25,10,6,9,30,28,2,36,12,7,3,2,17,10,7,24,13,3,3,7,13,18,-5,12,,,Villa Park,Birmingham
2003/04,24,34,Fulham,8,25,10,5,10,37,35,2,35,13,7,2,4,21,15,6,23,12,3,3,6,16,20,-4,12,,,Loftus Road,London
2003/04,24,35,Birmingham City,9,24,9,8,7,23,26,-3,35,12,5,4,3,14,14,0,19,12,4,4,4,9,12,-3,16,,,St Andrews,Birmingham
2003/04,24,27,Bolton Wanderers,10,25,8,10,7,31,37,-6,34,12,3,7,2,14,11,3,16,13,5,3,5,17,26,-9,18,,,Macron Stadium,Bolton
2003/04,24,21,Tottenham Hotspur,11,25,10,3,12,35,38,-3,33,13,7,1,5,24,19,5,22,12,3,2,7,11,19,-8,11,,,White Hart Lane,London
2003/04,24,20,Southampton,12,25,8,7,10,23,23,0,31,13,6,3,4,13,8,5,21,12,2,4,6,10,15,-5,10,,,The Friends Provident St Mary's Stadium,Southampton
2003/04,24,13,Middlesbrough,13,24,8,7,9,26,29,-3,31,13,3,4,6,11,16,-5,13,11,5,3,3,15,13,2,18,Q,EU_UC,Riverside Stadium,Middlesbrough
2003/04,24,3,Blackburn Rovers,14,25,7,6,12,36,40,-4,27,12,3,2,7,19,23,-4,11,13,4,4,5,17,17,0,16,,,Ewood Park,Blackburn
2003/04,24,7,Everton,15,25,6,7,12,28,36,-8,25,13,5,4,4,19,15,4,19,12,1,3,8,9,21,-12,6,,,Goodison Park,Liverpool
2003/04,24,11,Manchester City,16,25,5,9,11,33,37,-4,24,12,2,7,3,17,15,2,13,13,3,2,8,16,22,-6,11,,,Etihad Stadium,Manchester
2003/04,24,37,Portsmouth,17,25,6,5,14,28,39,-11,23,12,6,1,5,22,14,8,19,13,0,4,9,6,25,-19,4,,,Fratton Park,Portsmouth
2003/04,24,26,Leicester City,18,25,4,9,12,33,47,-14,21,13,2,6,5,14,23,-9,12,12,2,3,7,19,24,-5,9,R,EN_D1,King Power Stadium,Leicester
2003/04,24,9,Leeds United,19,25,5,5,15,23,50,-27,20,13,3,4,6,13,20,-7,13,12,2,1,9,10,30,-20,7,R,EN_D1,Elland Road,Leeds
2003/04,24,38,Wolverhampton Wanderers,20,25,4,8,13,22,51,-29,20,12,4,5,3,15,21,-6,17,13,0,3,10,7,30,-23,3,R,EN_D1,Molineux,Wolverhampton
2003/04,25,1,Arsenal,1,26,19,7,0,51,17,34,64,12,10,2,0,24,8,16,32,14,9,5,0,27,9,18,32,Q,EU_CL,Highbury,London
2003/04,25,12,Manchester United,2,26,18,3,5,50,24,26,57,14,9,3,2,30,13,17,30,12,9,0,3,20,11,9,27,Q,EU_CL,Old Trafford,Manchester
2003/04,25,4,Chelsea,3,26,17,4,5,47,21,26,55,13,8,2,3,22,10,12,26,13,9,2,2,25,11,14,29,Q,EU_CL,Stamford Bridge,London
2003/04,25,23,Newcastle United,4,26,10,11,5,37,27,10,41,14,8,3,3,23,9,14,27,12,2,8,2,14,18,-4,14,Q,EU_CL,Sports Direct Arena,Newcastle
2003/04,25,31,Charlton Athletic,5,26,11,7,8,37,32,5,40,13,5,3,5,21,22,-1,18,13,6,4,3,16,10,6,22,Q,EU_UC,The Valley,London
2003/04,25,10,Liverpool,6,25,10,8,7,36,27,9,38,12,6,2,4,18,13,5,20,13,4,6,3,18,14,4,18,,,Anfield,Liverpool
2003/04,25,2,Aston Villa,7,26,10,7,9,32,30,2,37,13,7,4,2,19,12,7,25,13,3,3,7,13,18,-5,12,,,Villa Park,Birmingham
2003/04,25,35,Birmingham City,8,25,9,9,7,25,28,-3,36,12,5,4,3,14,14,0,19,13,4,5,4,11,14,-3,17,,,St Andrews,Birmingham
2003/04,25,34,Fulham,9,26,10,5,11,38,37,1,35,13,7,2,4,21,15,6,23,13,3,3,7,17,22,-5,12,,,Loftus Road,London
2003/04,25,21,Tottenham Hotspur,10,26,10,4,12,39,42,-3,34,14,7,2,5,28,23,5,23,12,3,2,7,11,19,-8,11,,,White Hart Lane,London
2003/04,25,27,Bolton Wanderers,11,26,8,10,8,32,40,-8,34,13,3,7,3,15,14,1,16,13,5,3,5,17,26,-9,18,,,Macron Stadium,Bolton
2003/04,25,20,Southampton,12,26,8,8,10,26,26,0,32,14,6,4,4,16,11,5,22,12,2,4,6,10,15,-5,10,,,The Friends Provident St Mary's Stadium,Southampton
2003/04,25,13,Middlesbrough,13,25,8,7,10,27,31,-4,31,13,3,4,6,11,16,-5,13,12,5,3,4,16,15,1,18,Q,EU_UC,Riverside Stadium,Middlesbrough
2003/04,25,11,Manchester City,14,26,6,9,11,36,38,-2,27,12,2,7,3,17,15,2,13,14,4,2,8,19,23,-4,14,,,Etihad Stadium,Manchester
2003/04,25,3,Blackburn Rovers,15,26,7,6,13,38,43,-5,27,12,3,2,7,19,23,-4,11,14,4,4,6,19,20,-1,16,,,Ewood Park,Blackburn
2003/04,25,7,Everton,16,26,6,8,12,31,39,-8,26,13,5,4,4,19,15,4,19,13,1,4,8,12,24,-12,7,,,Goodison Park,Liverpool
2003/04,25,37,Portsmouth,17,25,6,5,14,28,39,-11,23,12,6,1,5,22,14,8,19,13,0,4,9,6,25,-19,4,,,Fratton Park,Portsmouth
2003/04,25,38,Wolverhampton Wanderers,18,26,5,8,13,24,52,-28,23,13,5,5,3,17,22,-5,20,13,0,3,10,7,30,-23,3,R,EN_D1,Molineux,Wolverhampton
2003/04,25,26,Leicester City,19,26,4,10,12,37,51,-14,22,13,2,6,5,14,23,-9,12,13,2,4,7,23,28,-5,10,R,EN_D1,King Power Stadium,Leicester
2003/04,25,9,Leeds United,20,26,5,6,15,24,51,-27,21,13,3,4,6,13,20,-7,13,13,2,2,9,11,31,-20,8,R,EN_D1,Elland Road,Leeds
2003/04,26,1,Arsenal,1,27,20,7,0,53,18,35,67,13,11,2,0,26,9,17,35,14,9,5,0,27,9,18,32,Q,EU_CL,Highbury,London
2003/04,26,4,Chelsea,2,27,18,4,5,48,21,27,58,13,8,2,3,22,10,12,26,14,10,2,2,26,11,15,32,Q,EU_CL,Stamford Bridge,London
2003/04,26,12,Manchester United,3,27,18,4,5,51,25,26,58,14,9,3,2,30,13,17,30,13,9,1,3,21,12,9,28,Q,EU_CL,Old Trafford,Manchester
2003/04,26,23,Newcastle United,4,27,10,12,5,38,28,10,42,14,8,3,3,23,9,14,27,13,2,9,2,15,19,-4,15,Q,EU_CL,Sports Direct Arena,Newcastle
2003/04,26,35,Birmingham City,5,27,11,9,7,30,29,1,42,14,7,4,3,19,15,4,25,13,4,5,4,11,14,-3,17,Q,EU_UC,St Andrews,Birmingham
2003/04,26,31,Charlton Athletic,6,27,11,7,9,38,34,4,40,13,5,3,5,21,22,-1,18,14,6,4,4,17,12,5,22,,,The Valley,London
2003/04,26,10,Liverpool,7,26,10,9,7,38,29,9,39,12,6,2,4,18,13,5,20,14,4,7,3,20,16,4,19,,,Anfield,Liverpool
2003/04,26,2,Aston Villa,8,27,10,7,10,32,32,0,37,13,7,4,2,19,12,7,25,14,3,3,8,13,20,-7,12,,,Villa Park,Birmingham
2003/04,26,34,Fulham,9,27,10,6,11,39,38,1,36,14,7,3,4,22,16,6,24,13,3,3,7,17,22,-5,12,,,Loftus Road,London
2003/04,26,21,Tottenham Hotspur,10,27,10,4,13,39,43,-4,34,14,7,2,5,28,23,5,23,13,3,2,8,11,20,-9,11,,,White Hart Lane,London
2003/04,26,13,Middlesbrough,11,27,9,7,11,29,34,-5,34,14,4,4,6,12,16,-4,16,13,5,3,5,17,18,-1,18,Q,EU_UC,Riverside Stadium,Middlesbrough
2003/04,26,27,Bolton Wanderers,12,27,8,10,9,32,42,-10,34,13,3,7,3,15,14,1,16,14,5,3,6,17,28,-11,18,,,Macron Stadium,Bolton
2003/04,26,20,Southampton,13,27,8,9,10,27,27,0,33,14,6,4,4,16,11,5,22,13,2,5,6,11,16,-5,11,,,The Friends Provident St Mary's Stadium,Southampton
2003/04,26,7,Everton,14,27,7,8,12,33,39,-6,29,14,6,4,4,21,15,6,22,13,1,4,8,12,24,-12,7,,,Goodison Park,Liverpool
2003/04,26,3,Blackburn Rovers,15,27,7,7,13,39,44,-5,28,13,3,3,7,20,24,-4,12,14,4,4,6,19,20,-1,16,,,Ewood Park,Blackburn
2003/04,26,11,Manchester City,16,27,6,9,12,36,39,-3,27,13,2,7,4,17,16,1,13,14,4,2,8,19,23,-4,14,,,Etihad Stadium,Manchester
2003/04,26,37,Portsmouth,17,26,6,6,14,29,40,-11,24,13,6,2,5,23,15,8,20,13,0,4,9,6,25,-19,4,,,Fratton Park,Portsmouth
2003/04,26,38,Wolverhampton Wanderers,18,27,5,9,13,24,52,-28,24,13,5,5,3,17,22,-5,20,14,0,4,10,7,30,-23,4,R,EN_D1,Molineux,Wolverhampton
2003/04,26,26,Leicester City,19,27,4,11,12,37,51,-14,23,14,2,7,5,14,23,-9,13,13,2,4,7,23,28,-5,10,R,EN_D1,King Power Stadium,Leicester
2003/04,26,9,Leeds United,20,27,5,7,15,26,53,-27,22,14,3,5,6,15,22,-7,14,13,2,2,9,11,31,-20,8,R,EN_D1,Elland Road,Leeds
2003/04,27,1,Arsenal,1,28,21,7,0,55,18,37,70,13,11,2,0,26,9,17,35,15,10,5,0,29,9,20,35,Q,EU_CL,Highbury,London
2003/04,27,4,Chelsea,2,28,19,4,5,50,21,29,61,13,8,2,3,22,10,12,26,15,11,2,2,28,11,17,35,Q,EU_CL,Stamford Bridge,London
2003/04,27,12,Manchester United,3,28,18,4,6,52,29,23,58,14,9,3,2,30,13,17,30,14,9,1,4,22,16,6,28,Q,EU_CL,Old Trafford,Manchester
2003/04,27,31,Charlton Athletic,4,28,12,7,9,39,34,5,43,14,6,3,5,22,22,0,21,14,6,4,4,17,12,5,22,Q,EU_CL,The Valley,London
2003/04,27,10,Liverpool,5,28,11,9,8,41,31,10,42,13,7,2,4,21,13,8,23,15,4,7,4,20,18,2,19,Q,EU_UC,Anfield,Liverpool
2003/04,27,23,Newcastle United,6,28,10,12,6,38,29,9,42,14,8,3,3,23,9,14,27,14,2,9,3,15,20,-5,15,,,Sports Direct Arena,Newcastle
2003/04,27,35,Birmingham City,7,28,11,9,8,30,30,0,42,15,7,4,4,19,16,3,25,13,4,5,4,11,14,-3,17,,,St Andrews,Birmingham
2003/04,27,2,Aston Villa,8,28,11,7,10,36,32,4,40,13,7,4,2,19,12,7,25,15,4,3,8,17,20,-3,15,,,Villa Park,Birmingham
2003/04,27,34,Fulham,9,28,11,6,11,41,38,3,39,15,8,3,4,24,16,8,27,13,3,3,7,17,22,-5,12,,,Loftus Road,London
2003/04,27,21,Tottenham Hotspur,10,28,11,4,13,40,43,-3,37,15,8,2,5,29,23,6,26,13,3,2,8,11,20,-9,11,,,White Hart Lane,London
2003/04,27,20,Southampton,11,28,9,9,10,29,27,2,36,15,7,4,4,18,11,7,25,13,2,5,6,11,16,-5,11,,,The Friends Provident St Mary's Stadium,Southampton
2003/04,27,13,Middlesbrough,12,28,9,7,12,29,35,-6,34,14,4,4,6,12,16,-4,16,14,5,3,6,17,19,-2,18,Q,EU_UC,Riverside Stadium,Middlesbrough
2003/04,27,27,Bolton Wanderers,13,28,8,10,10,32,44,-12,34,14,3,7,4,15,16,-1,16,14,5,3,6,17,28,-11,18,,,Macron Stadium,Bolton
2003/04,27,7,Everton,14,28,8,8,12,34,39,-5,32,15,7,4,4,22,15,7,25,13,1,4,8,12,24,-12,7,,,Goodison Park,Liverpool
2003/04,27,11,Manchester City,15,28,7,9,12,40,40,0,30,14,3,7,4,21,17,4,16,14,4,2,8,19,23,-4,14,,,Etihad Stadium,Manchester
2003/04,27,3,Blackburn Rovers,16,28,7,7,14,39,46,-7,28,14,3,3,8,20,26,-6,12,14,4,4,6,19,20,-1,16,,,Ewood Park,Blackburn
2003/04,27,26,Leicester City,17,28,5,11,12,38,51,-13,26,14,2,7,5,14,23,-9,13,14,3,4,7,24,28,-4,13,,,King Power Stadium,Leicester
2003/04,27,37,Portsmouth,18,28,6,6,16,29,44,-15,24,13,6,2,5,23,15,8,20,15,0,4,11,6,29,-23,4,R,EN_D1,Fratton Park,Portsmouth
2003/04,27,38,Wolverhampton Wanderers,19,28,5,9,14,24,56,-32,24,14,5,5,4,17,26,-9,20,14,0,4,10,7,30,-23,4,R,EN_D1,Molineux,Wolverhampton
2003/04,27,9,Leeds United,20,28,5,7,16,26,55,-29,22,14,3,5,6,15,22,-7,14,14,2,2,10,11,33,-22,8,R,EN_D1,Elland Road,Leeds
2003/04,28,1,Arsenal,1,29,22,7,0,57,19,38,73,14,12,2,0,28,10,18,38,15,10,5,0,29,9,20,35,Q,EU_CL,Highbury,London
2003/04,28,4,Chelsea,2,29,20,4,5,52,22,30,64,14,9,2,3,24,11,13,29,15,11,2,2,28,11,17,35,Q,EU_CL,Stamford Bridge,London
2003/04,28,12,Manchester United,3,29,19,4,6,55,29,26,61,15,10,3,2,33,13,20,33,14,9,1,4,22,16,6,28,Q,EU_CL,Old Trafford,Manchester
2003/04,28,10,Liverpool,4,29,12,9,8,42,31,11,45,14,8,2,4,22,13,9,26,15,4,7,4,20,18,2,19,Q,EU_CL,Anfield,Liverpool
2003/04,28,23,Newcastle United,5,29,11,12,6,41,30,11,45,15,9,3,3,26,10,16,30,14,2,9,3,15,20,-5,15,Q,EU_UC,Sports Direct Arena,Newcastle
2003/04,28,31,Charlton Athletic,6,29,12,7,10,40,37,3,43,14,6,3,5,22,22,0,21,15,6,4,5,18,15,3,22,,,The Valley,London
2003/04,28,35,Birmingham City,7,29,11,9,9,33,35,-2,42,15,7,4,4,19,16,3,25,14,4,5,5,14,19,-5,17,,,St Andrews,Birmingham
2003/04,28,2,Aston Villa,8,29,11,7,11,36,34,2,40,14,7,4,3,19,14,5,25,15,4,3,8,17,20,-3,15,,,Villa Park,Birmingham
2003/04,28,34,Fulham,9,29,11,6,12,42,40,2,39,15,8,3,4,24,16,8,27,14,3,3,8,18,24,-6,12,,,Loftus Road,London
2003/04,28,13,Middlesbrough,10,29,10,7,12,34,38,-4,37,15,5,4,6,17,19,-2,19,14,5,3,6,17,19,-2,18,Q,EU_UC,Riverside Stadium,Middlesbrough
2003/04,28,21,Tottenham Hotspur,11,29,11,4,14,40,46,-6,37,15,8,2,5,29,23,6,26,14,3,2,9,11,23,-12,11,,,White Hart Lane,London
2003/04,28,20,Southampton,12,29,9,9,11,29,28,1,36,15,7,4,4,18,11,7,25,14,2,5,7,11,17,-6,11,,,The Friends Provident St Mary's Stadium,Southampton
2003/04,28,27,Bolton Wanderers,13,29,8,10,11,33,46,-13,34,14,3,7,4,15,16,-1,16,15,5,3,7,18,30,-12,18,,,Macron Stadium,Bolton
2003/04,28,7,Everton,14,29,8,9,12,35,40,-5,33,15,7,4,4,22,15,7,25,14,1,5,8,13,25,-12,8,,,Goodison Park,Liverpool
2003/04,28,3,Blackburn Rovers,15,29,8,7,14,41,46,-5,31,14,3,3,8,20,26,-6,12,15,5,4,6,21,20,1,19,,,Ewood Park,Blackburn
2003/04,28,11,Manchester City,16,29,7,9,13,41,42,-1,30,14,3,7,4,21,17,4,16,15,4,2,9,20,25,-5,14,,,Etihad Stadium,Manchester
2003/04,28,26,Leicester City,17,29,5,12,12,39,52,-13,27,15,2,8,5,15,24,-9,14,14,3,4,7,24,28,-4,13,,,King Power Stadium,Leicester
2003/04,28,37,Portsmouth,18,29,7,6,16,30,44,-14,27,14,7,2,5,24,15,9,23,15,0,4,11,6,29,-23,4,R,EN_D1,Fratton Park,Portsmouth
2003/04,28,9,Leeds United,19,29,6,7,16,28,56,-28,25,15,4,5,6,17,23,-6,17,14,2,2,10,11,33,-22,8,R,EN_D1,Elland Road,Leeds
2003/04,28,38,Wolverhampton Wanderers,20,29,5,9,15,24,57,-33,24,14,5,5,4,17,26,-9,20,15,0,4,11,7,31,-24,4,R,EN_D1,Molineux,Wolverhampton
2003/04,29,1,Arsenal,1,30,22,8,0,58,20,38,74,15,12,3,0,29,11,18,39,15,10,5,0,29,9,20,35,Q,EU_CL,Highbury,London
2003/04,29,4,Chelsea,2,30,21,4,5,57,24,33,67,15,10,2,3,29,13,16,32,15,11,2,2,28,11,17,35,Q,EU_CL,Stamford Bridge,London
2003/04,29,12,Manchester United,3,30,19,5,6,56,30,26,62,15,10,3,2,33,13,20,33,15,9,2,4,23,17,6,29,Q,EU_CL,Old Trafford,Manchester
2003/04,29,10,Liverpool,4,30,12,10,8,42,31,11,46,14,8,2,4,22,13,9,26,16,4,8,4,20,18,2,20,Q,EU_CL,Anfield,Liverpool
2003/04,29,23,Newcastle United,5,30,11,12,7,41,31,10,45,15,9,3,3,26,10,16,30,15,2,9,4,15,21,-6,15,Q,EU_UC,Sports Direct Arena,Newcastle
2003/04,29,35,Birmingham City,6,30,12,9,9,37,36,1,45,16,8,4,4,23,17,6,28,14,4,5,5,14,19,-5,17,,,St Andrews,Birmingham
2003/04,29,2,Aston Villa,7,30,12,7,11,38,35,3,43,14,7,4,3,19,14,5,25,16,5,3,8,19,21,-2,18,,,Villa Park,Birmingham
2003/04,29,31,Charlton Athletic,8,30,12,7,11,41,39,2,43,15,6,3,6,23,24,-1,21,15,6,4,5,18,15,3,22,,,The Valley,London
2003/04,29,34,Fulham,9,30,11,7,12,42,40,2,40,15,8,3,4,24,16,8,27,15,3,4,8,18,24,-6,13,,,Loftus Road,London
2003/04,29,20,Southampton,10,30,10,9,11,30,28,2,39,16,8,4,4,19,11,8,28,14,2,5,7,11,17,-6,11,,,The Friends Provident St Mary's Stadium,Southampton
2003/04,29,13,Middlesbrough,11,30,10,8,12,35,39,-4,38,15,5,4,6,17,19,-2,19,15,5,4,6,18,20,-2,19,Q,EU_UC,Riverside Stadium,Middlesbrough
2003/04,29,21,Tottenham Hotspur,12,30,11,4,15,40,47,-7,37,15,8,2,5,29,23,6,26,15,3,2,10,11,24,-13,11,,,White Hart Lane,London
2003/04,29,27,Bolton Wanderers,13,30,9,10,11,34,46,-12,37,15,4,7,4,16,16,0,19,15,5,3,7,18,30,-12,18,,,Macron Stadium,Bolton
2003/04,29,7,Everton,14,30,8,10,12,36,41,-5,34,16,7,5,4,23,16,7,26,14,1,5,8,13,25,-12,8,,,Goodison Park,Liverpool
2003/04,29,11,Manchester City,15,30,7,10,13,41,42,-1,31,15,3,8,4,21,17,4,17,15,4,2,9,20,25,-5,14,,,Etihad Stadium,Manchester
2003/04,29,3,Blackburn Rovers,16,30,8,7,15,42,48,-6,31,15,3,3,9,21,28,-7,12,15,5,4,6,21,20,1,19,,,Ewood Park,Blackburn
2003/04,29,37,Portsmouth,17,30,8,6,16,32,45,-13,30,14,7,2,5,24,15,9,23,16,1,4,11,8,30,-22,7,,,Fratton Park,Portsmouth
2003/04,29,26,Leicester City,18,30,5,13,12,39,52,-13,28,16,2,9,5,15,24,-9,15,14,3,4,7,24,28,-4,13,R,EN_D1,King Power Stadium,Leicester
2003/04,29,9,Leeds United,19,30,6,7,17,29,60,-31,25,15,4,5,6,17,23,-6,17,15,2,2,11,12,37,-25,8,R,EN_D1,Elland Road,Leeds
2003/04,29,38,Wolverhampton Wanderers,20,30,5,9,16,26,62,-36,24,14,5,5,4,17,26,-9,20,16,0,4,12,9,36,-27,4,R,EN_D1,Molineux,Wolverhampton
2003/04,30,1,Arsenal,1,30,22,8,0,58,20,38,74,15,12,3,0,29,11,18,39,15,10,5,0,29,9,20,35,Q,EU_CL,Highbury,London
2003/04,30,4,Chelsea,2,31,22,4,5,58,24,34,70,15,10,2,3,29,13,16,32,16,12,2,2,29,11,18,38,Q,EU_CL,Stamford Bridge,London
2003/04,30,12,Manchester United,3,30,19,5,6,56,30,26,62,15,10,3,2,33,13,20,33,15,9,2,4,23,17,6,29,Q,EU_CL,Old Trafford,Manchester
2003/04,30,10,Liverpool,4,31,13,10,8,46,31,15,49,15,9,2,4,26,13,13,29,16,4,8,4,20,18,2,20,Q,EU_CL,Anfield,Liverpool
2003/04,30,23,Newcastle United,5,31,12,12,7,45,33,12,48,16,10,3,3,30,12,18,33,15,2,9,4,15,21,-6,15,Q,EU_UC,Sports Direct Arena,Newcastle
2003/04,30,35,Birmingham City,6,31,12,10,9,37,36,1,46,16,8,4,4,23,17,6,28,15,4,6,5,14,19,-5,18,,,St Andrews,Birmingham
2003/04,30,2,Aston Villa,7,31,12,8,11,39,36,3,44,15,7,5,3,20,15,5,26,16,5,3,8,19,21,-2,18,,,Villa Park,Birmingham
2003/04,30,31,Charlton Athletic,8,30,12,7,11,41,39,2,43,15,6,3,6,23,24,-1,21,15,6,4,5,18,15,3,22,,,The Valley,London
2003/04,30,20,Southampton,9,31,11,9,11,34,29,5,42,16,8,4,4,19,11,8,28,15,3,5,7,15,18,-3,14,,,The Friends Provident St Mary's Stadium,Southampton
2003/04,30,34,Fulham,10,31,11,8,12,42,40,2,41,16,8,4,4,24,16,8,28,15,3,4,8,18,24,-6,13,,,Loftus Road,London
2003/04,30,13,Middlesbrough,11,31,11,8,12,37,39,-2,41,16,6,4,6,19,19,0,22,15,5,4,6,18,20,-2,19,Q,EU_UC,Riverside Stadium,Middlesbrough
2003/04,30,21,Tottenham Hotspur,12,31,11,4,16,40,48,-8,37,16,8,2,6,29,24,5,26,15,3,2,10,11,24,-13,11,,,White Hart Lane,London
2003/04,30,27,Bolton Wanderers,13,31,9,10,12,34,48,-14,37,15,4,7,4,16,16,0,19,16,5,3,8,18,32,-14,18,,,Macron Stadium,Bolton
2003/04,30,7,Everton,14,31,8,10,13,38,45,-7,34,16,7,5,4,23,16,7,26,15,1,5,9,15,29,-14,8,,,Goodison Park,Liverpool
2003/04,30,11,Manchester City,15,31,7,11,13,42,43,-1,32,15,3,8,4,21,17,4,17,16,4,3,9,21,26,-5,15,,,Etihad Stadium,Manchester
2003/04,30,3,Blackburn Rovers,16,31,8,7,16,42,52,-10,31,15,3,3,9,21,28,-7,12,16,5,4,7,21,24,-3,19,,,Ewood Park,Blackburn
2003/04,30,37,Portsmouth,17,30,8,6,16,32,45,-13,30,14,7,2,5,24,15,9,23,16,1,4,11,8,30,-22,7,,,Fratton Park,Portsmouth
2003/04,30,26,Leicester City,18,31,5,13,13,41,55,-14,28,16,2,9,5,15,24,-9,15,15,3,4,8,26,31,-5,13,R,EN_D1,King Power Stadium,Leicester
2003/04,30,9,Leeds United,19,31,7,7,17,32,62,-30,28,16,5,5,6,20,25,-5,20,15,2,2,11,12,37,-25,8,R,EN_D1,Elland Road,Leeds
2003/04,30,38,Wolverhampton Wanderers,20,31,5,9,17,27,66,-39,24,15,5,5,5,18,30,-12,20,16,0,4,12,9,36,-27,4,R,EN_D1,Molineux,Wolverhampton
2003/04,31,1,Arsenal,1,32,23,9,0,62,22,40,78,16,13,3,0,33,13,20,42,16,10,6,0,29,9,20,36,Q,EU_CL,Highbury,London
2003/04,31,4,Chelsea,2,33,22,5,6,60,27,33,71,16,10,3,3,29,13,16,33,17,12,2,3,31,14,17,38,Q,EU_CL,Stamford Bridge,London
2003/04,31,12,Manchester United,3,32,21,5,6,59,31,28,68,16,11,3,2,34,13,21,36,16,10,2,4,25,18,7,32,Q,EU_CL,Old Trafford,Manchester
2003/04,31,10,Liverpool,4,33,13,10,10,48,36,12,49,16,9,2,5,26,14,12,29,17,4,8,5,22,22,0,20,Q,EU_CL,Anfield,Liverpool
2003/04,31,23,Newcastle United,5,32,12,13,7,45,33,12,49,17,10,4,3,30,12,18,34,15,2,9,4,15,21,-6,15,Q,EU_UC,Sports Direct Arena,Newcastle
2003/04,31,2,Aston Villa,6,33,13,9,11,44,40,4,48,16,8,5,3,23,17,6,29,17,5,4,8,21,23,-2,19,,,Villa Park,Birmingham
2003/04,31,31,Charlton Athletic,7,32,13,8,11,43,40,3,47,16,6,4,6,24,25,-1,22,16,7,4,5,19,15,4,25,,,The Valley,London
2003/04,31,35,Birmingham City,8,33,12,10,11,39,41,-2,46,17,8,4,5,24,19,5,28,16,4,6,6,15,22,-7,18,,,St Andrews,Birmingham
2003/04,31,13,Middlesbrough,9,33,12,9,12,40,40,0,45,17,7,4,6,22,20,2,25,16,5,5,6,18,20,-2,20,Q,EU_UC,Riverside Stadium,Middlesbrough
2003/04,31,34,Fulham,10,33,12,8,13,47,44,3,44,17,8,4,5,27,20,7,28,16,4,4,8,20,24,-4,16,,,Loftus Road,London
2003/04,31,20,Southampton,11,32,11,9,12,35,32,3,42,16,8,4,4,19,11,8,28,16,3,5,8,16,21,-5,14,,,The Friends Provident St Mary's Stadium,Southampton
2003/04,31,27,Bolton Wanderers,12,33,10,11,12,38,51,-13,41,16,4,8,4,18,18,0,20,17,6,3,8,20,33,-13,21,,,Macron Stadium,Bolton
2003/04,31,7,Everton,13,33,9,11,13,42,47,-5,38,17,8,5,4,26,17,9,29,16,1,6,9,16,30,-14,9,,,Goodison Park,Liverpool
2003/04,31,21,Tottenham Hotspur,14,33,11,5,17,42,52,-10,38,17,8,3,6,30,25,5,27,16,3,2,11,12,27,-15,11,,,White Hart Lane,London
2003/04,31,11,Manchester City,15,33,7,13,13,46,47,-1,34,16,3,9,4,24,20,4,18,17,4,4,9,22,27,-5,16,,,Etihad Stadium,Manchester
2003/04,31,3,Blackburn Rovers,16,33,9,7,17,47,57,-10,34,16,3,3,10,22,30,-8,12,17,6,4,7,25,27,-2,22,,,Ewood Park,Blackburn
2003/04,31,37,Portsmouth,17,32,9,7,16,36,47,-11,34,15,8,2,5,27,16,11,26,17,1,5,11,9,31,-22,8,,,Fratton Park,Portsmouth
2003/04,31,9,Leeds United,18,33,8,8,17,35,64,-29,32,17,5,6,6,21,26,-5,21,16,3,2,11,14,38,-24,11,R,EN_D1,Elland Road,Leeds
2003/04,31,26,Leicester City,19,33,5,13,15,41,58,-17,28,17,2,9,6,15,26,-11,15,16,3,4,9,26,32,-6,13,R,EN_D1,King Power Stadium,Leicester
2003/04,31,38,Wolverhampton Wanderers,20,33,5,10,18,31,71,-40,25,16,5,5,6,19,32,-13,20,17,0,5,12,12,39,-27,5,R,EN_D1,Molineux,Wolverhampton
2003/04,32,1,Arsenal,1,33,24,9,0,67,22,45,81,17,14,3,0,38,13,25,45,16,10,6,0,29,9,20,36,Q,EU_CL,Highbury,London
2003/04,32,4,Chelsea,2,34,22,6,6,60,27,33,72,17,10,4,3,29,13,16,34,17,12,2,3,31,14,17,38,Q,EU_CL,Stamford Bridge,London
2003/04,32,12,Manchester United,3,34,22,5,7,61,32,29,71,17,12,3,2,36,13,23,39,17,10,2,5,25,19,6,32,Q,EU_CL,Old Trafford,Manchester
2003/04,32,10,Liverpool,4,34,13,11,10,48,36,12,50,17,9,3,5,26,14,12,30,17,4,8,5,22,22,0,20,Q,EU_CL,Anfield,Liverpool
2003/04,32,23,Newcastle United,5,33,12,14,7,45,33,12,50,17,10,4,3,30,12,18,34,16,2,10,4,15,21,-6,16,Q,EU_UC,Sports Direct Arena,Newcastle
2003/04,32,2,Aston Villa,6,34,13,10,11,44,40,4,49,17,8,6,3,23,17,6,30,17,5,4,8,21,23,-2,19,,,Villa Park,Birmingham
2003/04,32,31,Charlton Athletic,7,34,13,9,12,44,43,1,48,17,6,5,6,25,26,-1,23,17,7,4,6,19,17,2,25,,,The Valley,London
2003/04,32,35,Birmingham City,8,34,12,11,11,40,42,-2,47,17,8,4,5,24,19,5,28,17,4,7,6,16,23,-7,19,,,St Andrews,Birmingham
2003/04,32,20,Southampton,9,33,12,9,12,38,33,5,45,16,8,4,4,19,11,8,28,17,4,5,8,19,22,-3,17,,,The Friends Provident St Mary's Stadium,Southampton
2003/04,32,34,Fulham,10,34,12,9,13,47,44,3,45,17,8,4,5,27,20,7,28,17,4,5,8,20,24,-4,17,,,Loftus Road,London
2003/04,32,13,Middlesbrough,11,34,12,9,13,40,42,-2,45,17,7,4,6,22,20,2,25,17,5,5,7,18,22,-4,20,Q,EU_UC,Riverside Stadium,Middlesbrough
2003/04,32,27,Bolton Wanderers,12,34,11,11,12,40,51,-11,44,17,5,8,4,20,18,2,23,17,6,3,8,20,33,-13,21,,,Macron Stadium,Bolton
2003/04,32,7,Everton,13,34,9,12,13,42,47,-5,39,17,8,5,4,26,17,9,29,17,1,7,9,16,30,-14,10,,,Goodison Park,Liverpool
2003/04,32,21,Tottenham Hotspur,14,34,11,5,18,42,54,-12,38,17,8,3,6,30,25,5,27,17,3,2,12,12,29,-17,11,,,White Hart Lane,London
2003/04,32,3,Blackburn Rovers,15,34,10,7,17,48,57,-9,37,17,4,3,10,23,30,-7,15,17,6,4,7,25,27,-2,22,,,Ewood Park,Blackburn
2003/04,32,37,Portsmouth,16,33,10,7,16,37,47,-10,37,16,9,2,5,28,16,12,29,17,1,5,11,9,31,-22,8,,,Fratton Park,Portsmouth
2003/04,32,11,Manchester City,17,34,7,13,14,47,50,-3,34,17,3,9,5,25,23,2,18,17,4,4,9,22,27,-5,16,,,Etihad Stadium,Manchester
2003/04,32,9,Leeds United,18,34,8,8,18,35,69,-34,32,17,5,6,6,21,26,-5,21,17,3,2,12,14,43,-29,11,R,EN_D1,Elland Road,Leeds
2003/04,32,26,Leicester City,19,34,5,13,16,41,59,-18,28,17,2,9,6,15,26,-11,15,17,3,4,10,26,33,-7,13,R,EN_D1,King Power Stadium,Leicester
2003/04,32,38,Wolverhampton Wanderers,20,34,6,10,18,33,71,-38,28,17,6,5,6,21,32,-11,23,17,0,5,12,12,39,-27,5,R,EN_D1,Molineux,Wolverhampton
2003/04,33,1,Arsenal,1,34,24,10,0,69,24,45,82,17,14,3,0,38,13,25,45,17,10,7,0,31,11,20,37,Q,EU_CL,Highbury,London
2003/04,33,4,Chelsea,2,35,22,6,7,61,29,32,72,17,10,4,3,29,13,16,34,18,12,2,4,32,16,16,38,Q,EU_CL,Stamford Bridge,London
2003/04,33,12,Manchester United,3,35,22,5,8,61,33,28,71,18,12,3,3,36,14,22,39,17,10,2,5,25,19,6,32,Q,EU_CL,Old Trafford,Manchester
2003/04,33,10,Liverpool,4,35,14,11,10,49,36,13,53,17,9,3,5,26,14,12,30,18,5,8,5,23,22,1,23,Q,EU_CL,Anfield,Liverpool
2003/04,33,23,Newcastle United,5,34,13,14,7,47,34,13,53,18,11,4,3,32,13,19,37,16,2,10,4,15,21,-6,16,Q,EU_UC,Sports Direct Arena,Newcastle
2003/04,33,2,Aston Villa,6,35,14,10,11,46,41,5,52,17,8,6,3,23,17,6,30,18,6,4,8,23,24,-1,22,,,Villa Park,Birmingham
2003/04,33,34,Fulham,7,35,13,9,13,49,44,5,48,18,9,4,5,29,20,9,31,17,4,5,8,20,24,-4,17,,,Loftus Road,London
2003/04,33,31,Charlton Athletic,8,35,13,9,13,44,45,-1,48,17,6,5,6,25,26,-1,23,18,7,4,7,19,19,0,25,,,The Valley,London
2003/04,33,35,Birmingham City,9,35,12,12,11,42,44,-2,48,18,8,5,5,26,21,5,29,17,4,7,6,16,23,-7,19,,,St Andrews,Birmingham
2003/04,33,27,Bolton Wanderers,10,35,12,11,12,42,52,-10,47,17,5,8,4,20,18,2,23,18,7,3,8,22,34,-12,24,,,Macron Stadium,Bolton
2003/04,33,20,Southampton,11,34,12,9,13,39,35,4,45,17,8,4,5,20,13,7,28,17,4,5,8,19,22,-3,17,,,The Friends Provident St Mary's Stadium,Southampton
2003/04,33,13,Middlesbrough,12,35,12,9,14,41,44,-3,45,18,7,4,7,23,22,1,25,17,5,5,7,18,22,-4,20,Q,EU_UC,Riverside Stadium,Middlesbrough
2003/04,33,3,Blackburn Rovers,13,35,11,7,17,49,57,-8,40,17,4,3,10,23,30,-7,15,18,7,4,7,26,27,-1,25,,,Ewood Park,Blackburn
2003/04,33,37,Portsmouth,14,34,11,7,16,39,48,-9,40,16,9,2,5,28,16,12,29,18,2,5,11,11,32,-21,11,,,Fratton Park,Portsmouth
2003/04,33,7,Everton,15,35,9,12,14,42,48,-6,39,18,8,5,5,26,18,8,29,17,1,7,9,16,30,-14,10,,,Goodison Park,Liverpool
2003/04,33,21,Tottenham Hotspur,16,35,11,6,18,44,56,-12,39,18,8,4,6,32,27,5,28,17,3,2,12,12,29,-17,11,,,White Hart Lane,London
2003/04,33,11,Manchester City,17,35,7,14,14,48,51,-3,35,17,3,9,5,25,23,2,18,18,4,5,9,23,28,-5,17,,,Etihad Stadium,Manchester
2003/04,33,9,Leeds United,18,35,8,8,19,36,71,-35,32,18,5,6,7,22,28,-6,21,17,3,2,12,14,43,-29,11,R,EN_D1,Elland Road,Leeds
2003/04,33,26,Leicester City,19,35,5,14,16,42,60,-18,29,18,2,10,6,16,27,-11,16,17,3,4,10,26,33,-7,13,R,EN_D1,King Power Stadium,Leicester
2003/04,33,38,Wolverhampton Wanderers,20,35,6,11,18,35,73,-38,29,17,6,5,6,21,32,-11,23,18,0,6,12,14,41,-27,6,R,EN_D1,Molineux,Wolverhampton
2003/04,34,1,Arsenal,1,36,24,12,0,70,25,45,84,18,14,4,0,38,13,25,46,18,10,8,0,32,12,20,38,Q,EU_CL,Highbury,London
2003/04,34,4,Chelsea,2,36,23,6,7,65,29,36,75,18,11,4,3,33,13,20,37,18,12,2,4,32,16,16,38,Q,EU_CL,Stamford Bridge,London
2003/04,34,12,Manchester United,3,36,22,5,9,61,34,27,71,18,12,3,3,36,14,22,39,18,10,2,6,25,20,5,32,Q,EU_CL,Old Trafford,Manchester
2003/04,34,10,Liverpool,4,36,15,11,10,51,36,15,56,18,10,3,5,28,14,14,33,18,5,8,5,23,22,1,23,Q,EU_CL,Anfield,Liverpool
2003/04,34,2,Aston Villa,5,36,15,10,11,47,41,6,55,18,9,6,3,24,17,7,33,18,6,4,8,23,24,-1,22,Q,EU_UC,Villa Park,Birmingham
2003/04,34,23,Newcastle United,6,35,13,14,8,47,35,12,53,18,11,4,3,32,13,19,37,17,2,10,5,15,22,-7,16,,,Sports Direct Arena,Newcastle
2003/04,34,27,Bolton Wanderers,7,36,13,11,12,46,53,-7,50,18,6,8,4,24,19,5,26,18,7,3,8,22,34,-12,24,,,Macron Stadium,Bolton
2003/04,34,34,Fulham,8,36,13,10,13,50,45,5,49,18,9,4,5,29,20,9,31,18,4,6,8,21,25,-4,18,,,Loftus Road,London
2003/04,34,31,Charlton Athletic,9,36,13,10,13,46,47,-1,49,18,6,6,6,27,28,-1,24,18,7,4,7,19,19,0,25,,,The Valley,London
2003/04,34,35,Birmingham City,10,36,12,13,11,42,44,-2,49,18,8,5,5,26,21,5,29,18,4,8,6,16,23,-7,20,,,St Andrews,Birmingham
2003/04,34,20,Southampton,11,35,12,9,14,39,39,0,45,17,8,4,5,20,13,7,28,18,4,5,9,19,26,-7,17,,,The Friends Provident St Mary's Stadium,Southampton
2003/04,34,13,Middlesbrough,12,36,12,9,15,41,46,-5,45,18,7,4,7,23,22,1,25,18,5,5,8,18,24,-6,20,Q,EU_UC,Riverside Stadium,Middlesbrough
2003/04,34,3,Blackburn Rovers,13,36,12,7,17,50,57,-7,43,18,5,3,10,24,30,-6,18,18,7,4,7,26,27,-1,25,,,Ewood Park,Blackburn
2003/04,34,37,Portsmouth,14,36,11,9,16,41,50,-9,42,18,9,4,5,30,18,12,31,18,2,5,11,11,32,-21,11,,,Fratton Park,Portsmouth
2003/04,34,7,Everton,15,36,9,12,15,43,50,-7,39,18,8,5,5,26,18,8,29,18,1,7,10,17,32,-15,10,,,Goodison Park,Liverpool
2003/04,34,21,Tottenham Hotspur,16,36,11,6,19,44,57,-13,39,18,8,4,6,32,27,5,28,18,3,2,13,12,30,-18,11,,,White Hart Lane,London
2003/04,34,11,Manchester City,17,36,8,14,14,49,51,-2,38,18,4,9,5,26,23,3,21,18,4,5,9,23,28,-5,17,,,Etihad Stadium,Manchester
2003/04,34,38,Wolverhampton Wanderers,18,36,7,11,18,37,74,-37,32,18,7,5,6,23,33,-10,26,18,0,6,12,14,41,-27,6,R,EN_D1,Molineux,Wolverhampton
2003/04,34,9,Leeds United,19,36,8,8,20,37,75,-38,32,18,5,6,7,22,28,-6,21,18,3,2,13,15,47,-32,11,R,EN_D1,Elland Road,Leeds
2003/04,34,26,Leicester City,20,36,5,15,16,44,62,-18,30,18,2,10,6,16,27,-11,16,18,3,5,10,28,35,-7,14,R,EN_D1,King Power Stadium,Leicester
2003/04,35,1,Arsenal,1,37,25,12,0,71,25,46,87,18,14,4,0,38,13,25,46,19,11,8,0,33,12,21,41,Q,EU_CL,Highbury,London
2003/04,35,4,Chelsea,2,37,23,7,7,66,30,36,76,18,11,4,3,33,13,20,37,19,12,3,4,33,17,16,39,Q,EU_CL,Stamford Bridge,London
2003/04,35,12,Manchester United,3,37,22,6,9,62,35,27,72,19,12,4,3,37,15,22,40,18,10,2,6,25,20,5,32,Q,EU_CL,Old Trafford,Manchester
2003/04,35,10,Liverpool,4,37,16,11,10,54,36,18,59,18,10,3,5,28,14,14,33,19,6,8,5,26,22,4,26,Q,EU_CL,Anfield,Liverpool
2003/04,35,2,Aston Villa,5,37,15,11,11,48,42,6,56,18,9,6,3,24,17,7,33,19,6,5,8,24,25,-1,23,Q,EU_UC,Villa Park,Birmingham
2003/04,35,23,Newcastle United,6,37,13,16,8,51,39,12,55,19,11,5,3,33,14,19,38,18,2,11,5,18,25,-7,17,,,Sports Direct Arena,Newcastle
2003/04,35,27,Bolton Wanderers,7,37,14,11,12,48,54,-6,53,18,6,8,4,24,19,5,26,19,8,3,8,24,35,-11,27,,,Macron Stadium,Bolton
2003/04,35,31,Charlton Athletic,8,37,13,11,13,49,50,-1,50,18,6,6,6,27,28,-1,24,19,7,5,7,22,22,0,26,,,The Valley,London
2003/04,35,34,Fulham,9,37,13,10,14,50,46,4,49,19,9,4,6,29,21,8,31,18,4,6,8,21,25,-4,18,,,Loftus Road,London
2003/04,35,35,Birmingham City,10,37,12,13,12,42,47,-5,49,19,8,5,6,26,24,2,29,18,4,8,6,16,23,-7,20,,,St Andrews,Birmingham
2003/04,35,13,Middlesbrough,11,37,13,9,15,43,47,-4,48,19,8,4,7,25,23,2,28,18,5,5,8,18,24,-6,20,Q,EU_UC,Riverside Stadium,Middlesbrough
2003/04,35,20,Southampton,12,37,12,11,14,43,43,0,47,19,8,6,5,24,17,7,30,18,4,5,9,19,26,-7,17,,,The Friends Provident St Mary's Stadium,Southampton
2003/04,35,3,Blackburn Rovers,13,37,12,7,18,50,58,-8,43,18,5,3,10,24,30,-6,18,19,7,4,8,26,28,-2,25,,,Ewood Park,Blackburn
2003/04,35,37,Portsmouth,14,37,11,9,17,42,53,-11,42,18,9,4,5,30,18,12,31,19,2,5,12,12,35,-23,11,,,Fratton Park,Portsmouth
2003/04,35,21,Tottenham Hotspur,15,37,12,6,19,45,57,-12,42,19,9,4,6,33,27,6,31,18,3,2,13,12,30,-18,11,,,White Hart Lane,London
2003/04,35,7,Everton,16,37,9,12,16,44,52,-8,39,19,8,5,6,27,20,7,29,18,1,7,10,17,32,-15,10,,,Goodison Park,Liverpool
2003/04,35,11,Manchester City,17,37,8,14,15,50,53,-3,38,18,4,9,5,26,23,3,21,19,4,5,10,24,30,-6,17,,,Etihad Stadium,Manchester
2003/04,35,26,Leicester City,18,37,6,15,16,47,63,-16,33,19,3,10,6,19,28,-9,19,18,3,5,10,28,35,-7,14,R,EN_D1,King Power Stadium,Leicester
2003/04,35,38,Wolverhampton Wanderers,19,37,7,12,18,38,75,-37,33,18,7,5,6,23,33,-10,26,19,0,7,12,15,42,-27,7,R,EN_D1,Molineux,Wolverhampton
2003/04,35,9,Leeds United,20,37,8,9,20,40,78,-38,33,19,5,7,7,25,31,-6,22,18,3,2,13,15,47,-32,11,R,EN_D1,Elland Road,Leeds
2003/04,36,1,Arsenal,1,38,26,12,0,73,26,47,90,19,15,4,0,40,14,26,49,19,11,8,0,33,12,21,41,Q,EU_CL,Highbury,London
2003/04,36,4,Chelsea,2,38,24,7,7,67,30,37,79,19,12,4,3,34,13,21,40,19,12,3,4,33,17,16,39,Q,EU_CL,Stamford Bridge,London
2003/04,36,12,Manchester United,3,38,23,6,9,64,35,29,75,19,12,4,3,37,15,22,40,19,11,2,6,27,20,7,35,Q,EU_CL,Old Trafford,Manchester
2003/04,36,10,Liverpool,4,38,16,12,10,55,37,18,60,19,10,4,5,29,15,14,34,19,6,8,5,26,22,4,26,Q,EU_CL,Anfield,Liverpool
2003/04,36,23,Newcastle United,5,38,13,17,8,52,40,12,56,19,11,5,3,33,14,19,38,19,2,12,5,19,26,-7,18,Q,EU_UC,Sports Direct Arena,Newcastle
2003/04,36,2,Aston Villa,6,38,15,11,12,48,44,4,56,19,9,6,4,24,19,5,33,19,6,5,8,24,25,-1,23,,,Villa Park,Birmingham
2003/04,36,31,Charlton Athletic,7,38,14,11,13,51,51,0,53,19,7,6,6,29,29,0,27,19,7,5,7,22,22,0,26,,,The Valley,London
2003/04,36,27,Bolton Wanderers,8,38,14,11,13,48,56,-8,53,19,6,8,5,24,21,3,26,19,8,3,8,24,35,-11,27,,,Macron Stadium,Bolton
2003/04,36,34,Fulham,9,38,14,10,14,52,46,6,52,19,9,4,6,29,21,8,31,19,5,6,8,23,25,-2,21,,,Loftus Road,London
2003/04,36,35,Birmingham City,10,38,12,14,12,43,48,-5,50,19,8,5,6,26,24,2,29,19,4,9,6,17,24,-7,21,,,St Andrews,Birmingham
2003/04,36,13,Middlesbrough,11,38,13,9,16,44,52,-8,48,19,8,4,7,25,23,2,28,19,5,5,9,19,29,-10,20,Q,EU_UC,Riverside Stadium,Middlesbrough
2003/04,36,20,Southampton,12,38,12,11,15,44,45,-1,47,19,8,6,5,24,17,7,30,19,4,5,10,20,28,-8,17,,,The Friends Provident St Mary's Stadium,Southampton
2003/04,36,37,Portsmouth,13,38,12,9,17,47,54,-7,45,19,10,4,5,35,19,16,34,19,2,5,12,12,35,-23,11,,,Fratton Park,Portsmouth
2003/04,36,21,Tottenham Hotspur,14,38,13,6,19,47,57,-10,45,19,9,4,6,33,27,6,31,19,4,2,13,14,30,-16,14,,,White Hart Lane,London
2003/04,36,3,Blackburn Rovers,15,38,12,8,18,51,59,-8,44,19,5,4,10,25,31,-6,19,19,7,4,8,26,28,-2,25,,,Ewood Park,Blackburn
2003/04,36,11,Manchester City,16,38,9,14,15,55,54,1,41,19,5,9,5,31,24,7,24,19,4,5,10,24,30,-6,17,,,Etihad Stadium,Manchester
2003/04,36,7,Everton,17,38,9,12,17,45,57,-12,39,19,8,5,6,27,20,7,29,19,1,7,11,18,37,-19,10,,,Goodison Park,Liverpool
2003/04,36,26,Leicester City,18,38,6,15,17,48,65,-17,33,19,3,10,6,19,28,-9,19,19,3,5,11,29,37,-8,14,R,EN_D1,King Power Stadium,Leicester
2003/04,36,9,Leeds United,19,38,8,9,21,40,79,-39,33,19,5,7,7,25,31,-6,22,19,3,2,14,15,48,-33,11,R,EN_D1,Elland Road,Leeds
2003/04,36,38,Wolverhampton Wanderers,20,38,7,12,19,38,77,-39,33,19,7,5,7,23,35,-12,26,19,0,7,12,15,42,-27,7,R,EN_D1,Molineux,Wolverhampton
2003/04,37,1,Arsenal,1,38,26,12,0,73,26,47,90,19,15,4,0,40,14,26,49,19,11,8,0,33,12,21,41,Q,EU_CL,Highbury,London
2003/04,37,4,Chelsea,2,38,24,7,7,67,30,37,79,19,12,4,3,34,13,21,40,19,12,3,4,33,17,16,39,Q,EU_CL,Stamford Bridge,London
2003/04,37,12,Manchester United,3,38,23,6,9,64,35,29,75,19,12,4,3,37,15,22,40,19,11,2,6,27,20,7,35,Q,EU_CL,Old Trafford,Manchester
2003/04,37,10,Liverpool,4,38,16,12,10,55,37,18,60,19,10,4,5,29,15,14,34,19,6,8,5,26,22,4,26,Q,EU_CL,Anfield,Liverpool
2003/04,37,23,Newcastle United,5,38,13,17,8,52,40,12,56,19,11,5,3,33,14,19,38,19,2,12,5,19,26,-7,18,Q,EU_UC,Sports Direct Arena,Newcastle
2003/04,37,2,Aston Villa,6,38,15,11,12,48,44,4,56,19,9,6,4,24,19,5,33,19,6,5,8,24,25,-1,23,,,Villa Park,Birmingham
2003/04,37,31,Charlton Athletic,7,38,14,11,13,51,51,0,53,19,7,6,6,29,29,0,27,19,7,5,7,22,22,0,26,,,The Valley,London
2003/04,37,27,Bolton Wanderers,8,38,14,11,13,48,56,-8,53,19,6,8,5,24,21,3,26,19,8,3,8,24,35,-11,27,,,Macron Stadium,Bolton
2003/04,37,34,Fulham,9,38,14,10,14,52,46,6,52,19,9,4,6,29,21,8,31,19,5,6,8,23,25,-2,21,,,Loftus Road,London
2003/04,37,35,Birmingham City,10,38,12,14,12,43,48,-5,50,19,8,5,6,26,24,2,29,19,4,9,6,17,24,-7,21,,,St Andrews,Birmingham
2003/04,37,13,Middlesbrough,11,38,13,9,16,44,52,-8,48,19,8,4,7,25,23,2,28,19,5,5,9,19,29,-10,20,Q,EU_UC,Riverside Stadium,Middlesbrough
2003/04,37,20,Southampton,12,38,12,11,15,44,45,-1,47,19,8,6,5,24,17,7,30,19,4,5,10,20,28,-8,17,,,The Friends Provident St Mary's Stadium,Southampton
2003/04,37,37,Portsmouth,13,38,12,9,17,47,54,-7,45,19,10,4,5,35,19,16,34,19,2,5,12,12,35,-23,11,,,Fratton Park,Portsmouth
2003/04,37,21,Tottenham Hotspur,14,38,13,6,19,47,57,-10,45,19,9,4,6,33,27,6,31,19,4,2,13,14,30,-16,14,,,White Hart Lane,London
2003/04,37,3,Blackburn Rovers,15,38,12,8,18,51,59,-8,44,19,5,4,10,25,31,-6,19,19,7,4,8,26,28,-2,25,,,Ewood Park,Blackburn
2003/04,37,11,Manchester City,16,38,9,14,15,55,54,1,41,19,5,9,5,31,24,7,24,19,4,5,10,24,30,-6,17,,,Etihad Stadium,Manchester
2003/04,37,7,Everton,17,38,9,12,17,45,57,-12,39,19,8,5,6,27,20,7,29,19,1,7,11,18,37,-19,10,,,Goodison Park,Liverpool
2003/04,37,26,Leicester City,18,38,6,15,17,48,65,-17,33,19,3,10,6,19,28,-9,19,19,3,5,11,29,37,-8,14,R,EN_D1,King Power Stadium,Leicester
2003/04,37,9,Leeds United,19,38,8,9,21,40,79,-39,33,19,5,7,7,25,31,-6,22,19,3,2,14,15,48,-33,11,R,EN_D1,Elland Road,Leeds
2003/04,37,38,Wolverhampton Wanderers,20,38,7,12,19,38,77,-39,33,19,7,5,7,23,35,-12,26,19,0,7,12,15,42,-27,7,R,EN_D1,Molineux,Wolverhampton
2003/04,38,1,Arsenal,1,38,26,12,0,73,26,47,90,19,15,4,0,40,14,26,49,19,11,8,0,33,12,21,41,Q,EU_CL,Highbury,London
2003/04,38,4,Chelsea,2,38,24,7,7,67,30,37,79,19,12,4,3,34,13,21,40,19,12,3,4,33,17,16,39,Q,EU_CL,Stamford Bridge,London
2003/04,38,12,Manchester United,3,38,23,6,9,64,35,29,75,19,12,4,3,37,15,22,40,19,11,2,6,27,20,7,35,Q,EU_CL,Old Trafford,Manchester
2003/04,38,10,Liverpool,4,38,16,12,10,55,37,18,60,19,10,4,5,29,15,14,34,19,6,8,5,26,22,4,26,Q,EU_CL,Anfield,Liverpool
2003/04,38,23,Newcastle United,5,38,13,17,8,52,40,12,56,19,11,5,3,33,14,19,38,19,2,12,5,19,26,-7,18,Q,EU_UC,Sports Direct Arena,Newcastle
2003/04,38,2,Aston Villa,6,38,15,11,12,48,44,4,56,19,9,6,4,24,19,5,33,19,6,5,8,24,25,-1,23,,,Villa Park,Birmingham
2003/04,38,31,Charlton Athletic,7,38,14,11,13,51,51,0,53,19,7,6,6,29,29,0,27,19,7,5,7,22,22,0,26,,,The Valley,London
2003/04,38,27,Bolton Wanderers,8,38,14,11,13,48,56,-8,53,19,6,8,5,24,21,3,26,19,8,3,8,24,35,-11,27,,,Macron Stadium,Bolton
2003/04,38,34,Fulham,9,38,14,10,14,52,46,6,52,19,9,4,6,29,21,8,31,19,5,6,8,23,25,-2,21,,,Loftus Road,London
2003/04,38,35,Birmingham City,10,38,12,14,12,43,48,-5,50,19,8,5,6,26,24,2,29,19,4,9,6,17,24,-7,21,,,St Andrews,Birmingham
2003/04,38,13,Middlesbrough,11,38,13,9,16,44,52,-8,48,19,8,4,7,25,23,2,28,19,5,5,9,19,29,-10,20,Q,EU_UC,Riverside Stadium,Middlesbrough
2003/04,38,20,Southampton,12,38,12,11,15,44,45,-1,47,19,8,6,5,24,17,7,30,19,4,5,10,20,28,-8,17,,,The Friends Provident St Mary's Stadium,Southampton
2003/04,38,37,Portsmouth,13,38,12,9,17,47,54,-7,45,19,10,4,5,35,19,16,34,19,2,5,12,12,35,-23,11,,,Fratton Park,Portsmouth
2003/04,38,21,Tottenham Hotspur,14,38,13,6,19,47,57,-10,45,19,9,4,6,33,27,6,31,19,4,2,13,14,30,-16,14,,,White Hart Lane,London
2003/04,38,3,Blackburn Rovers,15,38,12,8,18,51,59,-8,44,19,5,4,10,25,31,-6,19,19,7,4,8,26,28,-2,25,,,Ewood Park,Blackburn
2003/04,38,11,Manchester City,16,38,9,14,15,55,54,1,41,19,5,9,5,31,24,7,24,19,4,5,10,24,30,-6,17,,,Etihad Stadium,Manchester
2003/04,38,7,Everton,17,38,9,12,17,45,57,-12,39,19,8,5,6,27,20,7,29,19,1,7,11,18,37,-19,10,,,Goodison Park,Liverpool
2003/04,38,26,Leicester City,18,38,6,15,17,48,65,-17,33,19,3,10,6,19,28,-9,19,19,3,5,11,29,37,-8,14,R,EN_D1,King Power Stadium,Leicester
2003/04,38,9,Leeds United,19,38,8,9,21,40,79,-39,33,19,5,7,7,25,31,-6,22,19,3,2,14,15,48,-33,11,R,EN_D1,Elland Road,Leeds
2003/04,38,38,Wolverhampton Wanderers,20,38,7,12,19,38,77,-39,33,19,7,5,7,23,35,-12,26,19,0,7,12,15,42,-27,7,R,EN_D1,Molineux,Wolverhampton
