season,match_week,team_id,team_name,position,played,won,drawn,lost,goals_for,goals_against,goal_difference,points,home_played,home_won,home_drawn,home_lost,home_goals_for,home_goals_against,home_goal_difference,home_points,away_played,away_won,away_drawn,away_lost,away_goals_for,away_goals_against,away_goal_difference,away_points,annotation_types,annotation_destinations,stadium_name,stadium_city
2020/21,1,1,Arsenal,1,1,1,0,0,3,0,3,3,0,0,0,0,0,0,0,0,1,1,0,0,3,0,3,3,Q,EU_CL,Emirates Stadium,London
2020/21,1,26,Leicester City,2,1,1,0,0,3,0,3,3,0,0,0,0,0,0,0,0,1,1,0,0,3,0,3,3,Q,EU_CL,King Power Stadium,Leicester
2020/21,1,4,Chelsea,3,1,1,0,0,3,1,2,3,0,0,0,0,0,0,0,0,1,1,0,0,3,1,2,3,Q,EU_CL,Stamford Bridge,London
2020/21,1,23,Newcastle United,4,1,1,0,0,2,0,2,3,0,0,0,0,0,0,0,0,1,1,0,0,2,0,2,3,Q,EU_CL,St. James' Park,Newcastle
2020/21,1,38,Wolverhampton Wanderers,5,1,1,0,0,2,0,2,3,0,0,0,0,0,0,0,0,1,1,0,0,2,0,2,3,Q,EU_UC,Molineux Stadium,Wolverhampton
2020/21,1,10,Liverpool,6,1,1,0,0,4,3,1,3,1,1,0,0,4,3,1,3,0,0,0,0,0,0,0,0,Q,EU_UC,Anfield,Liverpool
2020/21,1,6,Crystal Palace,7,1,1,0,0,1,0,1,3,1,1,0,0,1,0,1,3,0,0,0,0,0,0,0,0,,,Selhurst Park,London
2020/21,1,7,Everton,8,1,1,0,0,1,0,1,3,0,0,0,0,0,0,0,0,1,1,0,0,1,0,1,3,,,Goodison Park,Liverpool
2020/21,1,9,Leeds United,9,1,0,0,1,3,4,-1,0,0,0,0,0,0,0,0,0,1,0,0,1,3,4,-1,0,,,Elland Road,Leeds
2020/21,1,20,Southampton,10,1,0,0,1,0,1,-1,0,0,0,0,0,0,0,0,0,1,0,0,1,0,1,-1,0,,,St. Mary's Stadium,Southampton
2020/21,1,21,Tottenham Hotspur,11,1,0,0,1,0,1,-1,0,1,0,0,1,0,1,-1,0,0,0,0,0,0,0,0,0,,,Tottenham Hotspur Stadium,London
2020/21,1,131,Brighton & Hove Albion,12,1,0,0,1,1,3,-2,0,1,0,0,1,1,3,-2,0,0,0,0,0,0,0,0,0,,,American Express Stadium,Falmer
2020/21,1,18,Sheffield United,13,1,0,0,1,0,2,-2,0,1,0,0,1,0,2,-2,0,0,0,0,0,0,0,0,0,,,Bramall Lane,Sheffield
2020/21,1,25,West Ham United,14,1,0,0,1,0,2,-2,0,1,0,0,1,0,2,-2,0,0,0,0,0,0,0,0,0,,,London Stadium,London
2020/21,1,34,Fulham,15,1,0,0,1,0,3,-3,0,1,0,0,1,0,3,-3,0,0,0,0,0,0,0,0,0,,,Craven Cottage,London
2020/21,1,36,West Bromwich Albion,16,1,0,0,1,0,3,-3,0,1,0,0,1,0,3,-3,0,0,0,0,0,0,0,0,0,,,The Hawthorns,West Bromwich
2020/21,2,26,Leicester City,1,2,2,0,0,7,2,5,6,1,1,0,0,4,2,2,3,1,1,0,0,3,0,3,3,Q,EU_CL,King Power Stadium,Leicester
2020/21,2,7,Everton,2,2,2,0,0,6,2,4,6,1,1,0,0,5,2,3,3,1,1,0,0,1,0,1,3,Q,EU_CL,Goodison Park,Liverpool
2020/21,2,1,Arsenal,3,2,2,0,0,5,1,4,6,1,1,0,0,2,1,1,3,1,1,0,0,3,0,3,3,Q,EU_CL,Emirates Stadium,London
2020/21,2,10,Liverpool,4,2,2,0,0,6,3,3,6,1,1,0,0,4,3,1,3,1,1,0,0,2,0,2,3,Q,EU_CL,Anfield,Liverpool
2020/21,2,6,Crystal Palace,5,2,2,0,0,4,1,3,6,1,1,0,0,1,0,1,3,1,1,0,0,3,1,2,3,Q,EU_UC,Selhurst Park,London
2020/21,2,21,Tottenham Hotspur,6,2,1,0,1,5,3,2,3,1,0,0,1,0,1,-1,0,1,1,0,0,5,2,3,3,Q,EU_UC,Tottenham Hotspur Stadium,London
2020/21,2,11,Manchester City,7,1,1,0,0,3,1,2,3,0,0,0,0,0,0,0,0,1,1,0,0,3,1,2,3,,,Etihad Stadium,Manchester
2020/21,2,131,Brighton & Hove Albion,8,2,1,0,1,4,3,1,3,1,0,0,1,1,3,-2,0,1,1,0,0,3,0,3,3,,,American Express Stadium,Falmer
2020/21,2,2,Aston Villa,9,1,1,0,0,1,0,1,3,1,1,0,0,1,0,1,3,0,0,0,0,0,0,0,0,,,Villa Park,Birmingham
2020/21,2,9,Leeds United,10,2,1,0,1,7,7,0,3,1,1,0,0,4,3,1,3,1,0,0,1,3,4,-1,0,,,Elland Road,Leeds
2020/21,2,4,Chelsea,11,2,1,0,1,3,3,0,3,1,0,0,1,0,2,-2,0,1,1,0,0,3,1,2,3,,,Stamford Bridge,London
2020/21,2,38,Wolverhampton Wanderers,12,2,1,0,1,3,3,0,3,1,0,0,1,1,3,-2,0,1,1,0,0,2,0,2,3,,,Molineux Stadium,Wolverhampton
2020/21,2,23,Newcastle United,13,2,1,0,1,2,3,-1,3,1,0,0,1,0,3,-3,0,1,1,0,0,2,0,2,3,,,St. James' Park,Newcastle
2020/21,2,43,Burnley,14,1,0,0,1,2,4,-2,0,0,0,0,0,0,0,0,0,1,0,0,1,2,4,-2,0,,,Turf Moor,Burnley
2020/21,2,12,Manchester United,15,1,0,0,1,1,3,-2,0,1,0,0,1,1,3,-2,0,0,0,0,0,0,0,0,0,,,Old Trafford,Manchester
2020/21,2,25,West Ham United,16,2,0,0,2,1,4,-3,0,1,0,0,1,0,2,-2,0,1,0,0,1,1,2,-1,0,,,London Stadium,London
2020/21,2,18,Sheffield United,17,2,0,0,2,0,3,-3,0,1,0,0,1,0,2,-2,0,1,0,0,1,0,1,-1,0,,,Bramall Lane,Sheffield
2020/21,2,34,Fulham,18,2,0,0,2,3,7,-4,0,1,0,0,1,0,3,-3,0,1,0,0,1,3,4,-1,0,,,Craven Cottage,London
2020/21,2,20,Southampton,19,2,0,0,2,2,6,-4,0,1,0,0,1,2,5,-3,0,1,0,0,1,0,1,-1,0,,,St. Mary's Stadium,Southampton
2020/21,2,36,West Bromwich Albion,20,2,0,0,2,2,8,-6,0,1,0,0,1,0,3,-3,0,1,0,0,1,2,5,-3,0,,,The Hawthorns,West Bromwich
2020/21,3,26,Leicester City,1,3,3,0,0,12,4,8,9,1,1,0,0,4,2,2,3,2,2,0,0,8,2,6,6,Q,EU_CL,King Power Stadium,Leicester
2020/21,3,10,Liverpool,2,3,3,0,0,9,4,5,9,2,2,0,0,7,4,3,6,1,1,0,0,2,0,2,3,Q,EU_CL,Anfield,Liverpool
2020/21,3,7,Everton,3,3,3,0,0,8,3,5,9,1,1,0,0,5,2,3,3,2,2,0,0,3,1,2,6,Q,EU_CL,Goodison Park,Liverpool
2020/21,3,2,Aston Villa,4,2,2,0,0,4,0,4,6,1,1,0,0,1,0,1,3,1,1,0,0,3,0,3,3,Q,EU_CL,Villa Park,Birmingham
2020/21,3,1,Arsenal,5,3,2,0,1,6,4,2,6,1,1,0,0,2,1,1,3,2,1,0,1,4,3,1,3,Q,EU_UC,Emirates Stadium,London
2020/21,3,6,Crystal Palace,6,3,2,0,1,5,3,2,6,2,1,0,1,2,2,0,3,1,1,0,0,3,1,2,3,Q,EU_UC,Selhurst Park,London
2020/21,3,9,Leeds United,7,3,2,0,1,8,7,1,6,1,1,0,0,4,3,1,3,2,1,0,1,4,4,0,3,,,Elland Road,Leeds
2020/21,3,21,Tottenham Hotspur,8,3,1,1,1,6,4,2,4,2,0,1,1,1,2,-1,1,1,1,0,0,5,2,3,3,,,Tottenham Hotspur Stadium,London
2020/21,3,4,Chelsea,9,3,1,1,1,6,6,0,4,1,0,0,1,0,2,-2,0,2,1,1,0,6,4,2,4,,,Stamford Bridge,London
2020/21,3,23,Newcastle United,10,3,1,1,1,3,4,-1,4,1,0,0,1,0,3,-3,0,2,1,1,0,3,1,2,4,,,St. James' Park,Newcastle
2020/21,3,25,West Ham United,11,3,1,0,2,5,4,1,3,2,1,0,1,4,2,2,3,1,0,0,1,1,2,-1,0,,,London Stadium,London
2020/21,3,131,Brighton & Hove Albion,12,3,1,0,2,6,6,0,3,2,0,0,2,3,6,-3,0,1,1,0,0,3,0,3,3,,,American Express Stadium,Falmer
2020/21,3,11,Manchester City,13,2,1,0,1,5,6,-1,3,1,0,0,1,2,5,-3,0,1,1,0,0,3,1,2,3,,,Etihad Stadium,Manchester
2020/21,3,12,Manchester United,14,2,1,0,1,4,5,-1,3,1,0,0,1,1,3,-2,0,1,1,0,0,3,2,1,3,,,Old Trafford,Manchester
2020/21,3,20,Southampton,15,3,1,0,2,3,6,-3,3,1,0,0,1,2,5,-3,0,2,1,0,1,1,1,0,3,,,St. Mary's Stadium,Southampton
2020/21,3,38,Wolverhampton Wanderers,16,3,1,0,2,3,7,-4,3,1,0,0,1,1,3,-2,0,2,1,0,1,2,4,-2,3,,,Molineux Stadium,Wolverhampton
2020/21,3,36,West Bromwich Albion,17,3,0,1,2,5,11,-6,1,2,0,1,1,3,6,-3,1,1,0,0,1,2,5,-3,0,,,The Hawthorns,West Bromwich
2020/21,3,43,Burnley,18,2,0,0,2,2,5,-3,0,1,0,0,1,0,1,-1,0,1,0,0,1,2,4,-2,0,,,Turf Moor,Burnley
2020/21,3,18,Sheffield United,19,3,0,0,3,0,4,-4,0,2,0,0,2,0,3,-3,0,1,0,0,1,0,1,-1,0,,,Bramall Lane,Sheffield
2020/21,3,34,Fulham,20,3,0,0,3,3,10,-7,0,2,0,0,2,0,6,-6,0,1,0,0,1,3,4,-1,0,,,Craven Cottage,London
2020/21,4,7,Everton,1,4,4,0,0,12,5,7,12,2,2,0,0,9,4,5,6,2,2,0,0,3,1,2,6,Q,EU_CL,Goodison Park,Liverpool
2020/21,4,2,Aston Villa,2,3,3,0,0,11,2,9,9,2,2,0,0,8,2,6,6,1,1,0,0,3,0,3,3,Q,EU_CL,Villa Park,Birmingham
2020/21,4,26,Leicester City,3,4,3,0,1,12,7,5,9,2,1,0,1,4,5,-1,3,2,2,0,0,8,2,6,6,Q,EU_CL,King Power Stadium,Leicester
2020/21,4,1,Arsenal,4,4,3,0,1,8,5,3,9,2,2,0,0,4,2,2,6,2,1,0,1,4,3,1,3,Q,EU_CL,Emirates Stadium,London
2020/21,4,10,Liverpool,5,4,3,0,1,11,11,0,9,2,2,0,0,7,4,3,6,2,1,0,1,4,7,-3,3,Q,EU_UC,Anfield,Liverpool
2020/21,4,21,Tottenham Hotspur,6,4,2,1,1,12,5,7,7,2,0,1,1,1,2,-1,1,2,2,0,0,11,3,8,6,Q,EU_UC,Tottenham Hotspur Stadium,London
2020/21,4,4,Chelsea,7,4,2,1,1,10,6,4,7,2,1,0,1,4,2,2,3,2,1,1,0,6,4,2,4,,,Stamford Bridge,London
2020/21,4,9,Leeds United,8,4,2,1,1,9,8,1,7,2,1,1,0,5,4,1,4,2,1,0,1,4,4,0,3,,,Elland Road,Leeds
2020/21,4,23,Newcastle United,9,4,2,1,1,6,5,1,7,2,1,0,1,3,4,-1,3,2,1,1,0,3,1,2,4,,,St. James' Park,Newcastle
2020/21,4,25,West Ham United,10,4,2,0,2,8,4,4,6,2,1,0,1,4,2,2,3,2,1,0,1,4,2,2,3,,,London Stadium,London
2020/21,4,20,Southampton,11,4,2,0,2,5,6,-1,6,2,1,0,1,4,5,-1,3,2,1,0,1,1,1,0,3,,,St. Mary's Stadium,Southampton
2020/21,4,6,Crystal Palace,12,4,2,0,2,5,7,-2,6,2,1,0,1,2,2,0,3,2,1,0,1,3,5,-2,3,,,Selhurst Park,London
2020/21,4,38,Wolverhampton Wanderers,13,4,2,0,2,4,7,-3,6,2,1,0,1,2,3,-1,3,2,1,0,1,2,4,-2,3,,,Molineux Stadium,Wolverhampton
2020/21,4,11,Manchester City,14,3,1,1,1,6,7,-1,4,1,0,0,1,2,5,-3,0,2,1,1,0,4,2,2,4,,,Etihad Stadium,Manchester
2020/21,4,131,Brighton & Hove Albion,15,4,1,0,3,8,10,-2,3,2,0,0,2,3,6,-3,0,2,1,0,1,5,4,1,3,,,American Express Stadium,Falmer
2020/21,4,12,Manchester United,16,3,1,0,2,5,11,-6,3,2,0,0,2,2,9,-7,0,1,1,0,0,3,2,1,3,,,Old Trafford,Manchester
2020/21,4,36,West Bromwich Albion,17,4,0,1,3,5,13,-8,1,2,0,1,1,3,6,-3,1,2,0,0,2,2,7,-5,0,,,The Hawthorns,West Bromwich
2020/21,4,43,Burnley,18,3,0,0,3,3,8,-5,0,1,0,0,1,0,1,-1,0,2,0,0,2,3,7,-4,0,,,Turf Moor,Burnley
2020/21,4,18,Sheffield United,19,4,0,0,4,1,6,-5,0,2,0,0,2,0,3,-3,0,2,0,0,2,1,3,-2,0,,,Bramall Lane,Sheffield
2020/21,4,34,Fulham,20,4,0,0,4,3,11,-8,0,2,0,0,2,0,6,-6,0,2,0,0,2,3,5,-2,0,,,Craven Cottage,London
2020/21,5,7,Everton,1,5,4,1,0,14,7,7,13,3,2,1,0,11,6,5,7,2,2,0,0,3,1,2,6,Q,EU_CL,Goodison Park,Liverpool
2020/21,5,2,Aston Villa,2,4,4,0,0,12,2,10,12,2,2,0,0,8,2,6,6,2,2,0,0,4,0,4,6,Q,EU_CL,Villa Park,Birmingham
2020/21,5,10,Liverpool,3,5,3,1,1,13,13,0,10,2,2,0,0,7,4,3,6,3,1,1,1,6,9,-3,4,Q,EU_CL,Anfield,Liverpool
2020/21,5,26,Leicester City,4,5,3,0,2,12,8,4,9,3,1,0,2,4,6,-2,3,2,2,0,0,8,2,6,6,Q,EU_CL,King Power Stadium,Leicester
2020/21,5,1,Arsenal,5,5,3,0,2,8,6,2,9,2,2,0,0,4,2,2,6,3,1,0,2,4,4,0,3,Q,EU_UC,Emirates Stadium,London
2020/21,5,38,Wolverhampton Wanderers,6,5,3,0,2,5,7,-2,9,2,1,0,1,2,3,-1,3,3,2,0,1,3,4,-1,6,Q,EU_UC,Molineux Stadium,Wolverhampton
2020/21,5,21,Tottenham Hotspur,7,5,2,2,1,15,8,7,8,3,0,2,1,4,5,-1,2,2,2,0,0,11,3,8,6,,,Tottenham Hotspur Stadium,London
2020/21,5,4,Chelsea,8,5,2,2,1,13,9,4,8,3,1,1,1,7,5,2,4,2,1,1,0,6,4,2,4,,,Stamford Bridge,London
2020/21,5,25,West Ham United,9,5,2,1,2,11,7,4,7,2,1,0,1,4,2,2,3,3,1,1,1,7,5,2,4,,,London Stadium,London
2020/21,5,9,Leeds United,10,5,2,1,2,9,9,0,7,3,1,1,1,5,5,0,4,2,1,0,1,4,4,0,3,,,Elland Road,Leeds
2020/21,5,11,Manchester City,11,4,2,1,1,7,7,0,7,2,1,0,1,3,5,-2,3,2,1,1,0,4,2,2,4,,,Etihad Stadium,Manchester
2020/21,5,20,Southampton,12,5,2,1,2,8,9,-1,7,2,1,0,1,4,5,-1,3,3,1,1,1,4,4,0,4,,,St. Mary's Stadium,Southampton
2020/21,5,23,Newcastle United,13,5,2,1,2,7,9,-2,7,3,1,0,2,4,8,-4,3,2,1,1,0,3,1,2,4,,,St. James' Park,Newcastle
2020/21,5,6,Crystal Palace,14,5,2,1,2,6,8,-2,7,3,1,1,1,3,3,0,4,2,1,0,1,3,5,-2,3,,,Selhurst Park,London
2020/21,5,12,Manchester United,15,4,2,0,2,9,12,-3,6,2,0,0,2,2,9,-7,0,2,2,0,0,7,3,4,6,,,Old Trafford,Manchester
2020/21,5,131,Brighton & Hove Albion,16,5,1,1,3,9,11,-2,4,2,0,0,2,3,6,-3,0,3,1,1,1,6,5,1,4,,,American Express Stadium,Falmer
2020/21,5,36,West Bromwich Albion,17,5,0,2,3,5,13,-8,2,3,0,2,1,3,6,-3,2,2,0,0,2,2,7,-5,0,,,The Hawthorns,West Bromwich
2020/21,5,43,Burnley,18,4,0,1,3,3,8,-5,1,1,0,0,1,0,1,-1,0,3,0,1,2,3,7,-4,1,,,Turf Moor,Burnley
2020/21,5,18,Sheffield United,19,5,0,1,4,2,7,-5,1,3,0,1,2,1,4,-3,1,2,0,0,2,1,3,-2,0,,,Bramall Lane,Sheffield
2020/21,5,34,Fulham,20,5,0,1,4,4,12,-8,1,2,0,0,2,0,6,-6,0,3,0,1,2,4,6,-2,1,,,Craven Cottage,London
2020/21,6,7,Everton,1,6,4,1,1,14,9,5,13,3,2,1,0,11,6,5,7,3,2,0,1,3,3,0,6,Q,EU_CL,Goodison Park,Liverpool
2020/21,6,10,Liverpool,2,6,4,1,1,15,14,1,13,3,3,0,0,9,5,4,9,3,1,1,1,6,9,-3,4,Q,EU_CL,Anfield,Liverpool
2020/21,6,2,Aston Villa,3,5,4,0,1,12,5,7,12,3,2,0,1,8,5,3,6,2,2,0,0,4,0,4,6,Q,EU_CL,Villa Park,Birmingham
2020/21,6,26,Leicester City,4,6,4,0,2,13,8,5,12,3,1,0,2,4,6,-2,3,3,3,0,0,9,2,7,9,Q,EU_CL,King Power Stadium,Leicester
2020/21,6,21,Tottenham Hotspur,5,6,3,2,1,16,8,8,11,3,0,2,1,4,5,-1,2,3,3,0,0,12,3,9,9,Q,EU_UC,Tottenham Hotspur Stadium,London
2020/21,6,9,Leeds United,6,6,3,1,2,12,9,3,10,3,1,1,1,5,5,0,4,3,2,0,1,7,4,3,6,Q,EU_UC,Elland Road,Leeds
2020/21,6,20,Southampton,7,6,3,1,2,10,9,1,10,3,2,0,1,6,5,1,6,3,1,1,1,4,4,0,4,,,St. Mary's Stadium,Southampton
2020/21,6,6,Crystal Palace,8,6,3,1,2,8,9,-1,10,3,1,1,1,3,3,0,4,3,2,0,1,5,6,-1,6,,,Selhurst Park,London
2020/21,6,38,Wolverhampton Wanderers,9,6,3,1,2,6,8,-2,10,3,1,1,1,3,4,-1,4,3,2,0,1,3,4,-1,6,,,Molineux Stadium,Wolverhampton
2020/21,6,4,Chelsea,10,6,2,3,1,13,9,4,9,3,1,1,1,7,5,2,4,3,1,2,0,6,4,2,5,,,Stamford Bridge,London
2020/21,6,1,Arsenal,11,6,3,0,3,8,7,1,9,3,2,0,1,4,3,1,6,3,1,0,2,4,4,0,3,,,Emirates Stadium,London
2020/21,6,25,West Ham United,12,6,2,2,2,12,8,4,8,3,1,1,1,5,3,2,4,3,1,1,1,7,5,2,4,,,London Stadium,London
2020/21,6,11,Manchester City,13,5,2,2,1,8,8,0,8,2,1,0,1,3,5,-2,3,3,1,2,0,5,3,2,5,,,Etihad Stadium,Manchester
2020/21,6,23,Newcastle United,14,6,2,2,2,8,10,-2,8,3,1,0,2,4,8,-4,3,3,1,2,0,4,2,2,5,,,St. James' Park,Newcastle
2020/21,6,12,Manchester United,15,5,2,1,2,9,12,-3,7,3,0,1,2,2,9,-7,1,2,2,0,0,7,3,4,6,,,Old Trafford,Manchester
2020/21,6,131,Brighton & Hove Albion,16,6,1,2,3,10,12,-2,5,3,0,1,2,4,7,-3,1,3,1,1,1,6,5,1,4,,,American Express Stadium,Falmer
2020/21,6,36,West Bromwich Albion,17,6,0,3,3,6,14,-8,3,3,0,2,1,3,6,-3,2,3,0,1,2,3,8,-5,1,,,The Hawthorns,West Bromwich
2020/21,6,43,Burnley,18,5,0,1,4,3,9,-6,1,2,0,0,2,0,2,-2,0,3,0,1,2,3,7,-4,1,,,Turf Moor,Burnley
2020/21,6,18,Sheffield United,19,6,0,1,5,3,9,-6,1,3,0,1,2,1,4,-3,1,3,0,0,3,2,5,-3,0,,,Bramall Lane,Sheffield
2020/21,6,34,Fulham,20,6,0,1,5,5,14,-9,1,3,0,0,3,1,8,-7,0,3,0,1,2,4,6,-2,1,,,Craven Cottage,London
2020/21,7,10,Liverpool,1,7,5,1,1,17,15,2,16,4,4,0,0,11,6,5,12,3,1,1,1,6,9,-3,4,Q,EU_CL,Anfield,Liverpool
2020/21,7,26,Leicester City,2,7,5,0,2,17,9,8,15,3,1,0,2,4,6,-2,3,4,4,0,0,13,3,10,12,Q,EU_CL,King Power Stadium,Leicester
2020/21,7,21,Tottenham Hotspur,3,7,4,2,1,18,9,9,14,4,1,2,1,6,6,0,5,3,3,0,0,12,3,9,9,Q,EU_CL,Tottenham Hotspur Stadium,London
2020/21,7,7,Everton,4,7,4,1,2,15,11,4,13,3,2,1,0,11,6,5,7,4,2,0,2,4,5,-1,6,Q,EU_CL,Goodison Park,Liverpool
2020/21,7,20,Southampton,5,7,4,1,2,14,12,2,13,3,2,0,1,6,5,1,6,4,2,1,1,8,7,1,7,Q,EU_UC,St. Mary's Stadium,Southampton
2020/21,7,38,Wolverhampton Wanderers,6,7,4,1,2,8,8,0,13,4,2,1,1,5,4,1,7,3,2,0,1,3,4,-1,6,Q,EU_UC,Molineux Stadium,Wolverhampton
2020/21,7,4,Chelsea,7,7,3,3,1,16,9,7,12,3,1,1,1,7,5,2,4,4,2,2,0,9,4,5,8,,,Stamford Bridge,London
2020/21,7,2,Aston Villa,8,6,4,0,2,15,9,6,12,4,2,0,2,11,9,2,6,2,2,0,0,4,0,4,6,,,Villa Park,Birmingham
2020/21,7,1,Arsenal,9,7,4,0,3,9,7,2,12,3,2,0,1,4,3,1,6,4,2,0,2,5,4,1,6,,,Emirates Stadium,London
2020/21,7,11,Manchester City,10,6,3,2,1,9,8,1,11,2,1,0,1,3,5,-2,3,4,2,2,0,6,3,3,8,,,Etihad Stadium,Manchester
2020/21,7,23,Newcastle United,11,7,3,2,2,10,11,-1,11,4,2,0,2,6,9,-3,6,3,1,2,0,4,2,2,5,,,St. James' Park,Newcastle
2020/21,7,9,Leeds United,12,7,3,1,3,13,13,0,10,4,1,1,2,6,9,-3,4,3,2,0,1,7,4,3,6,,,Elland Road,Leeds
2020/21,7,6,Crystal Palace,13,7,3,1,3,8,11,-3,10,3,1,1,1,3,3,0,4,4,2,0,2,5,8,-3,6,,,Selhurst Park,London
2020/21,7,25,West Ham United,14,7,2,2,3,13,10,3,8,3,1,1,1,5,3,2,4,4,1,1,2,8,7,1,4,,,London Stadium,London
2020/21,7,12,Manchester United,15,6,2,1,3,9,13,-4,7,4,0,1,3,2,10,-8,1,2,2,0,0,7,3,4,6,,,Old Trafford,Manchester
2020/21,7,131,Brighton & Hove Albion,16,7,1,2,4,11,14,-3,5,3,0,1,2,4,7,-3,1,4,1,1,2,7,7,0,4,,,American Express Stadium,Falmer
2020/21,7,34,Fulham,17,7,1,1,5,7,14,-7,4,4,1,0,3,3,8,-5,3,3,0,1,2,4,6,-2,1,,,Craven Cottage,London
2020/21,7,36,West Bromwich Albion,18,7,0,3,4,6,16,-10,3,3,0,2,1,3,6,-3,2,4,0,1,3,3,10,-7,1,,,The Hawthorns,West Bromwich
2020/21,7,18,Sheffield United,19,7,0,1,6,3,10,-7,1,4,0,1,3,1,5,-4,1,3,0,0,3,2,5,-3,0,,,Bramall Lane,Sheffield
2020/21,7,43,Burnley,20,6,0,1,5,3,12,-9,1,3,0,0,3,0,5,-5,0,3,0,1,2,3,7,-4,1,,,Turf Moor,Burnley
2020/21,8,26,Leicester City,1,8,6,0,2,18,9,9,18,4,2,0,2,5,6,-1,6,4,4,0,0,13,3,10,12,Q,EU_CL,King Power Stadium,Leicester
2020/21,8,21,Tottenham Hotspur,2,8,5,2,1,19,9,10,17,4,1,2,1,6,6,0,5,4,4,0,0,13,3,10,12,Q,EU_CL,Tottenham Hotspur Stadium,London
2020/21,8,10,Liverpool,3,8,5,2,1,18,16,2,17,4,4,0,0,11,6,5,12,4,1,2,1,7,10,-3,5,Q,EU_CL,Anfield,Liverpool
2020/21,8,20,Southampton,4,8,5,1,2,16,12,4,16,4,3,0,1,8,5,3,9,4,2,1,1,8,7,1,7,Q,EU_CL,St. Mary's Stadium,Southampton
2020/21,8,4,Chelsea,5,8,4,3,1,20,10,10,15,4,2,1,1,11,6,5,7,4,2,2,0,9,4,5,8,Q,EU_UC,Stamford Bridge,London
2020/21,8,2,Aston Villa,6,7,5,0,2,18,9,9,15,4,2,0,2,11,9,2,6,3,3,0,0,7,0,7,9,Q,EU_UC,Villa Park,Birmingham
2020/21,8,7,Everton,7,8,4,1,3,16,14,2,13,4,2,1,1,12,9,3,7,4,2,0,2,4,5,-1,6,,,Goodison Park,Liverpool
2020/21,8,6,Crystal Palace,8,8,4,1,3,12,12,0,13,4,2,1,1,7,4,3,7,4,2,0,2,5,8,-3,6,,,Selhurst Park,London
2020/21,8,38,Wolverhampton Wanderers,9,8,4,1,3,8,9,-1,13,4,2,1,1,5,4,1,7,4,2,0,2,3,5,-2,6,,,Molineux Stadium,Wolverhampton
2020/21,8,11,Manchester City,10,7,3,3,1,10,9,1,12,3,1,1,1,4,6,-2,4,4,2,2,0,6,3,3,8,,,Etihad Stadium,Manchester
2020/21,8,1,Arsenal,11,8,4,0,4,9,10,-1,12,4,2,0,2,4,6,-2,6,4,2,0,2,5,4,1,6,,,Emirates Stadium,London
2020/21,8,25,West Ham United,12,8,3,2,3,14,10,4,11,4,2,1,1,6,3,3,7,4,1,1,2,8,7,1,4,,,London Stadium,London
2020/21,8,23,Newcastle United,13,8,3,2,3,10,13,-3,11,4,2,0,2,6,9,-3,6,4,1,2,1,4,4,0,5,,,St. James' Park,Newcastle
2020/21,8,12,Manchester United,14,7,3,1,3,12,14,-2,10,4,0,1,3,2,10,-8,1,3,3,0,0,10,4,6,9,,,Old Trafford,Manchester
2020/21,8,9,Leeds United,15,8,3,1,4,14,17,-3,10,4,1,1,2,6,9,-3,4,4,2,0,2,8,8,0,6,,,Elland Road,Leeds
2020/21,8,131,Brighton & Hove Albion,16,8,1,3,4,11,14,-3,6,4,0,2,2,4,7,-3,2,4,1,1,2,7,7,0,4,,,American Express Stadium,Falmer
2020/21,8,34,Fulham,17,8,1,1,6,7,15,-8,4,4,1,0,3,3,8,-5,3,4,0,1,3,4,7,-3,1,,,Craven Cottage,London
2020/21,8,36,West Bromwich Albion,18,8,0,3,5,6,17,-11,3,4,0,2,2,3,7,-4,2,4,0,1,3,3,10,-7,1,,,The Hawthorns,West Bromwich
2020/21,8,43,Burnley,19,7,0,2,5,3,12,-9,2,3,0,0,3,0,5,-5,0,4,0,2,2,3,7,-4,2,,,Turf Moor,Burnley
2020/21,8,18,Sheffield United,20,8,0,1,7,4,14,-10,1,4,0,1,3,1,5,-4,1,4,0,0,4,3,9,-6,0,,,Bramall Lane,Sheffield
2020/21,9,21,Tottenham Hotspur,1,9,6,2,1,21,9,12,20,5,2,2,1,8,6,2,8,4,4,0,0,13,3,10,12,Q,EU_CL,Tottenham Hotspur Stadium,London
2020/21,9,10,Liverpool,2,9,6,2,1,21,16,5,20,5,5,0,0,14,6,8,15,4,1,2,1,7,10,-3,5,Q,EU_CL,Anfield,Liverpool
2020/21,9,4,Chelsea,3,9,5,3,1,22,10,12,18,4,2,1,1,11,6,5,7,5,3,2,0,11,4,7,11,Q,EU_CL,Stamford Bridge,London
2020/21,9,26,Leicester City,4,9,6,0,3,18,12,6,18,4,2,0,2,5,6,-1,6,5,4,0,1,13,6,7,12,Q,EU_CL,King Power Stadium,Leicester
2020/21,9,20,Southampton,5,9,5,2,2,17,13,4,17,4,3,0,1,8,5,3,9,5,2,2,1,9,8,1,8,Q,EU_UC,St. Mary's Stadium,Southampton
2020/21,9,7,Everton,6,9,5,1,3,19,16,3,16,4,2,1,1,12,9,3,7,5,3,0,2,7,7,0,9,Q,EU_UC,Goodison Park,Liverpool
2020/21,9,2,Aston Villa,7,8,5,0,3,19,11,8,15,5,2,0,3,12,11,1,6,3,3,0,0,7,0,7,9,,,Villa Park,Birmingham
2020/21,9,25,West Ham United,8,9,4,2,3,15,10,5,14,4,2,1,1,6,3,3,7,5,2,1,2,9,7,2,7,,,London Stadium,London
2020/21,9,38,Wolverhampton Wanderers,9,9,4,2,3,9,10,-1,14,5,2,2,1,6,5,1,8,4,2,0,2,3,5,-2,6,,,Molineux Stadium,Wolverhampton
2020/21,9,12,Manchester United,10,8,4,1,3,13,14,-1,13,5,1,1,3,3,10,-7,4,3,3,0,0,10,4,6,9,,,Old Trafford,Manchester
2020/21,9,6,Crystal Palace,11,9,4,1,4,12,13,-1,13,4,2,1,1,7,4,3,7,5,2,0,3,5,9,-4,6,,,Selhurst Park,London
2020/21,9,1,Arsenal,12,9,4,1,4,9,10,-1,13,4,2,0,2,4,6,-2,6,5,2,1,2,5,4,1,7,,,Emirates Stadium,London
2020/21,9,11,Manchester City,13,8,3,3,2,10,11,-1,12,3,1,1,1,4,6,-2,4,5,2,2,1,6,5,1,8,,,Etihad Stadium,Manchester
2020/21,9,9,Leeds United,14,9,3,2,4,14,17,-3,11,5,1,2,2,6,9,-3,5,4,2,0,2,8,8,0,6,,,Elland Road,Leeds
2020/21,9,23,Newcastle United,15,9,3,2,4,10,15,-5,11,5,2,0,3,6,11,-5,6,4,1,2,1,4,4,0,5,,,St. James' Park,Newcastle
2020/21,9,131,Brighton & Hove Albion,16,9,2,3,4,13,15,-2,9,4,0,2,2,4,7,-3,2,5,2,1,2,9,8,1,7,,,American Express Stadium,Falmer
2020/21,9,43,Burnley,17,8,1,2,5,4,12,-8,5,4,1,0,3,1,5,-4,3,4,0,2,2,3,7,-4,2,,,Turf Moor,Burnley
2020/21,9,34,Fulham,18,9,1,1,7,9,18,-9,4,5,1,0,4,5,11,-6,3,4,0,1,3,4,7,-3,1,,,Craven Cottage,London
2020/21,9,36,West Bromwich Albion,19,9,0,3,6,6,18,-12,3,4,0,2,2,3,7,-4,2,5,0,1,4,3,11,-8,1,,,The Hawthorns,West Bromwich
2020/21,9,18,Sheffield United,20,9,0,1,8,4,15,-11,1,5,0,1,4,1,6,-5,1,4,0,0,4,3,9,-6,0,,,Bramall Lane,Sheffield
2020/21,10,21,Tottenham Hotspur,1,10,6,3,1,21,9,12,21,5,2,2,1,8,6,2,8,5,4,1,0,13,3,10,13,Q,EU_CL,Tottenham Hotspur Stadium,London
2020/21,10,10,Liverpool,2,10,6,3,1,22,17,5,21,5,5,0,0,14,6,8,15,5,1,3,1,8,11,-3,6,Q,EU_CL,Anfield,Liverpool
2020/21,10,4,Chelsea,3,10,5,4,1,22,10,12,19,5,2,2,1,11,6,5,8,5,3,2,0,11,4,7,11,Q,EU_CL,Stamford Bridge,London
2020/21,10,26,Leicester City,4,10,6,0,4,19,14,5,18,5,2,0,3,6,8,-2,6,5,4,0,1,13,6,7,12,Q,EU_CL,King Power Stadium,Leicester
2020/21,10,25,West Ham United,5,10,5,2,3,17,11,6,17,5,3,1,1,8,4,4,10,5,2,1,2,9,7,2,7,Q,EU_UC,London Stadium,London
2020/21,10,20,Southampton,6,10,5,2,3,19,16,3,17,5,3,0,2,10,8,2,9,5,2,2,1,9,8,1,8,Q,EU_UC,St. Mary's Stadium,Southampton
2020/21,10,38,Wolverhampton Wanderers,7,10,5,2,3,11,11,0,17,5,2,2,1,6,5,1,8,5,3,0,2,5,6,-1,9,,,Molineux Stadium,Wolverhampton
2020/21,10,7,Everton,8,10,5,1,4,19,17,2,16,5,2,1,2,12,10,2,7,5,3,0,2,7,7,0,9,,,Goodison Park,Liverpool
2020/21,10,12,Manchester United,9,9,5,1,3,16,16,0,16,5,1,1,3,3,10,-7,4,4,4,0,0,13,6,7,12,,,Old Trafford,Manchester
2020/21,10,2,Aston Villa,10,9,5,0,4,20,13,7,15,5,2,0,3,12,11,1,6,4,3,0,1,8,2,6,9,,,Villa Park,Birmingham
2020/21,10,11,Manchester City,11,9,4,3,2,15,11,4,15,4,2,1,1,9,6,3,7,5,2,2,1,6,5,1,8,,,Etihad Stadium,Manchester
2020/21,10,9,Leeds United,12,10,4,2,4,15,17,-2,14,5,1,2,2,6,9,-3,5,5,3,0,2,9,8,1,9,,,Elland Road,Leeds
2020/21,10,23,Newcastle United,13,10,4,2,4,12,15,-3,14,5,2,0,3,6,11,-5,6,5,2,2,1,6,4,2,8,,,St. James' Park,Newcastle
2020/21,10,1,Arsenal,14,10,4,1,5,10,12,-2,13,5,2,0,3,5,8,-3,6,5,2,1,2,5,4,1,7,,,Emirates Stadium,London
2020/21,10,6,Crystal Palace,15,10,4,1,5,12,15,-3,13,5,2,1,2,7,6,1,7,5,2,0,3,5,9,-4,6,,,Selhurst Park,London
2020/21,10,131,Brighton & Hove Albion,16,10,2,4,4,14,16,-2,10,5,0,3,2,5,8,-3,3,5,2,1,2,9,8,1,7,,,American Express Stadium,Falmer
2020/21,10,34,Fulham,17,10,2,1,7,11,19,-8,7,5,1,0,4,5,11,-6,3,5,1,1,3,6,8,-2,4,,,Craven Cottage,London
2020/21,10,36,West Bromwich Albion,18,10,1,3,6,7,18,-11,6,5,1,2,2,4,7,-3,5,5,0,1,4,3,11,-8,1,,,The Hawthorns,West Bromwich
2020/21,10,43,Burnley,19,9,1,2,6,4,17,-13,5,4,1,0,3,1,5,-4,3,5,0,2,3,3,12,-9,2,,,Turf Moor,Burnley
2020/21,10,18,Sheffield United,20,10,0,1,9,4,16,-12,1,5,0,1,4,1,6,-5,1,5,0,0,5,3,10,-7,0,,,Bramall Lane,Sheffield
2020/21,11,21,Tottenham Hotspur,1,11,7,3,1,23,9,14,24,6,3,2,1,10,6,4,11,5,4,1,0,13,3,10,13,Q,EU_CL,Tottenham Hotspur Stadium,London
2020/21,11,10,Liverpool,2,11,7,3,1,26,17,9,24,6,6,0,0,18,6,12,18,5,1,3,1,8,11,-3,6,Q,EU_CL,Anfield,Liverpool
2020/21,11,4,Chelsea,3,11,6,4,1,25,11,14,22,6,3,2,1,14,7,7,11,5,3,2,0,11,4,7,11,Q,EU_CL,Stamford Bridge,London
2020/21,11,26,Leicester City,4,11,7,0,4,21,15,6,21,5,2,0,3,6,8,-2,6,6,5,0,1,15,7,8,15,Q,EU_CL,King Power Stadium,Leicester
2020/21,11,20,Southampton,5,11,6,2,3,21,17,4,20,5,3,0,2,10,8,2,9,6,3,2,1,11,9,2,11,Q,EU_UC,St. Mary's Stadium,Southampton
2020/21,11,12,Manchester United,6,10,6,1,3,19,17,2,19,5,1,1,3,3,10,-7,4,5,5,0,0,16,7,9,15,Q,EU_UC,Old Trafford,Manchester
2020/21,11,11,Manchester City,7,10,5,3,2,17,11,6,18,5,3,1,1,11,6,5,10,5,2,2,1,6,5,1,8,,,Etihad Stadium,Manchester
2020/21,11,25,West Ham United,8,11,5,2,4,18,14,4,17,6,3,1,2,9,7,2,10,5,2,1,2,9,7,2,7,,,London Stadium,London
2020/21,11,7,Everton,9,11,5,2,4,20,18,2,17,5,2,1,2,12,10,2,7,6,3,1,2,8,8,0,10,,,Goodison Park,Liverpool
2020/21,11,38,Wolverhampton Wanderers,10,11,5,2,4,11,15,-4,17,5,2,2,1,6,5,1,8,6,3,0,3,5,10,-5,9,,,Molineux Stadium,Wolverhampton
2020/21,11,6,Crystal Palace,11,11,5,1,5,17,16,1,16,5,2,1,2,7,6,1,7,6,3,0,3,10,10,0,9,,,Selhurst Park,London
2020/21,11,2,Aston Villa,12,9,5,0,4,20,13,7,15,5,2,0,3,12,11,1,6,4,3,0,1,8,2,6,9,,,Villa Park,Birmingham
2020/21,11,23,Newcastle United,13,10,4,2,4,12,15,-3,14,5,2,0,3,6,11,-5,6,5,2,2,1,6,4,2,8,,,St. James' Park,Newcastle
2020/21,11,9,Leeds United,14,11,4,2,5,16,20,-4,14,5,1,2,2,6,9,-3,5,6,3,0,3,10,11,-1,9,,,Elland Road,Leeds
2020/21,11,1,Arsenal,15,11,4,1,6,10,14,-4,13,5,2,0,3,5,8,-3,6,6,2,1,3,5,6,-1,7,,,Emirates Stadium,London
2020/21,11,131,Brighton & Hove Albion,16,11,2,4,5,15,18,-3,10,6,0,3,3,6,10,-4,3,5,2,1,2,9,8,1,7,,,American Express Stadium,Falmer
2020/21,11,34,Fulham,17,11,2,1,8,11,21,-10,7,5,1,0,4,5,11,-6,3,6,1,1,4,6,10,-4,4,,,Craven Cottage,London
2020/21,11,43,Burnley,18,10,1,3,6,5,18,-13,6,5,1,1,3,2,6,-4,4,5,0,2,3,3,12,-9,2,,,Turf Moor,Burnley
2020/21,11,36,West Bromwich Albion,19,11,1,3,7,8,23,-15,6,6,1,2,3,5,12,-7,5,5,0,1,4,3,11,-8,1,,,The Hawthorns,West Bromwich
2020/21,11,18,Sheffield United,20,11,0,1,10,5,18,-13,1,6,0,1,5,2,8,-6,1,5,0,0,5,3,10,-7,0,,,Bramall Lane,Sheffield
2020/21,12,21,Tottenham Hotspur,1,12,7,4,1,24,10,14,25,6,3,2,1,10,6,4,11,6,4,2,0,14,4,10,14,Q,EU_CL,Tottenham Hotspur Stadium,London
2020/21,12,10,Liverpool,2,12,7,4,1,27,18,9,25,6,6,0,0,18,6,12,18,6,1,4,1,9,12,-3,7,Q,EU_CL,Anfield,Liverpool
2020/21,12,26,Leicester City,3,12,8,0,4,24,15,9,24,6,3,0,3,9,8,1,9,6,5,0,1,15,7,8,15,Q,EU_CL,King Power Stadium,Leicester
2020/21,12,20,Southampton,4,12,7,2,3,24,17,7,23,6,4,0,2,13,8,5,12,6,3,2,1,11,9,2,11,Q,EU_CL,St. Mary's Stadium,Southampton
2020/21,12,4,Chelsea,5,12,6,4,2,25,12,13,22,6,3,2,1,14,7,7,11,6,3,2,1,11,5,6,11,Q,EU_UC,Stamford Bridge,London
2020/21,12,25,West Ham United,6,12,6,2,4,20,15,5,20,6,3,1,2,9,7,2,10,6,3,1,2,11,8,3,10,Q,EU_UC,London Stadium,London
2020/21,12,7,Everton,7,12,6,2,4,21,18,3,20,6,3,1,2,13,10,3,10,6,3,1,2,8,8,0,10,,,Goodison Park,Liverpool
2020/21,12,12,Manchester United,8,11,6,2,3,19,17,2,20,6,1,2,3,3,10,-7,5,5,5,0,0,16,7,9,15,,,Old Trafford,Manchester
2020/21,12,11,Manchester City,9,11,5,4,2,17,11,6,19,5,3,1,1,11,6,5,10,6,2,3,1,6,5,1,9,,,Etihad Stadium,Manchester
2020/21,12,2,Aston Villa,10,10,6,0,4,21,13,8,18,5,2,0,3,12,11,1,6,5,4,0,1,9,2,7,12,,,Villa Park,Birmingham
2020/21,12,6,Crystal Palace,11,12,5,2,5,18,17,1,17,6,2,2,2,8,7,1,8,6,3,0,3,10,10,0,9,,,Selhurst Park,London
2020/21,12,23,Newcastle United,12,11,5,2,4,14,16,-2,17,6,3,0,3,8,12,-4,9,5,2,2,1,6,4,2,8,,,St. James' Park,Newcastle
2020/21,12,38,Wolverhampton Wanderers,13,12,5,2,5,11,16,-5,17,6,2,2,2,6,6,0,8,6,3,0,3,5,10,-5,9,,,Molineux Stadium,Wolverhampton
2020/21,12,9,Leeds United,14,12,4,2,6,17,22,-5,14,6,1,2,3,7,11,-4,5,6,3,0,3,10,11,-1,9,,,Elland Road,Leeds
2020/21,12,1,Arsenal,15,12,4,1,7,10,15,-5,13,6,2,0,4,5,9,-4,6,6,2,1,3,5,6,-1,7,,,Emirates Stadium,London
2020/21,12,131,Brighton & Hove Albion,16,12,2,4,6,15,21,-6,10,6,0,3,3,6,10,-4,3,6,2,1,3,9,11,-2,7,,,American Express Stadium,Falmer
2020/21,12,43,Burnley,17,11,2,3,6,6,18,-12,9,5,1,1,3,2,6,-4,4,6,1,2,3,4,12,-8,5,,,Turf Moor,Burnley
2020/21,12,34,Fulham,18,12,2,2,8,12,22,-10,8,6,1,1,4,6,12,-6,4,6,1,1,4,6,10,-4,4,,,Craven Cottage,London
2020/21,12,36,West Bromwich Albion,19,12,1,3,8,9,25,-16,6,6,1,2,3,5,12,-7,5,6,0,1,5,4,13,-9,1,,,The Hawthorns,West Bromwich
2020/21,12,18,Sheffield United,20,12,0,1,11,5,21,-16,1,6,0,1,5,2,8,-6,1,6,0,0,6,3,13,-10,0,,,Bramall Lane,Sheffield
2020/21,13,10,Liverpool,1,13,8,4,1,29,19,10,28,7,7,0,0,20,7,13,21,6,1,4,1,9,12,-3,7,Q,EU_CL,Anfield,Liverpool
2020/21,13,21,Tottenham Hotspur,2,13,7,4,2,25,12,13,25,6,3,2,1,10,6,4,11,7,4,2,1,15,6,9,14,Q,EU_CL,Tottenham Hotspur Stadium,London
2020/21,13,20,Southampton,3,13,7,3,3,25,18,7,24,6,4,0,2,13,8,5,12,7,3,3,1,12,10,2,12,Q,EU_CL,St. Mary's Stadium,Southampton
2020/21,13,26,Leicester City,4,13,8,0,5,24,17,7,24,7,3,0,4,9,10,-1,9,6,5,0,1,15,7,8,15,Q,EU_CL,King Power Stadium,Leicester
2020/21,13,7,Everton,5,13,7,2,4,23,18,5,23,6,3,1,2,13,10,3,10,7,4,1,2,10,8,2,13,Q,EU_UC,Goodison Park,Liverpool
2020/21,13,12,Manchester United,6,12,7,2,3,22,19,3,23,6,1,2,3,3,10,-7,5,6,6,0,0,19,9,10,18,Q,EU_UC,Old Trafford,Manchester
2020/21,13,4,Chelsea,7,13,6,4,3,26,14,12,22,6,3,2,1,14,7,7,11,7,3,2,2,12,7,5,11,,,Stamford Bridge,London
2020/21,13,25,West Ham United,8,13,6,3,4,21,16,5,21,7,3,2,2,10,8,2,11,6,3,1,2,11,8,3,10,,,London Stadium,London
2020/21,13,11,Manchester City,9,12,5,5,2,18,12,6,20,6,3,2,1,12,7,5,11,6,2,3,1,6,5,1,9,,,Etihad Stadium,Manchester
2020/21,13,38,Wolverhampton Wanderers,10,13,6,2,5,13,17,-4,20,7,3,2,2,8,7,1,11,6,3,0,3,5,10,-5,9,,,Molineux Stadium,Wolverhampton
2020/21,13,2,Aston Villa,11,11,6,1,4,21,13,8,19,6,2,1,3,12,11,1,7,5,4,0,1,9,2,7,12,,,Villa Park,Birmingham
2020/21,13,6,Crystal Palace,12,13,5,3,5,19,18,1,18,6,2,2,2,8,7,1,8,7,3,1,3,11,11,0,10,,,Selhurst Park,London
2020/21,13,9,Leeds United,13,13,5,2,6,22,24,-2,17,7,2,2,3,12,13,-1,8,6,3,0,3,10,11,-1,9,,,Elland Road,Leeds
2020/21,13,23,Newcastle United,14,12,5,2,5,16,21,-5,17,6,3,0,3,8,12,-4,9,6,2,2,2,8,9,-1,8,,,St. James' Park,Newcastle
2020/21,13,1,Arsenal,15,13,4,2,7,11,16,-5,14,7,2,1,4,6,10,-4,7,6,2,1,3,5,6,-1,7,,,Emirates Stadium,London
2020/21,13,131,Brighton & Hove Albion,16,13,2,5,6,15,21,-6,11,6,0,3,3,6,10,-4,3,7,2,2,3,9,11,-2,8,,,American Express Stadium,Falmer
2020/21,13,43,Burnley,17,12,2,4,6,6,18,-12,10,5,1,1,3,2,6,-4,4,7,1,3,3,4,12,-8,6,,,Turf Moor,Burnley
2020/21,13,34,Fulham,18,13,2,3,8,12,22,-10,9,7,1,2,4,6,12,-6,5,6,1,1,4,6,10,-4,4,,,Craven Cottage,London
2020/21,13,36,West Bromwich Albion,19,13,1,4,8,10,26,-16,7,6,1,2,3,5,12,-7,5,7,0,2,5,5,14,-9,2,,,The Hawthorns,West Bromwich
2020/21,13,18,Sheffield United,20,13,0,1,12,7,24,-17,1,7,0,1,6,4,11,-7,1,6,0,0,6,3,13,-10,0,,,Bramall Lane,Sheffield
2020/21,14,10,Liverpool,1,14,9,4,1,36,19,17,31,7,7,0,0,20,7,13,21,7,2,4,1,16,12,4,10,Q,EU_CL,Anfield,Liverpool
2020/21,14,26,Leicester City,2,14,9,0,5,26,17,9,27,7,3,0,4,9,10,-1,9,7,6,0,1,17,7,10,18,Q,EU_CL,King Power Stadium,Leicester
2020/21,14,12,Manchester United,3,13,8,2,3,28,21,7,26,7,2,2,3,9,12,-3,8,6,6,0,0,19,9,10,18,Q,EU_CL,Old Trafford,Manchester
2020/21,14,7,Everton,4,14,8,2,4,25,19,6,26,7,4,1,2,15,11,4,13,7,4,1,2,10,8,2,13,Q,EU_CL,Goodison Park,Liverpool
2020/21,14,4,Chelsea,5,14,7,4,3,29,14,15,25,7,4,2,1,17,7,10,14,7,3,2,2,12,7,5,11,Q,EU_UC,Stamford Bridge,London
2020/21,14,21,Tottenham Hotspur,6,14,7,4,3,25,14,11,25,7,3,2,2,10,8,2,11,7,4,2,1,15,6,9,14,Q,EU_UC,Tottenham Hotspur Stadium,London
2020/21,14,20,Southampton,7,14,7,3,4,25,19,6,24,7,4,0,3,13,9,4,12,7,3,3,1,12,10,2,12,,,St. Mary's Stadium,Southampton
2020/21,14,11,Manchester City,8,13,6,5,2,19,12,7,23,6,3,2,1,12,7,5,11,7,3,3,1,7,5,2,12,,,Etihad Stadium,Manchester
2020/21,14,2,Aston Villa,9,12,7,1,4,24,13,11,22,6,2,1,3,12,11,1,7,6,5,0,1,12,2,10,15,,,Villa Park,Birmingham
2020/21,14,25,West Ham United,10,14,6,3,5,21,19,2,21,7,3,2,2,10,8,2,11,7,3,1,3,11,11,0,10,,,London Stadium,London
2020/21,14,38,Wolverhampton Wanderers,11,14,6,2,6,14,19,-5,20,7,3,2,2,8,7,1,11,7,3,0,4,6,12,-6,9,,,Molineux Stadium,Wolverhampton
2020/21,14,23,Newcastle United,12,13,5,3,5,17,22,-5,18,7,3,1,3,9,13,-4,10,6,2,2,2,8,9,-1,8,,,St. James' Park,Newcastle
2020/21,14,6,Crystal Palace,13,14,5,3,6,19,25,-6,18,7,2,2,3,8,14,-6,8,7,3,1,3,11,11,0,10,,,Selhurst Park,London
2020/21,14,9,Leeds United,14,14,5,2,7,24,30,-6,17,7,2,2,3,12,13,-1,8,7,3,0,4,12,17,-5,9,,,Elland Road,Leeds
2020/21,14,1,Arsenal,15,14,4,2,8,12,18,-6,14,7,2,1,4,6,10,-4,7,7,2,1,4,6,8,-2,7,,,Emirates Stadium,London
2020/21,14,43,Burnley,16,13,3,4,6,8,19,-11,13,6,2,1,3,4,7,-3,7,7,1,3,3,4,12,-8,6,,,Turf Moor,Burnley
2020/21,14,131,Brighton & Hove Albion,17,14,2,6,6,16,22,-6,12,7,0,4,3,7,11,-4,4,7,2,2,3,9,11,-2,8,,,American Express Stadium,Falmer
2020/21,14,34,Fulham,18,14,2,4,8,13,23,-10,10,7,1,2,4,6,12,-6,5,7,1,2,4,7,11,-4,5,,,Craven Cottage,London
2020/21,14,36,West Bromwich Albion,19,14,1,4,9,10,29,-19,7,7,1,2,4,5,15,-10,5,7,0,2,5,5,14,-9,2,,,The Hawthorns,West Bromwich
2020/21,14,18,Sheffield United,20,14,0,2,12,8,25,-17,2,7,0,1,6,4,11,-7,1,7,0,1,6,4,14,-10,1,,,Bramall Lane,Sheffield
2020/21,15,10,Liverpool,1,15,9,5,1,37,20,17,32,8,7,1,0,21,8,13,22,7,2,4,1,16,12,4,10,Q,EU_CL,Anfield,Liverpool
2020/21,15,7,Everton,2,15,9,2,4,26,19,7,29,7,4,1,2,15,11,4,13,8,5,1,2,11,8,3,16,Q,EU_CL,Goodison Park,Liverpool
2020/21,15,26,Leicester City,3,15,9,1,5,28,19,9,28,8,3,1,4,11,12,-1,10,7,6,0,1,17,7,10,18,Q,EU_CL,King Power Stadium,Leicester
2020/21,15,12,Manchester United,4,14,8,3,3,30,23,7,27,7,2,2,3,9,12,-3,8,7,6,1,0,21,11,10,19,Q,EU_CL,Old Trafford,Manchester
2020/21,15,21,Tottenham Hotspur,5,15,7,5,3,26,15,11,26,7,3,2,2,10,8,2,11,8,4,3,1,16,7,9,15,Q,EU_UC,Tottenham Hotspur Stadium,London
2020/21,15,11,Manchester City,6,14,7,5,2,21,12,9,26,7,4,2,1,14,7,7,14,7,3,3,1,7,5,2,12,Q,EU_UC,Etihad Stadium,Manchester
2020/21,15,2,Aston Villa,7,13,8,1,4,27,13,14,25,7,3,1,3,15,11,4,10,6,5,0,1,12,2,10,15,,,Villa Park,Birmingham
2020/21,15,4,Chelsea,8,15,7,4,4,30,17,13,25,7,4,2,1,17,7,10,14,8,3,2,3,13,10,3,11,,,Stamford Bridge,London
2020/21,15,20,Southampton,9,15,7,4,4,25,19,6,25,7,4,0,3,13,9,4,12,8,3,4,1,12,10,2,13,,,St. Mary's Stadium,Southampton
2020/21,15,25,West Ham United,10,15,6,4,5,23,21,2,22,8,3,3,2,12,10,2,12,7,3,1,3,11,11,0,10,,,London Stadium,London
2020/21,15,38,Wolverhampton Wanderers,11,15,6,3,6,15,20,-5,21,8,3,3,2,9,8,1,12,7,3,0,4,6,12,-6,9,,,Molineux Stadium,Wolverhampton
2020/21,15,9,Leeds United,12,15,6,2,7,25,30,-5,20,8,3,2,3,13,13,0,11,7,3,0,4,12,17,-5,9,,,Elland Road,Leeds
2020/21,15,23,Newcastle United,13,14,5,3,6,17,24,-7,18,7,3,1,3,9,13,-4,10,7,2,2,3,8,11,-3,8,,,St. James' Park,Newcastle
2020/21,15,6,Crystal Palace,14,15,5,3,7,19,28,-9,18,7,2,2,3,8,14,-6,8,8,3,1,4,11,14,-3,10,,,Selhurst Park,London
2020/21,15,1,Arsenal,15,15,5,2,8,15,19,-4,17,8,3,1,4,9,11,-2,10,7,2,1,4,6,8,-2,7,,,Emirates Stadium,London
2020/21,15,131,Brighton & Hove Albion,16,15,2,7,6,18,24,-6,13,7,0,4,3,7,11,-4,4,8,2,3,3,11,13,-2,9,,,American Express Stadium,Falmer
2020/21,15,43,Burnley,17,14,3,4,7,8,20,-12,13,6,2,1,3,4,7,-3,7,8,1,3,4,4,13,-9,6,,,Turf Moor,Burnley
2020/21,15,34,Fulham,18,15,2,5,8,13,23,-10,11,8,1,3,4,6,12,-6,6,7,1,2,4,7,11,-4,5,,,Craven Cottage,London
2020/21,15,36,West Bromwich Albion,19,15,1,5,9,11,30,-19,8,7,1,2,4,5,15,-10,5,8,0,3,5,6,15,-9,3,,,The Hawthorns,West Bromwich
2020/21,15,18,Sheffield United,20,15,0,2,13,8,26,-18,2,8,0,1,7,4,12,-8,1,7,0,1,6,4,14,-10,1,,,Bramall Lane,Sheffield
2020/21,16,10,Liverpool,1,16,9,6,1,37,20,17,33,8,7,1,0,21,8,13,22,8,2,5,1,16,12,4,11,Q,EU_CL,Anfield,Liverpool
2020/21,16,12,Manchester United,2,15,9,3,3,31,23,8,30,8,3,2,3,10,12,-2,11,7,6,1,0,21,11,10,19,Q,EU_CL,Old Trafford,Manchester
2020/21,16,26,Leicester City,3,16,9,2,5,29,20,9,29,8,3,1,4,11,12,-1,10,8,6,1,1,18,8,10,19,Q,EU_CL,King Power Stadium,Leicester
2020/21,16,7,Everton,4,15,9,2,4,26,19,7,29,7,4,1,2,15,11,4,13,8,5,1,2,11,8,3,16,Q,EU_CL,Goodison Park,Liverpool
2020/21,16,2,Aston Villa,5,14,8,2,4,28,14,14,26,7,3,1,3,15,11,4,10,7,5,1,1,13,3,10,16,Q,EU_UC,Villa Park,Birmingham
2020/21,16,4,Chelsea,6,16,7,5,4,31,18,13,26,8,4,3,1,18,8,10,15,8,3,2,3,13,10,3,11,Q,EU_UC,Stamford Bridge,London
2020/21,16,21,Tottenham Hotspur,7,15,7,5,3,26,15,11,26,7,3,2,2,10,8,2,11,8,4,3,1,16,7,9,15,,,Tottenham Hotspur Stadium,London
2020/21,16,11,Manchester City,8,14,7,5,2,21,12,9,26,7,4,2,1,14,7,7,14,7,3,3,1,7,5,2,12,,,Etihad Stadium,Manchester
2020/21,16,20,Southampton,9,16,7,5,4,25,19,6,26,8,4,1,3,13,9,4,13,8,3,4,1,12,10,2,13,,,St. Mary's Stadium,Southampton
2020/21,16,25,West Ham United,10,16,6,5,5,23,21,2,23,8,3,3,2,12,10,2,12,8,3,2,3,11,11,0,11,,,London Stadium,London
2020/21,16,9,Leeds United,11,16,7,2,7,30,30,0,23,8,3,2,3,13,13,0,11,8,4,0,4,17,17,0,12,,,Elland Road,Leeds
2020/21,16,38,Wolverhampton Wanderers,12,16,6,3,7,15,21,-6,21,8,3,3,2,9,8,1,12,8,3,0,5,6,13,-7,9,,,Molineux Stadium,Wolverhampton
2020/21,16,1,Arsenal,13,16,6,2,8,16,19,-3,20,8,3,1,4,9,11,-2,10,8,3,1,4,7,8,-1,10,,,Emirates Stadium,London
2020/21,16,23,Newcastle United,14,15,5,4,6,17,24,-7,19,8,3,2,3,9,13,-4,11,7,2,2,3,8,11,-3,8,,,St. James' Park,Newcastle
2020/21,16,6,Crystal Palace,15,16,5,4,7,20,29,-9,19,8,2,3,3,9,15,-6,9,8,3,1,4,11,14,-3,10,,,Selhurst Park,London
2020/21,16,43,Burnley,16,15,4,4,7,9,20,-11,16,7,3,1,3,5,7,-2,10,8,1,3,4,4,13,-9,6,,,Turf Moor,Burnley
2020/21,16,131,Brighton & Hove Albion,17,16,2,7,7,18,25,-7,13,8,0,4,4,7,12,-5,4,8,2,3,3,11,13,-2,9,,,American Express Stadium,Falmer
2020/21,16,34,Fulham,18,15,2,5,8,13,23,-10,11,8,1,3,4,6,12,-6,6,7,1,2,4,7,11,-4,5,,,Craven Cottage,London
2020/21,16,36,West Bromwich Albion,19,16,1,5,10,11,35,-24,8,8,1,2,5,5,20,-15,5,8,0,3,5,6,15,-9,3,,,The Hawthorns,West Bromwich
2020/21,16,18,Sheffield United,20,16,0,2,14,8,27,-19,2,8,0,1,7,4,12,-8,1,8,0,1,7,4,15,-11,1,,,Bramall Lane,Sheffield
2020/21,17,10,Liverpool,1,17,9,6,2,37,21,16,33,8,7,1,0,21,8,13,22,9,2,5,2,16,13,3,11,Q,EU_CL,Anfield,Liverpool
2020/21,17,12,Manchester United,2,16,10,3,3,33,24,9,33,9,4,2,3,12,13,-1,14,7,6,1,0,21,11,10,19,Q,EU_CL,Old Trafford,Manchester
2020/21,17,26,Leicester City,3,17,10,2,5,31,21,10,32,8,3,1,4,11,12,-1,10,9,7,1,1,20,9,11,22,Q,EU_CL,King Power Stadium,Leicester
2020/21,17,21,Tottenham Hotspur,4,16,8,5,3,29,15,14,29,8,4,2,2,13,8,5,14,8,4,3,1,16,7,9,15,Q,EU_CL,Tottenham Hotspur Stadium,London
2020/21,17,11,Manchester City,5,15,8,5,2,24,13,11,29,7,4,2,1,14,7,7,14,8,4,3,1,10,6,4,15,Q,EU_UC,Etihad Stadium,Manchester
2020/21,17,20,Southampton,6,17,8,5,4,26,19,7,29,9,5,1,3,14,9,5,16,8,3,4,1,12,10,2,13,Q,EU_UC,St. Mary's Stadium,Southampton
2020/21,17,7,Everton,7,16,9,2,5,26,20,6,29,8,4,1,3,15,12,3,13,8,5,1,2,11,8,3,16,,,Goodison Park,Liverpool
2020/21,17,2,Aston Villa,8,15,8,2,5,29,16,13,26,7,3,1,3,15,11,4,10,8,5,1,2,14,5,9,16,,,Villa Park,Birmingham
2020/21,17,4,Chelsea,9,17,7,5,5,32,21,11,26,9,4,3,2,19,11,8,15,8,3,2,3,13,10,3,11,,,Stamford Bridge,London
2020/21,17,25,West Ham United,10,17,7,5,5,24,21,3,26,8,3,3,2,12,10,2,12,9,4,2,3,12,11,1,14,,,London Stadium,London
2020/21,17,1,Arsenal,11,17,7,2,8,20,19,1,23,8,3,1,4,9,11,-2,10,9,4,1,4,11,8,3,13,,,Emirates Stadium,London
2020/21,17,9,Leeds United,12,17,7,2,8,30,33,-3,23,8,3,2,3,13,13,0,11,9,4,0,5,17,20,-3,12,,,Elland Road,Leeds
2020/21,17,38,Wolverhampton Wanderers,13,17,6,4,7,18,24,-6,22,8,3,3,2,9,8,1,12,9,3,1,5,9,16,-7,10,,,Molineux Stadium,Wolverhampton
2020/21,17,6,Crystal Palace,14,17,6,4,7,22,29,-7,22,9,3,3,3,11,15,-4,12,8,3,1,4,11,14,-3,10,,,Selhurst Park,London
2020/21,17,23,Newcastle United,15,16,5,4,7,18,26,-8,19,9,3,2,4,10,15,-5,11,7,2,2,3,8,11,-3,8,,,St. James' Park,Newcastle
2020/21,17,43,Burnley,16,15,4,4,7,9,20,-11,16,7,3,1,3,5,7,-2,10,8,1,3,4,4,13,-9,6,,,Turf Moor,Burnley
2020/21,17,131,Brighton & Hove Albion,17,17,2,8,7,21,28,-7,14,9,0,5,4,10,15,-5,5,8,2,3,3,11,13,-2,9,,,American Express Stadium,Falmer
2020/21,17,34,Fulham,18,15,2,5,8,13,23,-10,11,8,1,3,4,6,12,-6,6,7,1,2,4,7,11,-4,5,,,Craven Cottage,London
2020/21,17,36,West Bromwich Albion,19,17,1,5,11,11,39,-28,8,9,1,2,6,5,24,-19,5,8,0,3,5,6,15,-9,3,,,The Hawthorns,West Bromwich
2020/21,17,18,Sheffield United,20,17,0,2,15,8,29,-21,2,8,0,1,7,4,12,-8,1,9,0,1,8,4,17,-13,1,,,Bramall Lane,Sheffield
2020/21,18,12,Manchester United,1,17,11,3,3,34,24,10,36,9,4,2,3,12,13,-1,14,8,7,1,0,22,11,11,22,Q,EU_CL,Old Trafford,Manchester
2020/21,18,10,Liverpool,2,17,9,6,2,37,21,16,33,8,7,1,0,21,8,13,22,9,2,5,2,16,13,3,11,Q,EU_CL,Anfield,Liverpool
2020/21,18,11,Manchester City,3,16,9,5,2,25,13,12,32,8,5,2,1,15,7,8,17,8,4,3,1,10,6,4,15,Q,EU_CL,Etihad Stadium,Manchester
2020/21,18,26,Leicester City,4,17,10,2,5,31,21,10,32,8,3,1,4,11,12,-1,10,9,7,1,1,20,9,11,22,Q,EU_CL,King Power Stadium,Leicester
2020/21,18,7,Everton,5,17,10,2,5,28,21,7,32,8,4,1,3,15,12,3,13,9,6,1,2,13,9,4,19,Q,EU_UC,Goodison Park,Liverpool
2020/21,18,21,Tottenham Hotspur,6,17,8,6,3,30,16,14,30,9,4,3,2,14,9,5,15,8,4,3,1,16,7,9,15,Q,EU_UC,Tottenham Hotspur Stadium,London
2020/21,18,20,Southampton,7,17,8,5,4,26,19,7,29,9,5,1,3,14,9,5,16,8,3,4,1,12,10,2,13,,,St. Mary's Stadium,Southampton
2020/21,18,2,Aston Villa,8,15,8,2,5,29,16,13,26,7,3,1,3,15,11,4,10,8,5,1,2,14,5,9,16,,,Villa Park,Birmingham
2020/21,18,4,Chelsea,9,17,7,5,5,32,21,11,26,9,4,3,2,19,11,8,15,8,3,2,3,13,10,3,11,,,Stamford Bridge,London
2020/21,18,25,West Ham United,10,17,7,5,5,24,21,3,26,8,3,3,2,12,10,2,12,9,4,2,3,12,11,1,14,,,London Stadium,London
2020/21,18,1,Arsenal,11,18,7,3,8,20,19,1,24,9,3,2,4,9,11,-2,11,9,4,1,4,11,8,3,13,,,Emirates Stadium,London
2020/21,18,9,Leeds United,12,17,7,2,8,30,33,-3,23,8,3,2,3,13,13,0,11,9,4,0,5,17,20,-3,12,,,Elland Road,Leeds
2020/21,18,6,Crystal Palace,13,18,6,5,7,22,29,-7,23,9,3,3,3,11,15,-4,12,9,3,2,4,11,14,-3,11,,,Selhurst Park,London
2020/21,18,38,Wolverhampton Wanderers,14,18,6,4,8,19,26,-7,22,9,3,3,3,10,10,0,12,9,3,1,5,9,16,-7,10,,,Molineux Stadium,Wolverhampton
2020/21,18,23,Newcastle United,15,17,5,4,8,18,27,-9,19,9,3,2,4,10,15,-5,11,8,2,2,4,8,12,-4,8,,,St. James' Park,Newcastle
2020/21,18,43,Burnley,16,16,4,4,8,9,21,-12,16,8,3,1,4,5,8,-3,10,8,1,3,4,4,13,-9,6,,,Turf Moor,Burnley
2020/21,18,131,Brighton & Hove Albion,17,18,2,8,8,21,29,-8,14,9,0,5,4,10,15,-5,5,9,2,3,4,11,14,-3,9,,,American Express Stadium,Falmer
2020/21,18,34,Fulham,18,16,2,6,8,14,24,-10,12,8,1,3,4,6,12,-6,6,8,1,3,4,8,12,-4,6,,,Craven Cottage,London
2020/21,18,36,West Bromwich Albion,19,17,1,5,11,11,39,-28,8,9,1,2,6,5,24,-19,5,8,0,3,5,6,15,-9,3,,,The Hawthorns,West Bromwich
2020/21,18,18,Sheffield United,20,18,1,2,15,9,29,-20,5,9,1,1,7,5,12,-7,4,9,0,1,8,4,17,-13,1,,,Bramall Lane,Sheffield
2020/21,19,12,Manchester United,1,19,12,4,3,36,25,11,40,9,4,2,3,12,13,-1,14,10,8,2,0,24,12,12,26,Q,EU_CL,Old Trafford,Manchester
2020/21,19,11,Manchester City,2,18,11,5,2,31,13,18,38,10,7,2,1,21,7,14,23,8,4,3,1,10,6,4,15,Q,EU_CL,Etihad Stadium,Manchester
2020/21,19,26,Leicester City,3,19,12,2,5,35,21,14,38,10,5,1,4,15,12,3,16,9,7,1,1,20,9,11,22,Q,EU_CL,King Power Stadium,Leicester
2020/21,19,10,Liverpool,4,19,9,7,3,37,22,15,34,10,7,2,1,21,9,12,23,9,2,5,2,16,13,3,11,Q,EU_CL,Anfield,Liverpool
2020/21,19,21,Tottenham Hotspur,5,18,9,6,3,33,17,16,33,9,4,3,2,14,9,5,15,9,5,3,1,19,8,11,18,Q,EU_UC,Tottenham Hotspur Stadium,London
2020/21,19,7,Everton,6,17,10,2,5,28,21,7,32,8,4,1,3,15,12,3,13,9,6,1,2,13,9,4,19,Q,EU_UC,Goodison Park,Liverpool
2020/21,19,25,West Ham United,7,19,9,5,5,27,22,5,32,10,5,3,2,15,11,4,18,9,4,2,3,12,11,1,14,,,London Stadium,London
2020/21,19,2,Aston Villa,8,17,9,2,6,31,18,13,29,8,4,1,3,17,11,6,13,9,5,1,3,14,7,7,16,,,Villa Park,Birmingham
2020/21,19,4,Chelsea,9,19,8,5,6,33,23,10,29,9,4,3,2,19,11,8,15,10,4,2,4,14,12,2,14,,,Stamford Bridge,London
2020/21,19,20,Southampton,10,18,8,5,5,26,21,5,29,9,5,1,3,14,9,5,16,9,3,4,2,12,12,0,13,,,St. Mary's Stadium,Southampton
2020/21,19,1,Arsenal,11,19,8,3,8,23,19,4,27,10,4,2,4,12,11,1,14,9,4,1,4,11,8,3,13,,,Emirates Stadium,London
2020/21,19,9,Leeds United,12,18,7,2,9,30,34,-4,23,9,3,2,4,13,14,-1,11,9,4,0,5,17,20,-3,12,,,Elland Road,Leeds
2020/21,19,6,Crystal Palace,13,19,6,5,8,22,33,-11,23,9,3,3,3,11,15,-4,12,10,3,2,5,11,18,-7,11,,,Selhurst Park,London
2020/21,19,38,Wolverhampton Wanderers,14,19,6,4,9,21,29,-8,22,10,3,3,4,12,13,-1,12,9,3,1,5,9,16,-7,10,,,Molineux Stadium,Wolverhampton
2020/21,19,43,Burnley,15,18,5,4,9,10,22,-12,19,8,3,1,4,5,8,-3,10,10,2,3,5,5,14,-9,9,,,Turf Moor,Burnley
2020/21,19,23,Newcastle United,16,19,5,4,10,18,32,-14,19,9,3,2,4,10,15,-5,11,10,2,2,6,8,17,-9,8,,,St. James' Park,Newcastle
2020/21,19,131,Brighton & Hove Albion,17,19,3,8,8,22,29,-7,17,9,0,5,4,10,15,-5,5,10,3,3,4,12,14,-2,12,,,American Express Stadium,Falmer
2020/21,19,34,Fulham,18,18,2,6,10,15,27,-12,12,10,1,3,6,7,15,-8,6,8,1,3,4,8,12,-4,6,,,Craven Cottage,London
2020/21,19,36,West Bromwich Albion,19,19,2,5,12,15,43,-28,11,9,1,2,6,5,24,-19,5,10,1,3,6,10,19,-9,6,,,The Hawthorns,West Bromwich
2020/21,19,18,Sheffield United,20,19,1,2,16,10,32,-22,5,10,1,1,8,6,15,-9,4,9,0,1,8,4,17,-13,1,,,Bramall Lane,Sheffield
2020/21,20,11,Manchester City,1,19,12,5,2,36,13,23,41,10,7,2,1,21,7,14,23,9,5,3,1,15,6,9,18,Q,EU_CL,Etihad Stadium,Manchester
2020/21,20,12,Manchester United,2,20,12,4,4,37,27,10,40,10,4,2,4,13,15,-2,14,10,8,2,0,24,12,12,26,Q,EU_CL,Old Trafford,Manchester
2020/21,20,26,Leicester City,3,20,12,3,5,36,22,14,39,10,5,1,4,15,12,3,16,10,7,2,1,21,10,11,23,Q,EU_CL,King Power Stadium,Leicester
2020/21,20,10,Liverpool,4,20,10,7,3,40,23,17,37,10,7,2,1,21,9,12,23,10,3,5,2,19,14,5,14,Q,EU_CL,Anfield,Liverpool
2020/21,20,25,West Ham United,5,20,10,5,5,30,24,6,35,10,5,3,2,15,11,4,18,10,5,2,3,15,13,2,17,Q,EU_UC,London Stadium,London
2020/21,20,21,Tottenham Hotspur,6,19,9,6,4,34,20,14,33,10,4,3,3,15,12,3,15,9,5,3,1,19,8,11,18,Q,EU_UC,Tottenham Hotspur Stadium,London
2020/21,20,7,Everton,7,18,10,3,5,29,22,7,33,9,4,2,3,16,13,3,14,9,6,1,2,13,9,4,19,,,Goodison Park,Liverpool
2020/21,20,4,Chelsea,8,20,8,6,6,33,23,10,30,10,4,4,2,19,11,8,16,10,4,2,4,14,12,2,14,,,Stamford Bridge,London
2020/21,20,1,Arsenal,9,20,9,3,8,26,20,6,30,10,4,2,4,12,11,1,14,10,5,1,4,14,9,5,16,,,Emirates Stadium,London
2020/21,20,2,Aston Villa,10,18,9,2,7,33,21,12,29,8,4,1,3,17,11,6,13,10,5,1,4,16,10,6,16,,,Villa Park,Birmingham
2020/21,20,20,Southampton,11,19,8,5,6,27,24,3,29,10,5,1,4,15,12,3,16,9,3,4,2,12,12,0,13,,,St. Mary's Stadium,Southampton
2020/21,20,9,Leeds United,12,19,8,2,9,32,35,-3,26,9,3,2,4,13,14,-1,11,10,5,0,5,19,21,-2,15,,,Elland Road,Leeds
2020/21,20,38,Wolverhampton Wanderers,13,20,6,5,9,21,29,-8,23,10,3,3,4,12,13,-1,12,10,3,2,5,9,16,-7,11,,,Molineux Stadium,Wolverhampton
2020/21,20,6,Crystal Palace,14,20,6,5,9,24,36,-12,23,10,3,3,4,13,18,-5,12,10,3,2,5,11,18,-7,11,,,Selhurst Park,London
2020/21,20,43,Burnley,15,19,6,4,9,13,24,-11,22,9,4,1,4,8,10,-2,13,10,2,3,5,5,14,-9,9,,,Turf Moor,Burnley
2020/21,20,23,Newcastle United,16,20,5,4,11,19,34,-15,19,10,3,2,5,11,17,-6,11,10,2,2,6,8,17,-9,8,,,St. James' Park,Newcastle
2020/21,20,131,Brighton & Hove Albion,17,20,3,9,8,22,29,-7,18,10,0,6,4,10,15,-5,6,10,3,3,4,12,14,-2,12,,,American Express Stadium,Falmer
2020/21,20,34,Fulham,18,19,2,7,10,15,27,-12,13,10,1,3,6,7,15,-8,6,9,1,4,4,8,12,-4,7,,,Craven Cottage,London
2020/21,20,36,West Bromwich Albion,19,20,2,5,13,15,48,-33,11,10,1,2,7,5,29,-24,5,10,1,3,6,10,19,-9,6,,,The Hawthorns,West Bromwich
2020/21,20,18,Sheffield United,20,20,2,2,16,12,33,-21,8,10,1,1,8,6,15,-9,4,10,1,1,8,6,18,-12,4,,,Bramall Lane,Sheffield
2020/21,21,11,Manchester City,1,20,13,5,2,37,13,24,44,11,8,2,1,22,7,15,26,9,5,3,1,15,6,9,18,Q,EU_CL,Etihad Stadium,Manchester
2020/21,21,12,Manchester United,2,21,12,5,4,37,27,10,41,10,4,2,4,13,15,-2,14,11,8,3,0,24,12,12,27,Q,EU_CL,Old Trafford,Manchester
2020/21,21,10,Liverpool,3,21,11,7,3,43,24,19,40,10,7,2,1,21,9,12,23,11,4,5,2,22,15,7,17,Q,EU_CL,Anfield,Liverpool
2020/21,21,26,Leicester City,4,21,12,3,6,37,25,12,39,11,5,1,5,16,15,1,16,10,7,2,1,21,10,11,23,Q,EU_CL,King Power Stadium,Leicester
2020/21,21,25,West Ham United,5,21,10,5,6,31,27,4,35,11,5,3,3,16,14,2,18,10,5,2,3,15,13,2,17,Q,EU_UC,London Stadium,London
2020/21,21,21,Tottenham Hotspur,6,20,9,6,5,34,21,13,33,10,4,3,3,15,12,3,15,10,5,3,2,19,9,10,18,Q,EU_UC,Tottenham Hotspur Stadium,London
2020/21,21,4,Chelsea,7,21,9,6,6,35,23,12,33,11,5,4,2,21,11,10,19,10,4,2,4,14,12,2,14,,,Stamford Bridge,London
2020/21,21,7,Everton,8,19,10,3,6,29,24,5,33,10,4,2,4,16,15,1,14,9,6,1,2,13,9,4,19,,,Goodison Park,Liverpool
2020/21,21,2,Aston Villa,9,19,10,2,7,34,21,13,32,8,4,1,3,17,11,6,13,11,6,1,4,17,10,7,19,,,Villa Park,Birmingham
2020/21,21,1,Arsenal,10,21,9,4,8,26,20,6,31,11,4,3,4,12,11,1,15,10,5,1,4,14,9,5,16,,,Emirates Stadium,London
2020/21,21,20,Southampton,11,20,8,5,7,27,25,2,29,11,5,1,5,15,13,2,16,9,3,4,2,12,12,0,13,,,St. Mary's Stadium,Southampton
2020/21,21,9,Leeds United,12,20,9,2,9,35,36,-1,29,9,3,2,4,13,14,-1,11,11,6,0,5,22,22,0,18,,,Elland Road,Leeds
2020/21,21,6,Crystal Palace,13,21,7,5,9,25,36,-11,26,11,4,3,4,14,18,-4,15,10,3,2,5,11,18,-7,11,,,Selhurst Park,London
2020/21,21,38,Wolverhampton Wanderers,14,21,6,5,10,21,30,-9,23,10,3,3,4,12,13,-1,12,11,3,2,6,9,17,-8,11,,,Molineux Stadium,Wolverhampton
2020/21,21,23,Newcastle United,15,21,6,4,11,21,34,-13,22,10,3,2,5,11,17,-6,11,11,3,2,6,10,17,-7,11,,,St. James' Park,Newcastle
2020/21,21,43,Burnley,16,20,6,4,10,13,26,-13,22,9,4,1,4,8,10,-2,13,11,2,3,6,5,16,-11,9,,,Turf Moor,Burnley
2020/21,21,131,Brighton & Hove Albion,17,21,4,9,8,23,29,-6,21,11,1,6,4,11,15,-4,9,10,3,3,4,12,14,-2,12,,,American Express Stadium,Falmer
2020/21,21,34,Fulham,18,20,2,8,10,17,29,-12,14,10,1,3,6,7,15,-8,6,10,1,5,4,10,14,-4,8,,,Craven Cottage,London
2020/21,21,36,West Bromwich Albion,19,21,2,6,13,17,50,-33,12,11,1,3,7,7,31,-24,6,10,1,3,6,10,19,-9,6,,,The Hawthorns,West Bromwich
2020/21,21,18,Sheffield United,20,21,2,2,17,12,34,-22,8,10,1,1,8,6,15,-9,4,11,1,1,9,6,19,-13,4,,,Bramall Lane,Sheffield
2020/21,22,11,Manchester City,1,21,14,5,2,39,13,26,47,11,8,2,1,22,7,15,26,10,6,3,1,17,6,11,21,Q,EU_CL,Etihad Stadium,Manchester
2020/21,22,12,Manchester United,2,22,13,5,4,46,27,19,44,11,5,2,4,22,15,7,17,11,8,3,0,24,12,12,27,Q,EU_CL,Old Trafford,Manchester
2020/21,22,26,Leicester City,3,22,13,3,6,39,25,14,42,11,5,1,5,16,15,1,16,11,8,2,1,23,10,13,26,Q,EU_CL,King Power Stadium,Leicester
2020/21,22,10,Liverpool,4,22,11,7,4,43,25,18,40,11,7,2,2,21,10,11,23,11,4,5,2,22,15,7,17,Q,EU_CL,Anfield,Liverpool
2020/21,22,25,West Ham United,5,22,11,5,6,34,28,6,38,11,5,3,3,16,14,2,18,11,6,2,3,18,14,4,20,Q,EU_UC,London Stadium,London
2020/21,22,4,Chelsea,6,22,10,6,6,36,23,13,36,11,5,4,2,21,11,10,19,11,5,2,4,15,12,3,17,Q,EU_UC,Stamford Bridge,London
2020/21,22,7,Everton,7,20,11,3,6,31,25,6,36,10,4,2,4,16,15,1,14,10,7,1,2,15,10,5,22,,,Goodison Park,Liverpool
2020/21,22,21,Tottenham Hotspur,8,21,9,6,6,34,22,12,33,11,4,3,4,15,13,2,15,10,5,3,2,19,9,10,18,,,Tottenham Hotspur Stadium,London
2020/21,22,2,Aston Villa,9,20,10,2,8,35,24,11,32,9,4,1,4,18,14,4,13,11,6,1,4,17,10,7,19,,,Villa Park,Birmingham
2020/21,22,1,Arsenal,10,22,9,4,9,27,22,5,31,11,4,3,4,12,11,1,15,11,5,1,5,15,11,4,16,,,Emirates Stadium,London
2020/21,22,9,Leeds United,11,21,9,2,10,36,38,-2,29,10,3,2,5,14,16,-2,11,11,6,0,5,22,22,0,18,,,Elland Road,Leeds
2020/21,22,20,Southampton,12,21,8,5,8,27,34,-7,29,11,5,1,5,15,13,2,16,10,3,4,3,12,21,-9,13,,,St. Mary's Stadium,Southampton
2020/21,22,6,Crystal Palace,13,22,8,5,9,27,37,-10,29,11,4,3,4,14,18,-4,15,11,4,2,5,13,19,-6,14,,,Selhurst Park,London
2020/21,22,38,Wolverhampton Wanderers,14,22,7,5,10,23,31,-8,26,11,4,3,4,14,14,0,15,11,3,2,6,9,17,-8,11,,,Molineux Stadium,Wolverhampton
2020/21,22,131,Brighton & Hove Albion,15,22,5,9,8,24,29,-5,24,11,1,6,4,11,15,-4,9,11,4,3,4,13,14,-1,15,,,American Express Stadium,Falmer
2020/21,22,23,Newcastle United,16,22,6,4,12,22,36,-14,22,11,3,2,6,12,19,-7,11,11,3,2,6,10,17,-7,11,,,St. James' Park,Newcastle
2020/21,22,43,Burnley,17,21,6,4,11,13,28,-15,22,10,4,1,5,8,12,-4,13,11,2,3,6,5,16,-11,9,,,Turf Moor,Burnley
2020/21,22,34,Fulham,18,21,2,8,11,17,31,-14,14,11,1,3,7,7,17,-10,6,10,1,5,4,10,14,-4,8,,,Craven Cottage,London
2020/21,22,36,West Bromwich Albion,19,22,2,6,14,18,52,-34,12,11,1,3,7,7,31,-24,6,11,1,3,7,11,21,-10,6,,,The Hawthorns,West Bromwich
2020/21,22,18,Sheffield United,20,22,3,2,17,14,35,-21,11,11,2,1,8,8,16,-8,7,11,1,1,9,6,19,-13,4,,,Bramall Lane,Sheffield
2020/21,23,11,Manchester City,1,22,15,5,2,43,14,29,50,11,8,2,1,22,7,15,26,11,7,3,1,21,7,14,24,Q,EU_CL,Etihad Stadium,Manchester
2020/21,23,12,Manchester United,2,23,13,6,4,49,30,19,45,12,5,3,4,25,18,7,18,11,8,3,0,24,12,12,27,Q,EU_CL,Old Trafford,Manchester
2020/21,23,26,Leicester City,3,23,13,4,6,39,25,14,43,11,5,1,5,16,15,1,16,12,8,3,1,23,10,13,27,Q,EU_CL,King Power Stadium,Leicester
2020/21,23,10,Liverpool,4,23,11,7,5,44,29,15,40,12,7,2,3,22,14,8,23,11,4,5,2,22,15,7,17,Q,EU_CL,Anfield,Liverpool
2020/21,23,4,Chelsea,5,23,11,6,6,38,24,14,39,11,5,4,2,21,11,10,19,12,6,2,4,17,13,4,20,Q,EU_UC,Stamford Bridge,London
2020/21,23,25,West Ham United,6,23,11,6,6,34,28,6,39,11,5,3,3,16,14,2,18,12,6,3,3,18,14,4,21,Q,EU_UC,London Stadium,London
2020/21,23,7,Everton,7,21,11,4,6,34,28,6,37,10,4,2,4,16,15,1,14,11,7,2,2,18,13,5,23,,,Goodison Park,Liverpool
2020/21,23,21,Tottenham Hotspur,8,22,10,6,6,36,22,14,36,12,5,3,4,17,13,4,18,10,5,3,2,19,9,10,18,,,Tottenham Hotspur Stadium,London
2020/21,23,2,Aston Villa,9,21,11,2,8,36,24,12,35,10,5,1,4,19,14,5,16,11,6,1,4,17,10,7,19,,,Villa Park,Birmingham
2020/21,23,9,Leeds United,10,22,10,2,10,38,38,0,32,11,4,2,5,16,16,0,14,11,6,0,5,22,22,0,18,,,Elland Road,Leeds
2020/21,23,1,Arsenal,11,23,9,4,10,27,23,4,31,11,4,3,4,12,11,1,15,12,5,1,6,15,12,3,16,,,Emirates Stadium,London
2020/21,23,20,Southampton,12,22,8,5,9,29,37,-8,29,11,5,1,5,15,13,2,16,11,3,4,4,14,24,-10,13,,,St. Mary's Stadium,Southampton
2020/21,23,6,Crystal Palace,13,23,8,5,10,27,39,-12,29,11,4,3,4,14,18,-4,15,12,4,2,6,13,21,-8,14,,,Selhurst Park,London
2020/21,23,38,Wolverhampton Wanderers,14,23,7,6,10,23,31,-8,27,12,4,4,4,14,14,0,16,11,3,2,6,9,17,-8,11,,,Molineux Stadium,Wolverhampton
2020/21,23,131,Brighton & Hove Albion,15,23,5,10,8,25,30,-5,25,11,1,6,4,11,15,-4,9,12,4,4,4,14,15,-1,16,,,American Express Stadium,Falmer
2020/21,23,23,Newcastle United,16,23,7,4,12,25,38,-13,25,12,4,2,6,15,21,-6,14,11,3,2,6,10,17,-7,11,,,St. James' Park,Newcastle
2020/21,23,43,Burnley,17,22,6,5,11,14,29,-15,23,11,4,2,5,9,13,-4,14,11,2,3,6,5,16,-11,9,,,Turf Moor,Burnley
2020/21,23,34,Fulham,18,22,2,9,11,17,31,-14,15,12,1,4,7,7,17,-10,7,10,1,5,4,10,14,-4,8,,,Craven Cottage,London
2020/21,23,36,West Bromwich Albion,19,23,2,6,15,18,54,-36,12,11,1,3,7,7,31,-24,6,12,1,3,8,11,23,-12,6,,,The Hawthorns,West Bromwich
2020/21,23,18,Sheffield United,20,23,3,2,18,15,37,-22,11,12,2,1,9,9,18,-9,7,11,1,1,9,6,19,-13,4,,,Bramall Lane,Sheffield
2020/21,24,11,Manchester City,1,24,17,5,2,49,15,34,56,12,9,2,1,25,7,18,29,12,8,3,1,24,8,16,27,Q,EU_CL,Etihad Stadium,Manchester
2020/21,24,12,Manchester United,2,24,13,7,4,50,31,19,46,12,5,3,4,25,18,7,18,12,8,4,0,25,13,12,28,Q,EU_CL,Old Trafford,Manchester
2020/21,24,26,Leicester City,3,24,14,4,6,42,26,16,46,12,6,1,5,19,16,3,19,12,8,3,1,23,10,13,27,Q,EU_CL,King Power Stadium,Leicester
2020/21,24,4,Chelsea,4,24,12,6,6,40,24,16,42,12,6,4,2,23,11,12,22,12,6,2,4,17,13,4,20,Q,EU_CL,Stamford Bridge,London
2020/21,24,25,West Ham United,5,24,12,6,6,37,28,9,42,12,6,3,3,19,14,5,21,12,6,3,3,18,14,4,21,Q,EU_UC,London Stadium,London
2020/21,24,10,Liverpool,6,24,11,7,6,45,32,13,40,12,7,2,3,22,14,8,23,12,4,5,3,23,18,5,17,Q,EU_UC,Anfield,Liverpool
2020/21,24,7,Everton,7,23,11,4,8,35,33,2,37,12,4,2,6,17,20,-3,14,11,7,2,2,18,13,5,23,,,Goodison Park,Liverpool
2020/21,24,2,Aston Villa,8,22,11,3,8,36,24,12,36,10,5,1,4,19,14,5,16,12,6,2,4,17,10,7,20,,,Villa Park,Birmingham
2020/21,24,21,Tottenham Hotspur,9,23,10,6,7,36,25,11,36,12,5,3,4,17,13,4,18,11,5,3,3,19,12,7,18,,,Tottenham Hotspur Stadium,London
2020/21,24,1,Arsenal,10,24,10,4,10,31,25,6,34,12,5,3,4,16,13,3,18,12,5,1,6,15,12,3,16,,,Emirates Stadium,London
2020/21,24,9,Leeds United,11,23,10,2,11,40,42,-2,32,11,4,2,5,16,16,0,14,12,6,0,6,24,26,-2,18,,,Elland Road,Leeds
2020/21,24,38,Wolverhampton Wanderers,12,24,8,6,10,25,32,-7,30,12,4,4,4,14,14,0,16,12,4,2,6,11,18,-7,14,,,Molineux Stadium,Wolverhampton
2020/21,24,20,Southampton,13,23,8,5,10,30,39,-9,29,12,5,1,6,16,15,1,16,11,3,4,4,14,24,-10,13,,,St. Mary's Stadium,Southampton
2020/21,24,6,Crystal Palace,14,24,8,5,11,27,42,-15,29,12,4,3,5,14,21,-7,15,12,4,2,6,13,21,-8,14,,,Selhurst Park,London
2020/21,24,43,Burnley,15,24,7,6,11,18,30,-12,27,12,4,3,5,10,14,-4,15,12,3,3,6,8,16,-8,12,,,Turf Moor,Burnley
2020/21,24,131,Brighton & Hove Albion,16,24,5,11,8,25,30,-5,26,12,1,7,4,11,15,-4,10,12,4,4,4,14,15,-1,16,,,American Express Stadium,Falmer
2020/21,24,23,Newcastle United,17,24,7,4,13,25,40,-15,25,12,4,2,6,15,21,-6,14,12,3,2,7,10,19,-9,11,,,St. James' Park,Newcastle
2020/21,24,34,Fulham,18,24,3,10,11,20,32,-12,19,12,1,4,7,7,17,-10,7,12,2,6,4,13,15,-2,12,,,Craven Cottage,London
2020/21,24,36,West Bromwich Albion,19,24,2,7,15,19,55,-36,13,12,1,4,7,8,32,-24,7,12,1,3,8,11,23,-12,6,,,The Hawthorns,West Bromwich
2020/21,24,18,Sheffield United,20,24,3,2,19,15,40,-25,11,12,2,1,9,9,18,-9,7,12,1,1,10,6,22,-16,4,,,Bramall Lane,Sheffield
2020/21,25,11,Manchester City,1,25,18,5,2,50,15,35,59,12,9,2,1,25,7,18,29,13,9,3,1,25,8,17,30,Q,EU_CL,Etihad Stadium,Manchester
2020/21,25,12,Manchester United,2,25,14,7,4,53,32,21,49,13,6,3,4,28,19,9,21,12,8,4,0,25,13,12,28,Q,EU_CL,Old Trafford,Manchester
2020/21,25,26,Leicester City,3,25,15,4,6,44,27,17,49,12,6,1,5,19,16,3,19,13,9,3,1,25,11,14,30,Q,EU_CL,King Power Stadium,Leicester
2020/21,25,25,West Ham United,4,25,13,6,6,39,29,10,45,13,7,3,3,21,15,6,24,12,6,3,3,18,14,4,21,Q,EU_CL,London Stadium,London
2020/21,25,4,Chelsea,5,25,12,7,6,41,25,16,43,12,6,4,2,23,11,12,22,13,6,3,4,18,14,4,21,Q,EU_UC,Stamford Bridge,London
2020/21,25,10,Liverpool,6,25,11,7,7,45,34,11,40,13,7,2,4,22,16,6,23,12,4,5,3,23,18,5,17,Q,EU_UC,Anfield,Liverpool
2020/21,25,7,Everton,7,24,12,4,8,37,33,4,40,12,4,2,6,17,20,-3,14,12,8,2,2,20,13,7,26,,,Goodison Park,Liverpool
2020/21,25,2,Aston Villa,8,23,11,3,9,37,26,11,36,11,5,1,5,20,16,4,16,12,6,2,4,17,10,7,20,,,Villa Park,Birmingham
2020/21,25,21,Tottenham Hotspur,9,24,10,6,8,37,27,10,36,12,5,3,4,17,13,4,18,12,5,3,4,20,14,6,18,,,Tottenham Hotspur Stadium,London
2020/21,25,9,Leeds United,10,25,11,2,12,43,43,0,35,12,5,2,5,19,16,3,17,13,6,0,7,24,27,-3,18,,,Elland Road,Leeds
2020/21,25,1,Arsenal,11,25,10,4,11,31,26,5,34,13,5,3,5,16,14,2,18,12,5,1,6,15,12,3,16,,,Emirates Stadium,London
2020/21,25,38,Wolverhampton Wanderers,12,25,9,6,10,26,32,-6,33,13,5,4,4,15,14,1,19,12,4,2,6,11,18,-7,14,,,Molineux Stadium,Wolverhampton
2020/21,25,6,Crystal Palace,13,25,9,5,11,29,43,-14,32,12,4,3,5,14,21,-7,15,13,5,2,6,15,22,-7,17,,,Selhurst Park,London
2020/21,25,20,Southampton,14,25,8,6,11,31,43,-12,30,13,5,2,6,17,16,1,17,12,3,4,5,14,27,-13,13,,,St. Mary's Stadium,Southampton
2020/21,25,43,Burnley,15,25,7,7,11,18,30,-12,28,13,4,4,5,10,14,-4,16,12,3,3,6,8,16,-8,12,,,Turf Moor,Burnley
2020/21,25,131,Brighton & Hove Albion,16,25,5,11,9,26,32,-6,26,13,1,7,5,12,17,-5,10,12,4,4,4,14,15,-1,16,,,American Express Stadium,Falmer
2020/21,25,23,Newcastle United,17,25,7,4,14,26,43,-17,25,12,4,2,6,15,21,-6,14,13,3,2,8,11,22,-11,11,,,St. James' Park,Newcastle
2020/21,25,34,Fulham,18,25,4,10,11,21,32,-11,22,13,2,4,7,8,17,-9,10,12,2,6,4,13,15,-2,12,,,Craven Cottage,London
2020/21,25,36,West Bromwich Albion,19,25,2,8,15,19,55,-36,14,12,1,4,7,8,32,-24,7,13,1,4,8,11,23,-12,7,,,The Hawthorns,West Bromwich
2020/21,25,18,Sheffield United,20,25,3,2,20,15,41,-26,11,12,2,1,9,9,18,-9,7,13,1,1,11,6,23,-17,4,,,Bramall Lane,Sheffield
2020/21,26,11,Manchester City,1,27,20,5,2,56,17,39,65,14,11,2,1,31,9,22,35,13,9,3,1,25,8,17,30,Q,EU_CL,Etihad Stadium,Manchester
2020/21,26,12,Manchester United,2,27,14,9,4,53,32,21,51,13,6,3,4,28,19,9,21,14,8,6,0,25,13,12,30,Q,EU_CL,Old Trafford,Manchester
2020/21,26,26,Leicester City,3,27,15,5,7,46,31,15,50,13,6,1,6,20,19,1,19,14,9,4,1,26,12,14,31,Q,EU_CL,King Power Stadium,Leicester
2020/21,26,4,Chelsea,4,27,13,8,6,42,25,17,47,13,6,5,2,23,11,12,23,14,7,3,4,19,14,5,24,Q,EU_CL,Stamford Bridge,London
2020/21,26,7,Everton,5,26,14,4,8,39,33,6,46,13,5,2,6,18,20,-2,17,13,9,2,2,21,13,8,29,Q,EU_UC,Goodison Park,Liverpool
2020/21,26,25,West Ham United,6,26,13,6,7,40,31,9,45,13,7,3,3,21,15,6,24,13,6,3,4,19,16,3,21,Q,EU_UC,London Stadium,London
2020/21,26,10,Liverpool,7,27,12,7,8,47,35,12,43,14,7,2,5,22,17,5,23,13,5,5,3,25,18,7,20,,,Anfield,Liverpool
2020/21,26,21,Tottenham Hotspur,8,26,12,6,8,42,27,15,42,13,6,3,4,21,13,8,21,13,6,3,4,21,14,7,21,,,Tottenham Hotspur Stadium,London
2020/21,26,2,Aston Villa,9,25,12,3,10,38,27,11,39,11,5,1,5,20,16,4,16,14,7,2,5,18,11,7,23,,,Villa Park,Birmingham
2020/21,26,1,Arsenal,10,26,11,4,11,34,27,7,37,13,5,3,5,16,14,2,18,13,6,1,6,18,13,5,19,,,Emirates Stadium,London
2020/21,26,9,Leeds United,11,26,11,2,13,43,44,-1,35,13,5,2,6,19,17,2,17,13,6,0,7,24,27,-3,18,,,Elland Road,Leeds
2020/21,26,38,Wolverhampton Wanderers,12,27,9,7,11,28,37,-9,34,13,5,4,4,15,14,1,19,14,4,3,7,13,23,-10,15,,,Molineux Stadium,Wolverhampton
2020/21,26,6,Crystal Palace,13,27,9,7,11,29,43,-14,34,14,4,5,5,14,21,-7,17,13,5,2,6,15,22,-7,17,,,Selhurst Park,London
2020/21,26,20,Southampton,14,26,8,6,12,31,44,-13,30,13,5,2,6,17,16,1,17,13,3,4,6,14,28,-14,13,,,St. Mary's Stadium,Southampton
2020/21,26,43,Burnley,15,27,7,8,12,19,35,-16,29,14,4,5,5,11,15,-4,17,13,3,3,7,8,20,-12,12,,,Turf Moor,Burnley
2020/21,26,131,Brighton & Hove Albion,16,26,5,11,10,26,33,-7,26,13,1,7,5,12,17,-5,10,13,4,4,5,14,16,-2,16,,,American Express Stadium,Falmer
2020/21,26,23,Newcastle United,17,26,7,5,14,27,44,-17,26,13,4,3,6,16,22,-6,15,13,3,2,8,11,22,-11,11,,,St. James' Park,Newcastle
2020/21,26,34,Fulham,18,27,4,11,12,21,33,-12,23,14,2,4,8,8,18,-10,10,13,2,7,4,13,15,-2,13,,,Craven Cottage,London
2020/21,26,36,West Bromwich Albion,19,27,3,8,16,20,56,-36,17,14,2,4,8,9,33,-24,10,13,1,4,8,11,23,-12,7,,,The Hawthorns,West Bromwich
2020/21,26,18,Sheffield United,20,27,4,2,21,16,43,-27,14,14,3,1,10,10,20,-10,10,13,1,1,11,6,23,-17,4,,,Bramall Lane,Sheffield
2020/21,27,11,Manchester City,1,29,21,5,3,61,21,40,68,16,12,2,2,36,13,23,38,13,9,3,1,25,8,17,30,Q,EU_CL,Etihad Stadium,Manchester
2020/21,27,12,Manchester United,2,28,15,9,4,55,32,23,54,13,6,3,4,28,19,9,21,15,9,6,0,27,13,14,33,Q,EU_CL,Old Trafford,Manchester
2020/21,27,26,Leicester City,3,28,16,5,7,48,32,16,53,13,6,1,6,20,19,1,19,15,10,4,1,28,13,15,34,Q,EU_CL,King Power Stadium,Leicester
2020/21,27,4,Chelsea,4,28,14,8,6,44,25,19,50,14,7,5,2,25,11,14,26,14,7,3,4,19,14,5,24,Q,EU_CL,Stamford Bridge,London
2020/21,27,25,West Ham United,5,27,14,6,7,42,31,11,48,14,8,3,3,23,15,8,27,13,6,3,4,19,16,3,21,Q,EU_UC,London Stadium,London
2020/21,27,7,Everton,6,27,14,4,9,39,35,4,46,13,5,2,6,18,20,-2,17,14,9,2,3,21,15,6,29,Q,EU_UC,Goodison Park,Liverpool
2020/21,27,21,Tottenham Hotspur,7,27,13,6,8,46,28,18,45,14,7,3,4,25,14,11,24,13,6,3,4,21,14,7,21,,,Tottenham Hotspur Stadium,London
2020/21,27,10,Liverpool,8,28,12,7,9,47,36,11,43,15,7,2,6,22,18,4,23,13,5,5,3,25,18,7,20,,,Anfield,Liverpool
2020/21,27,2,Aston Villa,9,26,12,4,10,38,27,11,40,12,5,2,5,20,16,4,17,14,7,2,5,18,11,7,23,,,Villa Park,Birmingham
2020/21,27,1,Arsenal,10,27,11,5,11,35,28,7,38,13,5,3,5,16,14,2,18,14,6,2,6,19,14,5,20,,,Emirates Stadium,London
2020/21,27,9,Leeds United,11,27,11,2,14,43,46,-3,35,13,5,2,6,19,17,2,17,14,6,0,8,24,29,-5,18,,,Elland Road,Leeds
2020/21,27,38,Wolverhampton Wanderers,12,28,9,8,11,28,37,-9,35,13,5,4,4,15,14,1,19,15,4,4,7,13,23,-10,16,,,Molineux Stadium,Wolverhampton
2020/21,27,6,Crystal Palace,13,28,9,7,12,30,47,-17,34,14,4,5,5,14,21,-7,17,14,5,2,7,16,26,-10,17,,,Selhurst Park,London
2020/21,27,20,Southampton,14,28,9,6,13,35,49,-14,33,13,5,2,6,17,16,1,17,15,4,4,7,18,33,-15,16,,,St. Mary's Stadium,Southampton
2020/21,27,43,Burnley,15,28,7,9,12,20,36,-16,30,15,4,6,5,12,16,-4,18,13,3,3,7,8,20,-12,12,,,Turf Moor,Burnley
2020/21,27,23,Newcastle United,16,27,7,6,14,27,44,-17,27,13,4,3,6,16,22,-6,15,14,3,3,8,11,22,-11,12,,,St. James' Park,Newcastle
2020/21,27,131,Brighton & Hove Albion,17,27,5,11,11,27,35,-8,26,14,1,7,6,13,19,-6,10,13,4,4,5,14,16,-2,16,,,American Express Stadium,Falmer
2020/21,27,34,Fulham,18,28,5,11,12,22,33,-11,26,14,2,4,8,8,18,-10,10,14,3,7,4,14,15,-1,16,,,Craven Cottage,London
2020/21,27,36,West Bromwich Albion,19,28,3,9,16,20,56,-36,18,15,2,5,8,9,33,-24,11,13,1,4,8,11,23,-12,7,,,The Hawthorns,West Bromwich
2020/21,27,18,Sheffield United,20,28,4,2,22,16,45,-29,14,15,3,1,11,10,22,-12,10,13,1,1,11,6,23,-17,4,,,Bramall Lane,Sheffield
2020/21,28,11,Manchester City,1,30,22,5,3,64,21,43,71,16,12,2,2,36,13,23,38,14,10,3,1,28,8,20,33,Q,EU_CL,Etihad Stadium,Manchester
2020/21,28,12,Manchester United,2,29,16,9,4,56,32,24,57,14,7,3,4,29,19,10,24,15,9,6,0,27,13,14,33,Q,EU_CL,Old Trafford,Manchester
2020/21,28,26,Leicester City,3,29,17,5,7,53,32,21,56,14,7,1,6,25,19,6,22,15,10,4,1,28,13,15,34,Q,EU_CL,King Power Stadium,Leicester
2020/21,28,4,Chelsea,4,29,14,9,6,44,25,19,51,14,7,5,2,25,11,14,26,15,7,4,4,19,14,5,25,Q,EU_CL,Stamford Bridge,London
2020/21,28,25,West Ham United,5,28,14,6,8,42,32,10,48,14,8,3,3,23,15,8,27,14,6,3,5,19,17,2,21,Q,EU_UC,London Stadium,London
2020/21,28,10,Liverpool,6,29,13,7,9,48,36,12,46,15,7,2,6,22,18,4,23,14,6,5,3,26,18,8,23,Q,EU_UC,Anfield,Liverpool
2020/21,28,7,Everton,7,28,14,4,10,40,37,3,46,14,5,2,7,19,22,-3,17,14,9,2,3,21,15,6,29,,,Goodison Park,Liverpool
2020/21,28,21,Tottenham Hotspur,8,28,13,6,9,47,30,17,45,14,7,3,4,25,14,11,24,14,6,3,5,22,16,6,21,,,Tottenham Hotspur Stadium,London
2020/21,28,2,Aston Villa,9,27,12,5,10,39,28,11,41,12,5,2,5,20,16,4,17,15,7,3,5,19,12,7,24,,,Villa Park,Birmingham
2020/21,28,1,Arsenal,10,28,12,5,11,37,29,8,41,14,6,3,5,18,15,3,21,14,6,2,6,19,14,5,20,,,Emirates Stadium,London
2020/21,28,6,Crystal Palace,11,29,10,7,12,31,47,-16,37,15,5,5,5,15,21,-6,20,14,5,2,7,16,26,-10,17,,,Selhurst Park,London
2020/21,28,9,Leeds United,12,28,11,3,14,43,46,-3,36,14,5,3,6,19,17,2,18,14,6,0,8,24,29,-5,18,,,Elland Road,Leeds
2020/21,28,38,Wolverhampton Wanderers,13,29,9,8,12,28,38,-10,35,14,5,4,5,15,15,0,19,15,4,4,7,13,23,-10,16,,,Molineux Stadium,Wolverhampton
2020/21,28,20,Southampton,14,29,9,6,14,36,51,-15,33,14,5,2,7,18,18,0,17,15,4,4,7,18,33,-15,16,,,St. Mary's Stadium,Southampton
2020/21,28,43,Burnley,15,29,8,9,12,22,37,-15,33,15,4,6,5,12,16,-4,18,14,4,3,7,10,21,-11,15,,,Turf Moor,Burnley
2020/21,28,131,Brighton & Hove Albion,16,28,6,11,11,29,36,-7,29,14,1,7,6,13,19,-6,10,14,5,4,5,16,17,-1,19,,,American Express Stadium,Falmer
2020/21,28,23,Newcastle United,17,28,7,7,14,28,45,-17,28,14,4,4,6,17,23,-6,16,14,3,3,8,11,22,-11,12,,,St. James' Park,Newcastle
2020/21,28,34,Fulham,18,29,5,11,13,22,36,-14,26,15,2,4,9,8,21,-13,10,14,3,7,4,14,15,-1,16,,,Craven Cottage,London
2020/21,28,36,West Bromwich Albion,19,29,3,9,17,20,57,-37,18,15,2,5,8,9,33,-24,11,14,1,4,9,11,24,-13,7,,,The Hawthorns,West Bromwich
2020/21,28,18,Sheffield United,20,29,4,2,23,16,50,-34,14,15,3,1,11,10,22,-12,10,14,1,1,12,6,28,-22,4,,,Bramall Lane,Sheffield
2020/21,29,11,Manchester City,1,30,22,5,3,64,21,43,71,16,12,2,2,36,13,23,38,14,10,3,1,28,8,20,33,Q,EU_CL,Etihad Stadium,Manchester
2020/21,29,12,Manchester United,2,29,16,9,4,56,32,24,57,14,7,3,4,29,19,10,24,15,9,6,0,27,13,14,33,Q,EU_CL,Old Trafford,Manchester
2020/21,29,26,Leicester City,3,29,17,5,7,53,32,21,56,14,7,1,6,25,19,6,22,15,10,4,1,28,13,15,34,Q,EU_CL,King Power Stadium,Leicester
2020/21,29,4,Chelsea,4,29,14,9,6,44,25,19,51,14,7,5,2,25,11,14,26,15,7,4,4,19,14,5,25,Q,EU_CL,Stamford Bridge,London
2020/21,29,25,West Ham United,5,29,14,7,8,45,35,10,49,15,8,4,3,26,18,8,28,14,6,3,5,19,17,2,21,Q,EU_UC,London Stadium,London
2020/21,29,21,Tottenham Hotspur,6,29,14,6,9,49,30,19,48,14,7,3,4,25,14,11,24,15,7,3,5,24,16,8,24,Q,EU_UC,Tottenham Hotspur Stadium,London
2020/21,29,10,Liverpool,7,29,13,7,9,48,36,12,46,15,7,2,6,22,18,4,23,14,6,5,3,26,18,8,23,,,Anfield,Liverpool
2020/21,29,7,Everton,8,28,14,4,10,40,37,3,46,14,5,2,7,19,22,-3,17,14,9,2,3,21,15,6,29,,,Goodison Park,Liverpool
2020/21,29,1,Arsenal,9,29,12,6,11,40,32,8,42,14,6,3,5,18,15,3,21,15,6,3,6,22,17,5,21,,,Emirates Stadium,London
2020/21,29,2,Aston Villa,10,28,12,5,11,39,30,9,41,13,5,2,6,20,18,2,17,15,7,3,5,19,12,7,24,,,Villa Park,Birmingham
2020/21,29,9,Leeds United,11,29,12,3,14,45,47,-2,39,14,5,3,6,19,17,2,18,15,7,0,8,26,30,-4,21,,,Elland Road,Leeds
2020/21,29,6,Crystal Palace,12,29,10,7,12,31,47,-16,37,15,5,5,5,15,21,-6,20,14,5,2,7,16,26,-10,17,,,Selhurst Park,London
2020/21,29,38,Wolverhampton Wanderers,13,29,9,8,12,28,38,-10,35,14,5,4,5,15,15,0,19,15,4,4,7,13,23,-10,16,,,Molineux Stadium,Wolverhampton
2020/21,29,20,Southampton,14,29,9,6,14,36,51,-15,33,14,5,2,7,18,18,0,17,15,4,4,7,18,33,-15,16,,,St. Mary's Stadium,Southampton
2020/21,29,43,Burnley,15,29,8,9,12,22,37,-15,33,15,4,6,5,12,16,-4,18,14,4,3,7,10,21,-11,15,,,Turf Moor,Burnley
2020/21,29,131,Brighton & Hove Albion,16,29,7,11,11,32,36,-4,32,15,2,7,6,16,19,-3,13,14,5,4,5,16,17,-1,19,,,American Express Stadium,Falmer
2020/21,29,23,Newcastle United,17,29,7,7,15,28,48,-20,28,14,4,4,6,17,23,-6,16,15,3,3,9,11,25,-14,12,,,St. James' Park,Newcastle
2020/21,29,34,Fulham,18,30,5,11,14,23,38,-15,26,16,2,4,10,9,23,-14,10,14,3,7,4,14,15,-1,16,,,Craven Cottage,London
2020/21,29,36,West Bromwich Albion,19,29,3,9,17,20,57,-37,18,15,2,5,8,9,33,-24,11,14,1,4,9,11,24,-13,7,,,The Hawthorns,West Bromwich
2020/21,29,18,Sheffield United,20,29,4,2,23,16,50,-34,14,15,3,1,11,10,22,-12,10,14,1,1,12,6,28,-22,4,,,Bramall Lane,Sheffield
2020/21,30,11,Manchester City,1,31,23,5,3,66,21,45,74,16,12,2,2,36,13,23,38,15,11,3,1,30,8,22,36,Q,EU_CL,Etihad Stadium,Manchester
2020/21,30,12,Manchester United,2,30,17,9,4,58,33,25,60,15,8,3,4,31,20,11,27,15,9,6,0,27,13,14,33,Q,EU_CL,Old Trafford,Manchester
2020/21,30,26,Leicester City,3,30,17,5,8,53,34,19,56,15,7,1,7,25,21,4,22,15,10,4,1,28,13,15,34,Q,EU_CL,King Power Stadium,Leicester
2020/21,30,25,West Ham United,4,30,15,7,8,48,37,11,52,15,8,4,3,26,18,8,28,15,7,3,5,22,19,3,24,Q,EU_CL,London Stadium,London
2020/21,30,4,Chelsea,5,30,14,9,7,46,30,16,51,15,7,5,3,27,16,11,26,15,7,4,4,19,14,5,25,Q,EU_UC,Stamford Bridge,London
2020/21,30,21,Tottenham Hotspur,6,30,14,7,9,51,32,19,49,14,7,3,4,25,14,11,24,16,7,4,5,26,18,8,25,Q,EU_UC,Tottenham Hotspur Stadium,London
2020/21,30,10,Liverpool,7,30,14,7,9,51,36,15,49,15,7,2,6,22,18,4,23,15,7,5,3,29,18,11,26,,,Anfield,Liverpool
2020/21,30,7,Everton,8,29,14,5,10,41,38,3,47,15,5,3,7,20,23,-3,18,14,9,2,3,21,15,6,29,,,Goodison Park,Liverpool
2020/21,30,2,Aston Villa,9,29,13,5,11,42,31,11,44,14,6,2,6,23,19,4,20,15,7,3,5,19,12,7,24,,,Villa Park,Birmingham
2020/21,30,1,Arsenal,10,30,12,6,12,40,35,5,42,15,6,3,6,18,18,0,21,15,6,3,6,22,17,5,21,,,Emirates Stadium,London
2020/21,30,9,Leeds United,11,30,13,3,14,47,48,-1,42,15,6,3,6,21,18,3,21,15,7,0,8,26,30,-4,21,,,Elland Road,Leeds
2020/21,30,6,Crystal Palace,12,30,10,8,12,32,48,-16,38,15,5,5,5,15,21,-6,20,15,5,3,7,17,27,-10,18,,,Selhurst Park,London
2020/21,30,20,Southampton,13,30,10,6,14,39,53,-14,36,15,6,2,7,21,20,1,20,15,4,4,7,18,33,-15,16,,,St. Mary's Stadium,Southampton
2020/21,30,38,Wolverhampton Wanderers,14,30,9,8,13,30,41,-11,35,15,5,4,6,17,18,-1,19,15,4,4,7,13,23,-10,16,,,Molineux Stadium,Wolverhampton
2020/21,30,43,Burnley,15,30,8,9,13,24,40,-16,33,15,4,6,5,12,16,-4,18,15,4,3,8,12,24,-12,15,,,Turf Moor,Burnley
2020/21,30,131,Brighton & Hove Albion,16,30,7,11,12,33,38,-5,32,15,2,7,6,16,19,-3,13,15,5,4,6,17,19,-2,19,,,American Express Stadium,Falmer
2020/21,30,23,Newcastle United,17,30,7,8,15,30,50,-20,29,15,4,5,6,19,25,-6,17,15,3,3,9,11,25,-14,12,,,St. James' Park,Newcastle
2020/21,30,34,Fulham,18,31,5,11,15,24,41,-17,26,16,2,4,10,9,23,-14,10,15,3,7,5,15,18,-3,16,,,Craven Cottage,London
2020/21,30,36,West Bromwich Albion,19,30,4,9,17,25,59,-34,21,15,2,5,8,9,33,-24,11,15,2,4,9,16,26,-10,10,,,The Hawthorns,West Bromwich
2020/21,30,18,Sheffield United,20,30,4,2,24,17,52,-35,14,15,3,1,11,10,22,-12,10,15,1,1,13,7,30,-23,4,,,Bramall Lane,Sheffield
2020/21,31,11,Manchester City,1,32,23,5,4,67,23,44,74,17,12,2,3,37,15,22,38,15,11,3,1,30,8,22,36,Q,EU_CL,Etihad Stadium,Manchester
2020/21,31,12,Manchester United,2,31,18,9,4,61,34,27,63,15,8,3,4,31,20,11,27,16,10,6,0,30,14,16,36,Q,EU_CL,Old Trafford,Manchester
2020/21,31,26,Leicester City,3,31,17,5,9,55,37,18,56,15,7,1,7,25,21,4,22,16,10,4,2,30,16,14,34,Q,EU_CL,King Power Stadium,Leicester
2020/21,31,25,West Ham United,4,31,16,7,8,51,39,12,55,16,9,4,3,29,20,9,31,15,7,3,5,22,19,3,24,Q,EU_CL,London Stadium,London
2020/21,31,4,Chelsea,5,31,15,9,7,50,31,19,54,15,7,5,3,27,16,11,26,16,8,4,4,23,15,8,28,Q,EU_UC,Stamford Bridge,London
2020/21,31,10,Liverpool,6,31,15,7,9,53,37,16,52,16,8,2,6,24,19,5,26,15,7,5,3,29,18,11,26,Q,EU_UC,Anfield,Liverpool
2020/21,31,21,Tottenham Hotspur,7,31,14,7,10,52,35,17,49,15,7,3,5,26,17,9,24,16,7,4,5,26,18,8,25,,,Tottenham Hotspur Stadium,London
2020/21,31,7,Everton,8,30,14,6,10,41,38,3,48,15,5,3,7,20,23,-3,18,15,9,3,3,21,15,6,30,,,Goodison Park,Liverpool
2020/21,31,1,Arsenal,9,31,13,6,12,43,35,8,45,15,6,3,6,18,18,0,21,16,7,3,6,25,17,8,24,,,Emirates Stadium,London
2020/21,31,9,Leeds United,10,31,14,3,14,49,49,0,45,15,6,3,6,21,18,3,21,16,8,0,8,28,31,-3,24,,,Elland Road,Leeds
2020/21,31,2,Aston Villa,11,30,13,5,12,43,33,10,44,14,6,2,6,23,19,4,20,16,7,3,6,20,14,6,24,,,Villa Park,Birmingham
2020/21,31,38,Wolverhampton Wanderers,12,31,10,8,13,31,41,-10,38,15,5,4,6,17,18,-1,19,16,5,4,7,14,23,-9,19,,,Molineux Stadium,Wolverhampton
2020/21,31,6,Crystal Palace,13,31,10,8,13,33,52,-19,38,16,5,5,6,16,25,-9,20,15,5,3,7,17,27,-10,18,,,Selhurst Park,London
2020/21,31,20,Southampton,14,31,10,6,15,39,56,-17,36,15,6,2,7,21,20,1,20,16,4,4,8,18,36,-18,16,,,St. Mary's Stadium,Southampton
2020/21,31,131,Brighton & Hove Albion,15,31,7,12,12,33,38,-5,33,16,2,8,6,16,19,-3,14,15,5,4,6,17,19,-2,19,,,American Express Stadium,Falmer
2020/21,31,43,Burnley,16,31,8,9,14,25,42,-17,33,16,4,6,6,13,18,-5,18,15,4,3,8,12,24,-12,15,,,Turf Moor,Burnley
2020/21,31,23,Newcastle United,17,31,8,8,15,32,51,-19,32,15,4,5,6,19,25,-6,17,16,4,3,9,13,26,-13,15,,,St. James' Park,Newcastle
2020/21,31,34,Fulham,18,32,5,11,16,24,42,-18,26,17,2,4,11,9,24,-15,10,15,3,7,5,15,18,-3,16,,,Craven Cottage,London
2020/21,31,36,West Bromwich Albion,19,31,5,9,17,28,59,-31,24,16,3,5,8,12,33,-21,14,15,2,4,9,16,26,-10,10,,,The Hawthorns,West Bromwich
2020/21,31,18,Sheffield United,20,31,4,2,25,17,55,-38,14,16,3,1,12,10,25,-15,10,15,1,1,13,7,30,-23,4,,,Bramall Lane,Sheffield
2020/21,32,11,Manchester City,1,33,24,5,4,69,24,45,77,17,12,2,3,37,15,22,38,16,12,3,1,32,9,23,39,Q,EU_CL,Etihad Stadium,Manchester
2020/21,32,12,Manchester United,2,32,19,9,4,64,35,29,66,16,9,3,4,34,21,13,30,16,10,6,0,30,14,16,36,Q,EU_CL,Old Trafford,Manchester
2020/21,32,26,Leicester City,3,32,18,5,9,58,37,21,59,16,8,1,7,28,21,7,25,16,10,4,2,30,16,14,34,Q,EU_CL,King Power Stadium,Leicester
2020/21,32,4,Chelsea,4,32,15,10,7,50,31,19,55,16,7,6,3,27,16,11,27,16,8,4,4,23,15,8,28,Q,EU_CL,Stamford Bridge,London
2020/21,32,25,West Ham United,5,32,16,7,9,53,42,11,55,16,9,4,3,29,20,9,31,16,7,3,6,24,22,2,24,Q,EU_UC,London Stadium,London
2020/21,32,21,Tottenham Hotspur,6,33,15,8,10,56,38,18,53,16,8,3,5,28,18,10,27,17,7,5,5,28,20,8,26,Q,EU_UC,Tottenham Hotspur Stadium,London
2020/21,32,10,Liverpool,7,32,15,8,9,54,38,16,53,16,8,2,6,24,19,5,26,16,7,6,3,30,19,11,27,,,Anfield,Liverpool
2020/21,32,7,Everton,8,31,14,7,10,43,40,3,49,16,5,4,7,22,25,-3,19,15,9,3,3,21,15,6,30,,,Goodison Park,Liverpool
2020/21,32,1,Arsenal,9,32,13,7,12,44,36,8,46,16,6,4,6,19,19,0,22,16,7,3,6,25,17,8,24,,,Emirates Stadium,London
2020/21,32,9,Leeds United,10,32,14,4,14,50,50,0,46,16,6,4,6,22,19,3,22,16,8,0,8,28,31,-3,24,,,Elland Road,Leeds
2020/21,32,2,Aston Villa,11,31,13,5,13,44,35,9,44,15,6,2,7,24,21,3,20,16,7,3,6,20,14,6,24,,,Villa Park,Birmingham
2020/21,32,38,Wolverhampton Wanderers,12,32,11,8,13,32,41,-9,41,16,6,4,6,18,18,0,22,16,5,4,7,14,23,-9,19,,,Molineux Stadium,Wolverhampton
2020/21,32,6,Crystal Palace,13,31,10,8,13,33,52,-19,38,16,5,5,6,16,25,-9,20,15,5,3,7,17,27,-10,18,,,Selhurst Park,London
2020/21,32,20,Southampton,14,32,10,6,16,40,58,-18,36,15,6,2,7,21,20,1,20,17,4,4,9,19,38,-19,16,,,St. Mary's Stadium,Southampton
2020/21,32,23,Newcastle United,15,32,9,8,15,35,53,-18,35,16,5,5,6,22,27,-5,20,16,4,3,9,13,26,-13,15,,,St. James' Park,Newcastle
2020/21,32,131,Brighton & Hove Albion,16,32,7,13,12,33,38,-5,34,16,2,8,6,16,19,-3,14,16,5,5,6,17,19,-2,20,,,American Express Stadium,Falmer
2020/21,32,43,Burnley,17,32,8,9,15,26,45,-19,33,16,4,6,6,13,18,-5,18,16,4,3,9,13,27,-14,15,,,Turf Moor,Burnley
2020/21,32,34,Fulham,18,33,5,12,16,25,43,-18,27,17,2,4,11,9,24,-15,10,16,3,8,5,16,19,-3,17,,,Craven Cottage,London
2020/21,32,36,West Bromwich Albion,19,32,5,9,18,28,62,-34,24,16,3,5,8,12,33,-21,14,16,2,4,10,16,29,-13,10,,,The Hawthorns,West Bromwich
2020/21,32,18,Sheffield United,20,32,4,2,26,17,56,-39,14,16,3,1,12,10,25,-15,10,16,1,1,14,7,31,-24,4,,,Bramall Lane,Sheffield
2020/21,33,11,Manchester City,1,33,24,5,4,69,24,45,77,17,12,2,3,37,15,22,38,16,12,3,1,32,9,23,39,Q,EU_CL,Etihad Stadium,Manchester
2020/21,33,12,Manchester United,2,33,19,10,4,64,35,29,67,16,9,3,4,34,21,13,30,17,10,7,0,30,14,16,37,Q,EU_CL,Old Trafford,Manchester
2020/21,33,26,Leicester City,3,33,19,5,9,60,38,22,62,17,9,1,7,30,22,8,28,16,10,4,2,30,16,14,34,Q,EU_CL,King Power Stadium,Leicester
2020/21,33,4,Chelsea,4,33,16,10,7,51,31,20,58,16,7,6,3,27,16,11,27,17,9,4,4,24,15,9,31,Q,EU_CL,Stamford Bridge,London
2020/21,33,25,West Ham United,5,33,16,7,10,53,43,10,55,17,9,4,4,29,21,8,31,16,7,3,6,24,22,2,24,Q,EU_UC,London Stadium,London
2020/21,33,10,Liverpool,6,33,15,9,9,55,39,16,54,17,8,3,6,25,20,5,27,16,7,6,3,30,19,11,27,Q,EU_UC,Anfield,Liverpool
2020/21,33,21,Tottenham Hotspur,7,33,15,8,10,56,38,18,53,16,8,3,5,28,18,10,27,17,7,5,5,28,20,8,26,,,Tottenham Hotspur Stadium,London
2020/21,33,7,Everton,8,32,15,7,10,44,40,4,52,16,5,4,7,22,25,-3,19,16,10,3,3,22,15,7,33,,,Goodison Park,Liverpool
2020/21,33,9,Leeds United,9,33,14,5,14,50,50,0,47,17,6,5,6,22,19,3,23,16,8,0,8,28,31,-3,24,,,Elland Road,Leeds
2020/21,33,1,Arsenal,10,33,13,7,13,44,37,7,46,17,6,4,7,19,20,-1,22,16,7,3,6,25,17,8,24,,,Emirates Stadium,London
2020/21,33,2,Aston Villa,11,32,13,6,13,46,37,9,45,16,6,3,7,26,23,3,21,16,7,3,6,20,14,6,24,,,Villa Park,Birmingham
2020/21,33,38,Wolverhampton Wanderers,12,33,11,8,14,32,45,-13,41,17,6,4,7,18,22,-4,22,16,5,4,7,14,23,-9,19,,,Molineux Stadium,Wolverhampton
2020/21,33,6,Crystal Palace,13,32,10,8,14,34,54,-20,38,16,5,5,6,16,25,-9,20,16,5,3,8,18,29,-11,18,,,Selhurst Park,London
2020/21,33,43,Burnley,14,33,9,9,15,30,45,-15,36,16,4,6,6,13,18,-5,18,17,5,3,9,17,27,-10,18,,,Turf Moor,Burnley
2020/21,33,20,Southampton,15,32,10,6,16,40,58,-18,36,15,6,2,7,21,20,1,20,17,4,4,9,19,38,-19,16,,,St. Mary's Stadium,Southampton
2020/21,33,23,Newcastle United,16,33,9,9,15,36,54,-18,36,16,5,5,6,22,27,-5,20,17,4,4,9,14,27,-13,16,,,St. James' Park,Newcastle
2020/21,33,131,Brighton & Hove Albion,17,33,7,13,13,33,39,-6,34,16,2,8,6,16,19,-3,14,17,5,5,7,17,20,-3,20,,,American Express Stadium,Falmer
2020/21,33,34,Fulham,18,33,5,12,16,25,43,-18,27,17,2,4,11,9,24,-15,10,16,3,8,5,16,19,-3,17,,,Craven Cottage,London
2020/21,33,36,West Bromwich Albion,19,33,5,10,18,30,64,-34,25,16,3,5,8,12,33,-21,14,17,2,5,10,18,31,-13,11,,,The Hawthorns,West Bromwich
2020/21,33,18,Sheffield United,20,33,5,2,26,18,56,-38,17,17,4,1,12,11,25,-14,13,16,1,1,14,7,31,-24,4,,,Bramall Lane,Sheffield
2020/21,34,11,Manchester City,1,34,25,5,4,71,24,47,80,17,12,2,3,37,15,22,38,17,13,3,1,34,9,25,42,Q,EU_CL,Etihad Stadium,Manchester
2020/21,34,12,Manchester United,2,33,19,10,4,64,35,29,67,16,9,3,4,34,21,13,30,17,10,7,0,30,14,16,37,Q,EU_CL,Old Trafford,Manchester
2020/21,34,26,Leicester City,3,34,19,6,9,61,39,22,63,17,9,1,7,30,22,8,28,17,10,5,2,31,17,14,35,Q,EU_CL,King Power Stadium,Leicester
2020/21,34,4,Chelsea,4,34,17,10,7,53,31,22,61,17,8,6,3,29,16,13,30,17,9,4,4,24,15,9,31,Q,EU_CL,Stamford Bridge,London
2020/21,34,25,West Ham United,5,34,17,7,10,55,44,11,58,17,9,4,4,29,21,8,31,17,8,3,6,26,23,3,27,Q,EU_UC,London Stadium,London
2020/21,34,21,Tottenham Hotspur,6,34,16,8,10,60,38,22,56,17,9,3,5,32,18,14,30,17,7,5,5,28,20,8,26,Q,EU_UC,Tottenham Hotspur Stadium,London
2020/21,34,10,Liverpool,7,33,15,9,9,55,39,16,54,17,8,3,6,25,20,5,27,16,7,6,3,30,19,11,27,,,Anfield,Liverpool
2020/21,34,7,Everton,8,33,15,7,11,45,42,3,52,17,5,4,8,23,27,-4,19,16,10,3,3,22,15,7,33,,,Goodison Park,Liverpool
2020/21,34,1,Arsenal,9,34,14,7,13,46,37,9,49,17,6,4,7,19,20,-1,22,17,8,3,6,27,17,10,27,,,Emirates Stadium,London
2020/21,34,2,Aston Villa,10,33,14,6,13,48,38,10,48,16,6,3,7,26,23,3,21,17,8,3,6,22,15,7,27,,,Villa Park,Birmingham
2020/21,34,9,Leeds United,11,34,14,5,15,50,52,-2,47,17,6,5,6,22,19,3,23,17,8,0,9,28,33,-5,24,,,Elland Road,Leeds
2020/21,34,38,Wolverhampton Wanderers,12,34,11,9,14,33,46,-13,42,17,6,4,7,18,22,-4,22,17,5,5,7,15,24,-9,20,,,Molineux Stadium,Wolverhampton
2020/21,34,6,Crystal Palace,13,33,10,8,15,34,56,-22,38,17,5,5,7,16,27,-11,20,16,5,3,8,18,29,-11,18,,,Selhurst Park,London
2020/21,34,131,Brighton & Hove Albion,14,34,8,13,13,35,39,-4,37,17,3,8,6,18,19,-1,17,17,5,5,7,17,20,-3,20,,,American Express Stadium,Falmer
2020/21,34,20,Southampton,15,33,10,7,16,41,59,-18,37,16,6,3,7,22,21,1,21,17,4,4,9,19,38,-19,16,,,St. Mary's Stadium,Southampton
2020/21,34,43,Burnley,16,34,9,9,16,31,47,-16,36,17,4,6,7,14,20,-6,18,17,5,3,9,17,27,-10,18,,,Turf Moor,Burnley
2020/21,34,23,Newcastle United,17,34,9,9,16,36,56,-20,36,17,5,5,7,22,29,-7,20,17,4,4,9,14,27,-13,16,,,St. James' Park,Newcastle
2020/21,34,34,Fulham,18,34,5,12,17,25,45,-20,27,17,2,4,11,9,24,-15,10,17,3,8,6,16,21,-5,17,,,Craven Cottage,London
2020/21,34,36,West Bromwich Albion,19,34,5,11,18,31,65,-34,26,17,3,6,8,13,34,-21,15,17,2,5,10,18,31,-13,11,,,The Hawthorns,West Bromwich
2020/21,34,18,Sheffield United,20,34,5,2,27,18,60,-42,17,17,4,1,12,11,25,-14,13,17,1,1,15,7,35,-28,4,,,Bramall Lane,Sheffield
2020/21,35,11,Manchester City,1,35,25,5,5,72,26,46,80,18,12,2,4,38,17,21,38,17,13,3,1,34,9,25,42,Q,EU_CL,Etihad Stadium,Manchester
2020/21,35,12,Manchester United,2,36,20,10,6,70,42,28,70,18,9,3,6,37,27,10,30,18,11,7,0,33,15,18,40,Q,EU_CL,Old Trafford,Manchester
2020/21,35,26,Leicester City,3,36,20,6,10,65,44,21,66,18,9,1,8,32,26,6,28,18,11,5,2,33,18,15,38,Q,EU_CL,King Power Stadium,Leicester
2020/21,35,4,Chelsea,4,36,18,10,8,55,33,22,64,18,8,6,4,29,17,12,30,18,10,4,4,26,16,10,34,Q,EU_CL,Stamford Bridge,London
2020/21,35,10,Liverpool,5,35,17,9,9,61,41,20,60,18,9,3,6,27,20,7,30,17,8,6,3,34,21,13,30,Q,EU_UC,Anfield,Liverpool
2020/21,35,25,West Ham United,6,35,17,7,11,55,45,10,58,18,9,4,5,29,22,7,31,17,8,3,6,26,23,3,27,Q,EU_UC,London Stadium,London
2020/21,35,21,Tottenham Hotspur,7,35,16,8,11,61,41,20,56,17,9,3,5,32,18,14,30,18,7,5,6,29,23,6,26,,,Tottenham Hotspur Stadium,London
2020/21,35,7,Everton,8,35,16,8,11,46,42,4,56,17,5,4,8,23,27,-4,19,18,11,4,3,23,15,8,37,,,Goodison Park,Liverpool
2020/21,35,1,Arsenal,9,36,16,7,13,50,38,12,55,18,7,4,7,22,21,1,25,18,9,3,6,28,17,11,30,,,Emirates Stadium,London
2020/21,35,9,Leeds United,10,35,15,5,15,53,53,0,50,18,7,5,6,25,20,5,26,17,8,0,9,28,33,-5,24,,,Elland Road,Leeds
2020/21,35,2,Aston Villa,11,35,14,7,14,49,41,8,49,18,6,4,8,27,26,1,22,17,8,3,6,22,15,7,27,,,Villa Park,Birmingham
2020/21,35,38,Wolverhampton Wanderers,12,35,12,9,14,35,47,-12,45,18,7,4,7,20,23,-3,25,17,5,5,7,15,24,-9,20,,,Molineux Stadium,Wolverhampton
2020/21,35,6,Crystal Palace,13,35,11,8,16,37,59,-22,41,17,5,5,7,16,27,-11,20,18,6,3,9,21,32,-11,21,,,Selhurst Park,London
2020/21,35,20,Southampton,14,35,11,7,17,44,62,-18,40,17,7,3,7,25,22,3,24,18,4,4,10,19,40,-21,16,,,St. Mary's Stadium,Southampton
2020/21,35,43,Burnley,15,35,10,9,16,33,47,-14,39,17,4,6,7,14,20,-6,18,18,6,3,9,19,27,-8,21,,,Turf Moor,Burnley
2020/21,35,23,Newcastle United,16,35,10,9,16,40,58,-18,39,17,5,5,7,22,29,-7,20,18,5,4,9,18,29,-11,19,,,St. James' Park,Newcastle
2020/21,35,131,Brighton & Hove Albion,17,35,8,13,14,36,41,-5,37,17,3,8,6,18,19,-1,17,18,5,5,8,18,22,-4,20,,,American Express Stadium,Falmer
2020/21,35,34,Fulham,18,35,5,12,18,25,47,-22,27,18,2,4,12,9,26,-17,10,17,3,8,6,16,21,-5,17,,,Craven Cottage,London
2020/21,35,36,West Bromwich Albion,19,35,5,11,19,32,68,-36,26,17,3,6,8,13,34,-21,15,18,2,5,11,19,34,-15,11,,,The Hawthorns,West Bromwich
2020/21,35,18,Sheffield United,20,35,5,2,28,18,62,-44,17,18,4,1,13,11,27,-16,13,17,1,1,15,7,35,-28,4,,,Bramall Lane,Sheffield
2020/21,36,11,Manchester City,1,36,26,5,5,76,29,47,83,18,12,2,4,38,17,21,38,18,14,3,1,38,12,26,45,Q,EU_CL,Etihad Stadium,Manchester
2020/21,36,12,Manchester United,2,36,20,10,6,70,42,28,70,18,9,3,6,37,27,10,30,18,11,7,0,33,15,18,40,Q,EU_CL,Old Trafford,Manchester
2020/21,36,26,Leicester City,3,36,20,6,10,65,44,21,66,18,9,1,8,32,26,6,28,18,11,5,2,33,18,15,38,Q,EU_CL,King Power Stadium,Leicester
2020/21,36,4,Chelsea,4,36,18,10,8,55,33,22,64,18,8,6,4,29,17,12,30,18,10,4,4,26,16,10,34,Q,EU_CL,Stamford Bridge,London
2020/21,36,10,Liverpool,5,36,18,9,9,63,42,21,63,18,9,3,6,27,20,7,30,18,9,6,3,36,22,14,33,Q,EU_UC,Anfield,Liverpool
2020/21,36,21,Tottenham Hotspur,6,36,17,8,11,63,41,22,59,18,10,3,5,34,18,16,33,18,7,5,6,29,23,6,26,Q,EU_UC,Tottenham Hotspur Stadium,London
2020/21,36,25,West Ham United,7,36,17,8,11,56,46,10,59,18,9,4,5,29,22,7,31,18,8,4,6,27,24,3,28,,,London Stadium,London
2020/21,36,7,Everton,8,36,16,8,12,46,43,3,56,18,5,4,9,23,28,-5,19,18,11,4,3,23,15,8,37,,,Goodison Park,Liverpool
2020/21,36,1,Arsenal,9,36,16,7,13,50,38,12,55,18,7,4,7,22,21,1,25,18,9,3,6,28,17,11,30,,,Emirates Stadium,London
2020/21,36,9,Leeds United,10,36,16,5,15,57,53,4,53,18,7,5,6,25,20,5,26,18,9,0,9,32,33,-1,27,,,Elland Road,Leeds
2020/21,36,2,Aston Villa,11,36,14,7,15,51,44,7,49,18,6,4,8,27,26,1,22,18,8,3,7,24,18,6,27,,,Villa Park,Birmingham
2020/21,36,38,Wolverhampton Wanderers,12,36,12,9,15,35,49,-14,45,18,7,4,7,20,23,-3,25,18,5,5,8,15,26,-11,20,,,Molineux Stadium,Wolverhampton
2020/21,36,6,Crystal Palace,13,36,12,8,16,40,61,-21,44,18,6,5,7,19,29,-10,23,18,6,3,9,21,32,-11,21,,,Selhurst Park,London
2020/21,36,20,Southampton,14,36,12,7,17,47,63,-16,43,18,8,3,7,28,23,5,27,18,4,4,10,19,40,-21,16,,,St. Mary's Stadium,Southampton
2020/21,36,43,Burnley,15,36,10,9,17,33,51,-18,39,18,4,6,8,14,24,-10,18,18,6,3,9,19,27,-8,21,,,Turf Moor,Burnley
2020/21,36,23,Newcastle United,16,36,10,9,17,43,62,-19,39,18,5,5,8,25,33,-8,20,18,5,4,9,18,29,-11,19,,,St. James' Park,Newcastle
2020/21,36,131,Brighton & Hove Albion,17,36,8,14,14,37,42,-5,38,18,3,9,6,19,20,-1,18,18,5,5,8,18,22,-4,20,,,American Express Stadium,Falmer
2020/21,36,34,Fulham,18,36,5,12,19,26,50,-24,27,18,2,4,12,9,26,-17,10,18,3,8,7,17,24,-7,17,,,Craven Cottage,London
2020/21,36,36,West Bromwich Albion,19,36,5,11,20,33,70,-37,26,18,3,6,9,14,36,-22,15,18,2,5,11,19,34,-15,11,,,The Hawthorns,West Bromwich
2020/21,36,18,Sheffield United,20,36,6,2,28,19,62,-43,20,18,4,1,13,11,27,-16,13,18,2,1,15,8,35,-27,7,,,Bramall Lane,Sheffield
2020/21,37,11,Manchester City,1,37,26,5,6,78,32,46,83,18,12,2,4,38,17,21,38,19,14,3,2,40,15,25,45,Q,EU_CL,Etihad Stadium,Manchester
2020/21,37,12,Manchester United,2,37,20,11,6,71,43,28,71,19,9,4,6,38,28,10,31,18,11,7,0,33,15,18,40,Q,EU_CL,Old Trafford,Manchester
2020/21,37,4,Chelsea,3,37,19,10,8,57,34,23,67,19,9,6,4,31,18,13,33,18,10,4,4,26,16,10,34,Q,EU_CL,Stamford Bridge,London
2020/21,37,10,Liverpool,4,37,19,9,9,66,42,24,66,18,9,3,6,27,20,7,30,19,10,6,3,39,22,17,36,Q,EU_CL,Anfield,Liverpool
2020/21,37,26,Leicester City,5,37,20,6,11,66,46,20,66,18,9,1,8,32,26,6,28,19,11,5,3,34,20,14,38,Q,EU_UC,King Power Stadium,Leicester
2020/21,37,25,West Ham United,6,37,18,8,11,59,47,12,62,18,9,4,5,29,22,7,31,19,9,4,6,30,25,5,31,Q,EU_UC,London Stadium,London
2020/21,37,21,Tottenham Hotspur,7,37,17,8,12,64,43,21,59,19,10,3,6,35,20,15,33,18,7,5,6,29,23,6,26,,,Tottenham Hotspur Stadium,London
2020/21,37,7,Everton,8,37,17,8,12,47,43,4,59,19,6,4,9,24,28,-4,22,18,11,4,3,23,15,8,37,,,Goodison Park,Liverpool
2020/21,37,1,Arsenal,9,37,17,7,13,53,39,14,58,18,7,4,7,22,21,1,25,19,10,3,6,31,18,13,33,,,Emirates Stadium,London
2020/21,37,9,Leeds United,10,37,17,5,15,59,53,6,56,18,7,5,6,25,20,5,26,19,10,0,9,34,33,1,30,,,Elland Road,Leeds
2020/21,37,2,Aston Villa,11,37,15,7,15,53,45,8,52,18,6,4,8,27,26,1,22,19,9,3,7,26,19,7,30,,,Villa Park,Birmingham
2020/21,37,38,Wolverhampton Wanderers,12,37,12,9,16,35,50,-15,45,18,7,4,7,20,23,-3,25,19,5,5,9,15,27,-12,20,,,Molineux Stadium,Wolverhampton
2020/21,37,6,Crystal Palace,13,37,12,8,17,41,64,-23,44,19,6,5,8,20,32,-12,23,18,6,3,9,21,32,-11,21,,,Selhurst Park,London
2020/21,37,20,Southampton,14,37,12,7,18,47,65,-18,43,19,8,3,8,28,25,3,27,18,4,4,10,19,40,-21,16,,,St. Mary's Stadium,Southampton
2020/21,37,23,Newcastle United,15,37,11,9,17,44,62,-18,42,19,6,5,8,26,33,-7,23,18,5,4,9,18,29,-11,19,,,St. James' Park,Newcastle
2020/21,37,131,Brighton & Hove Albion,16,37,9,14,14,40,44,-4,41,19,4,9,6,22,22,0,21,18,5,5,8,18,22,-4,20,,,American Express Stadium,Falmer
2020/21,37,43,Burnley,17,37,10,9,18,33,54,-21,39,19,4,6,9,14,27,-13,18,18,6,3,9,19,27,-8,21,,,Turf Moor,Burnley
2020/21,37,34,Fulham,18,37,5,13,19,27,51,-24,28,18,2,4,12,9,26,-17,10,19,3,9,7,18,25,-7,18,,,Craven Cottage,London
2020/21,37,36,West Bromwich Albion,19,37,5,11,21,34,73,-39,26,19,3,6,10,15,39,-24,15,18,2,5,11,19,34,-15,11,,,The Hawthorns,West Bromwich
2020/21,37,18,Sheffield United,20,37,6,2,29,19,63,-44,20,18,4,1,13,11,27,-16,13,19,2,1,16,8,36,-28,7,,,Bramall Lane,Sheffield
2020/21,38,11,Manchester City,1,38,27,5,6,83,32,51,86,19,13,2,4,43,17,26,41,19,14,3,2,40,15,25,45,Q,EU_CL,Etihad Stadium,Manchester
2020/21,38,12,Manchester United,2,38,21,11,6,73,44,29,74,19,9,4,6,38,28,10,31,19,12,7,0,35,16,19,43,Q,EU_CL,Old Trafford,Manchester
2020/21,38,10,Liverpool,3,38,20,9,9,68,42,26,69,19,10,3,6,29,20,9,33,19,10,6,3,39,22,17,36,Q,EU_CL,Anfield,Liverpool
2020/21,38,4,Chelsea,4,38,19,10,9,58,36,22,67,19,9,6,4,31,18,13,33,19,10,4,5,27,18,9,34,Q,EU_CL,Stamford Bridge,London
2020/21,38,26,Leicester City,5,38,20,6,12,68,50,18,66,19,9,1,9,34,30,4,28,19,11,5,3,34,20,14,38,Q,EU_UC,King Power Stadium,Leicester
2020/21,38,25,West Ham United,6,38,19,8,11,62,47,15,65,19,10,4,5,32,22,10,34,19,9,4,6,30,25,5,31,Q,EU_UC,London Stadium,London
2020/21,38,21,Tottenham Hotspur,7,38,18,8,12,68,45,23,62,19,10,3,6,35,20,15,33,19,8,5,6,33,25,8,29,,,Tottenham Hotspur Stadium,London
2020/21,38,1,Arsenal,8,38,18,7,13,55,39,16,61,19,8,4,7,24,21,3,28,19,10,3,6,31,18,13,33,,,Emirates Stadium,London
2020/21,38,9,Leeds United,9,38,18,5,15,62,54,8,59,19,8,5,6,28,21,7,29,19,10,0,9,34,33,1,30,,,Elland Road,Leeds
2020/21,38,7,Everton,10,38,17,8,13,47,48,-1,59,19,6,4,9,24,28,-4,22,19,11,4,4,23,20,3,37,,,Goodison Park,Liverpool
2020/21,38,2,Aston Villa,11,38,16,7,15,55,46,9,55,19,7,4,8,29,27,2,25,19,9,3,7,26,19,7,30,,,Villa Park,Birmingham
2020/21,38,23,Newcastle United,12,38,12,9,17,46,62,-16,45,19,6,5,8,26,33,-7,23,19,6,4,9,20,29,-9,22,,,St. James' Park,Newcastle
2020/21,38,38,Wolverhampton Wanderers,13,38,12,9,17,36,52,-16,45,19,7,4,8,21,25,-4,25,19,5,5,9,15,27,-12,20,,,Molineux Stadium,Wolverhampton
2020/21,38,6,Crystal Palace,14,38,12,8,18,41,66,-25,44,19,6,5,8,20,32,-12,23,19,6,3,10,21,34,-13,21,,,Selhurst Park,London
2020/21,38,20,Southampton,15,38,12,7,19,47,68,-21,43,19,8,3,8,28,25,3,27,19,4,4,11,19,43,-24,16,,,St. Mary's Stadium,Southampton
2020/21,38,131,Brighton & Hove Albion,16,38,9,14,15,40,46,-6,41,19,4,9,6,22,22,0,21,19,5,5,9,18,24,-6,20,,,American Express Stadium,Falmer
2020/21,38,43,Burnley,17,38,10,9,19,33,55,-22,39,19,4,6,9,14,27,-13,18,19,6,3,10,19,28,-9,21,,,Turf Moor,Burnley
2020/21,38,34,Fulham,18,38,5,13,20,27,53,-26,28,19,2,4,13,9,28,-19,10,19,3,9,7,18,25,-7,18,,,Craven Cottage,London
2020/21,38,36,West Bromwich Albion,19,38,5,11,22,35,76,-41,26,19,3,6,10,15,39,-24,15,19,2,5,12,20,37,-17,11,,,The Hawthorns,West Bromwich
2020/21,38,18,Sheffield United,20,38,7,2,29,20,63,-43,23,19,5,1,13,12,27,-15,16,19,2,1,16,8,36,-28,7,,,Bramall Lane,Sheffield
